<com.matt_richardson.gocd.websocket_notifier.PipelineWebSocketServer: void <init>(int)>/this#_0	this#_0
<com.matt_richardson.gocd.websocket_notifier.PipelineWebSocketServer: void <init>(int)>/$stack2	$stack2
<com.matt_richardson.gocd.websocket_notifier.PipelineWebSocketServer: void <init>(int)>/port#_0	port#_0
<com.matt_richardson.gocd.websocket_notifier.PipelineWebSocketServer: void <init>(int)>/$stack3	$stack3
<com.matt_richardson.gocd.websocket_notifier.PipelineWebSocketServer: void <init>(int)>/$classconstant0	$classconstant0
<com.matt_richardson.gocd.websocket_notifier.PipelineWebSocketServer: void <init>(java.lang.String,int)>/this#_0	this#_0
<com.matt_richardson.gocd.websocket_notifier.PipelineWebSocketServer: void <init>(java.lang.String,int)>/$stack3	$stack3
<com.matt_richardson.gocd.websocket_notifier.PipelineWebSocketServer: void <init>(java.lang.String,int)>/host#_0	host#_0
<com.matt_richardson.gocd.websocket_notifier.PipelineWebSocketServer: void <init>(java.lang.String,int)>/port#_0	port#_0
<com.matt_richardson.gocd.websocket_notifier.PipelineWebSocketServer: void <init>(java.lang.String,int)>/$stack4	$stack4
<com.matt_richardson.gocd.websocket_notifier.PipelineWebSocketServer: void <init>(java.lang.String,int)>/$classconstant0	$classconstant0
<com.matt_richardson.gocd.websocket_notifier.PipelineWebSocketServer: void onOpen(org.java_websocket.WebSocket,org.java_websocket.handshake.ClientHandshake)>/this#_0	this#_0
<com.matt_richardson.gocd.websocket_notifier.PipelineWebSocketServer: void onOpen(org.java_websocket.WebSocket,org.java_websocket.handshake.ClientHandshake)>/$stack3	$stack3
<com.matt_richardson.gocd.websocket_notifier.PipelineWebSocketServer: void onOpen(org.java_websocket.WebSocket,org.java_websocket.handshake.ClientHandshake)>/$stack4	$stack4
<com.matt_richardson.gocd.websocket_notifier.PipelineWebSocketServer: void onOpen(org.java_websocket.WebSocket,org.java_websocket.handshake.ClientHandshake)>/conn#_0	conn#_0
<com.matt_richardson.gocd.websocket_notifier.PipelineWebSocketServer: void onOpen(org.java_websocket.WebSocket,org.java_websocket.handshake.ClientHandshake)>/$stack5	$stack5
<com.matt_richardson.gocd.websocket_notifier.PipelineWebSocketServer: void onOpen(org.java_websocket.WebSocket,org.java_websocket.handshake.ClientHandshake)>/$stack6	$stack6
<com.matt_richardson.gocd.websocket_notifier.PipelineWebSocketServer: void onOpen(org.java_websocket.WebSocket,org.java_websocket.handshake.ClientHandshake)>/$stack7	$stack7
<com.matt_richardson.gocd.websocket_notifier.PipelineWebSocketServer: void onOpen(org.java_websocket.WebSocket,org.java_websocket.handshake.ClientHandshake)>/$stack8	$stack8
<com.matt_richardson.gocd.websocket_notifier.PipelineWebSocketServer: void onOpen(org.java_websocket.WebSocket,org.java_websocket.handshake.ClientHandshake)>/$stack9	$stack9
<com.matt_richardson.gocd.websocket_notifier.PipelineWebSocketServer: void onOpen(org.java_websocket.WebSocket,org.java_websocket.handshake.ClientHandshake)>/$stack10	$stack10
<com.matt_richardson.gocd.websocket_notifier.PipelineWebSocketServer: void onOpen(org.java_websocket.WebSocket,org.java_websocket.handshake.ClientHandshake)>/handshake#_0	handshake#_0
<com.matt_richardson.gocd.websocket_notifier.PipelineWebSocketServer: void onOpen(org.java_websocket.WebSocket,org.java_websocket.handshake.ClientHandshake)>/$stringconstant0	$stringconstant0
<com.matt_richardson.gocd.websocket_notifier.PipelineWebSocketServer: void onClose(org.java_websocket.WebSocket,int,java.lang.String,boolean)>/this#_0	this#_0
<com.matt_richardson.gocd.websocket_notifier.PipelineWebSocketServer: void onClose(org.java_websocket.WebSocket,int,java.lang.String,boolean)>/$stack5	$stack5
<com.matt_richardson.gocd.websocket_notifier.PipelineWebSocketServer: void onClose(org.java_websocket.WebSocket,int,java.lang.String,boolean)>/$stack6	$stack6
<com.matt_richardson.gocd.websocket_notifier.PipelineWebSocketServer: void onClose(org.java_websocket.WebSocket,int,java.lang.String,boolean)>/conn#_0	conn#_0
<com.matt_richardson.gocd.websocket_notifier.PipelineWebSocketServer: void onClose(org.java_websocket.WebSocket,int,java.lang.String,boolean)>/$stack7	$stack7
<com.matt_richardson.gocd.websocket_notifier.PipelineWebSocketServer: void onClose(org.java_websocket.WebSocket,int,java.lang.String,boolean)>/$stack8	$stack8
<com.matt_richardson.gocd.websocket_notifier.PipelineWebSocketServer: void onClose(org.java_websocket.WebSocket,int,java.lang.String,boolean)>/$stack9	$stack9
<com.matt_richardson.gocd.websocket_notifier.PipelineWebSocketServer: void onClose(org.java_websocket.WebSocket,int,java.lang.String,boolean)>/code#_0	code#_0
<com.matt_richardson.gocd.websocket_notifier.PipelineWebSocketServer: void onClose(org.java_websocket.WebSocket,int,java.lang.String,boolean)>/reason#_0	reason#_0
<com.matt_richardson.gocd.websocket_notifier.PipelineWebSocketServer: void onClose(org.java_websocket.WebSocket,int,java.lang.String,boolean)>/remote#_0	remote#_0
<com.matt_richardson.gocd.websocket_notifier.PipelineWebSocketServer: void onClose(org.java_websocket.WebSocket,int,java.lang.String,boolean)>/$stringconstant0	$stringconstant0
<com.matt_richardson.gocd.websocket_notifier.PipelineWebSocketServer: void onMessage(org.java_websocket.WebSocket,java.lang.String)>/this#_0	this#_0
<com.matt_richardson.gocd.websocket_notifier.PipelineWebSocketServer: void onMessage(org.java_websocket.WebSocket,java.lang.String)>/conn#_0	conn#_0
<com.matt_richardson.gocd.websocket_notifier.PipelineWebSocketServer: void onMessage(org.java_websocket.WebSocket,java.lang.String)>/message#_0	message#_0
<com.matt_richardson.gocd.websocket_notifier.PipelineWebSocketServer: void onError(org.java_websocket.WebSocket,java.lang.Exception)>/this#_0	this#_0
<com.matt_richardson.gocd.websocket_notifier.PipelineWebSocketServer: void onError(org.java_websocket.WebSocket,java.lang.Exception)>/ex#_0	ex#_0
<com.matt_richardson.gocd.websocket_notifier.PipelineWebSocketServer: void onError(org.java_websocket.WebSocket,java.lang.Exception)>/$stack3	$stack3
<com.matt_richardson.gocd.websocket_notifier.PipelineWebSocketServer: void onError(org.java_websocket.WebSocket,java.lang.Exception)>/conn#_0	conn#_0
<com.matt_richardson.gocd.websocket_notifier.PipelineWebSocketServer: void onError(org.java_websocket.WebSocket,java.lang.Exception)>/$stringconstant0	$stringconstant0
<com.matt_richardson.gocd.websocket_notifier.PipelineWebSocketServer: void sendToAll(java.lang.String)>/this#_0	this#_0
<com.matt_richardson.gocd.websocket_notifier.PipelineWebSocketServer: void sendToAll(java.lang.String)>/con#_42	con#_42
<com.matt_richardson.gocd.websocket_notifier.PipelineWebSocketServer: void sendToAll(java.lang.String)>/l4#_44	l4#_44
<com.matt_richardson.gocd.websocket_notifier.PipelineWebSocketServer: void sendToAll(java.lang.String)>/$stack8	$stack8
<com.matt_richardson.gocd.websocket_notifier.PipelineWebSocketServer: void sendToAll(java.lang.String)>/$stack10	$stack10
<com.matt_richardson.gocd.websocket_notifier.PipelineWebSocketServer: void sendToAll(java.lang.String)>/c#_44	c#_44
<com.matt_richardson.gocd.websocket_notifier.PipelineWebSocketServer: void sendToAll(java.lang.String)>/$stack11	$stack11
<com.matt_richardson.gocd.websocket_notifier.PipelineWebSocketServer: void sendToAll(java.lang.String)>/$stack12	$stack12
<com.matt_richardson.gocd.websocket_notifier.PipelineWebSocketServer: void sendToAll(java.lang.String)>/text#_0	text#_0
<com.matt_richardson.gocd.websocket_notifier.PipelineWebSocketServer: void sendToAll(java.lang.String)>/$stack13	$stack13
<com.matt_richardson.gocd.websocket_notifier.PipelineWebSocketServer: void sendToAll(java.lang.String)>/$stack14	$stack14
<com.matt_richardson.gocd.websocket_notifier.PipelineWebSocketServer: void sendToAll(java.lang.String)>/$stack15	$stack15
<com.matt_richardson.gocd.websocket_notifier.PipelineWebSocketServer: void sendToAll(java.lang.String)>/$stack16	$stack16
<com.matt_richardson.gocd.websocket_notifier.PipelineWebSocketServer: void sendToAll(java.lang.String)>/$stack17	$stack17
<com.matt_richardson.gocd.websocket_notifier.PipelineWebSocketServer: void sendToAll(java.lang.String)>/$stack19	$stack19
<com.matt_richardson.gocd.websocket_notifier.PipelineWebSocketServer: void sendToAll(java.lang.String)>/$stringconstant0	$stringconstant0
<com.matt_richardson.gocd.websocket_notifier.PipelineWebSocketServer: void sendToAll(java.lang.String)>/$stringconstant1	$stringconstant1
<com.matt_richardson.gocd.websocket_notifier.GoNotificationPlugin: void initializeGoApplicationAccessor(com.thoughtworks.go.plugin.api.GoApplicationAccessor)>/$stack7	$stack7
<com.matt_richardson.gocd.websocket_notifier.GoNotificationPlugin: void initializeGoApplicationAccessor(com.thoughtworks.go.plugin.api.GoApplicationAccessor)>/$stack8	$stack8
<com.matt_richardson.gocd.websocket_notifier.GoNotificationPlugin: void initializeGoApplicationAccessor(com.thoughtworks.go.plugin.api.GoApplicationAccessor)>/port#_30	port#_30
<com.matt_richardson.gocd.websocket_notifier.GoNotificationPlugin: void initializeGoApplicationAccessor(com.thoughtworks.go.plugin.api.GoApplicationAccessor)>/host#_31	host#_31
<com.matt_richardson.gocd.websocket_notifier.GoNotificationPlugin: void initializeGoApplicationAccessor(com.thoughtworks.go.plugin.api.GoApplicationAccessor)>/$stack9	$stack9
<com.matt_richardson.gocd.websocket_notifier.GoNotificationPlugin: void initializeGoApplicationAccessor(com.thoughtworks.go.plugin.api.GoApplicationAccessor)>/$stack10	$stack10
<com.matt_richardson.gocd.websocket_notifier.GoNotificationPlugin: void initializeGoApplicationAccessor(com.thoughtworks.go.plugin.api.GoApplicationAccessor)>/$stack11	$stack11
<com.matt_richardson.gocd.websocket_notifier.GoNotificationPlugin: void initializeGoApplicationAccessor(com.thoughtworks.go.plugin.api.GoApplicationAccessor)>/$stack12	$stack12
<com.matt_richardson.gocd.websocket_notifier.GoNotificationPlugin: void initializeGoApplicationAccessor(com.thoughtworks.go.plugin.api.GoApplicationAccessor)>/$stack13	$stack13
<com.matt_richardson.gocd.websocket_notifier.GoNotificationPlugin: void initializeGoApplicationAccessor(com.thoughtworks.go.plugin.api.GoApplicationAccessor)>/$stack14	$stack14
<com.matt_richardson.gocd.websocket_notifier.GoNotificationPlugin: void initializeGoApplicationAccessor(com.thoughtworks.go.plugin.api.GoApplicationAccessor)>/$stack15	$stack15
<com.matt_richardson.gocd.websocket_notifier.GoNotificationPlugin: void initializeGoApplicationAccessor(com.thoughtworks.go.plugin.api.GoApplicationAccessor)>/$stack16	$stack16
<com.matt_richardson.gocd.websocket_notifier.GoNotificationPlugin: void initializeGoApplicationAccessor(com.thoughtworks.go.plugin.api.GoApplicationAccessor)>/$stack17	$stack17
<com.matt_richardson.gocd.websocket_notifier.GoNotificationPlugin: void initializeGoApplicationAccessor(com.thoughtworks.go.plugin.api.GoApplicationAccessor)>/$stack18	$stack18
<com.matt_richardson.gocd.websocket_notifier.GoNotificationPlugin: void initializeGoApplicationAccessor(com.thoughtworks.go.plugin.api.GoApplicationAccessor)>/$stack19	$stack19
<com.matt_richardson.gocd.websocket_notifier.GoNotificationPlugin: void initializeGoApplicationAccessor(com.thoughtworks.go.plugin.api.GoApplicationAccessor)>/$stack20	$stack20
<com.matt_richardson.gocd.websocket_notifier.GoNotificationPlugin: void initializeGoApplicationAccessor(com.thoughtworks.go.plugin.api.GoApplicationAccessor)>/$stack21	$stack21
<com.matt_richardson.gocd.websocket_notifier.GoNotificationPlugin: void initializeGoApplicationAccessor(com.thoughtworks.go.plugin.api.GoApplicationAccessor)>/$stack22	$stack22
<com.matt_richardson.gocd.websocket_notifier.GoNotificationPlugin: void initializeGoApplicationAccessor(com.thoughtworks.go.plugin.api.GoApplicationAccessor)>/$stack23	$stack23
<com.matt_richardson.gocd.websocket_notifier.GoNotificationPlugin: void initializeGoApplicationAccessor(com.thoughtworks.go.plugin.api.GoApplicationAccessor)>/$stack29	$stack29
<com.matt_richardson.gocd.websocket_notifier.GoNotificationPlugin: void initializeGoApplicationAccessor(com.thoughtworks.go.plugin.api.GoApplicationAccessor)>/$stack30	$stack30
<com.matt_richardson.gocd.websocket_notifier.GoNotificationPlugin: void initializeGoApplicationAccessor(com.thoughtworks.go.plugin.api.GoApplicationAccessor)>/$stack31	$stack31
<com.matt_richardson.gocd.websocket_notifier.GoNotificationPlugin: void initializeGoApplicationAccessor(com.thoughtworks.go.plugin.api.GoApplicationAccessor)>/$stack32	$stack32
<com.matt_richardson.gocd.websocket_notifier.GoNotificationPlugin: void initializeGoApplicationAccessor(com.thoughtworks.go.plugin.api.GoApplicationAccessor)>/$stack33	$stack33
<com.matt_richardson.gocd.websocket_notifier.GoNotificationPlugin: void initializeGoApplicationAccessor(com.thoughtworks.go.plugin.api.GoApplicationAccessor)>/$stack34	$stack34
<com.matt_richardson.gocd.websocket_notifier.GoNotificationPlugin: void initializeGoApplicationAccessor(com.thoughtworks.go.plugin.api.GoApplicationAccessor)>/this#_0	this#_0
<com.matt_richardson.gocd.websocket_notifier.GoNotificationPlugin: void initializeGoApplicationAccessor(com.thoughtworks.go.plugin.api.GoApplicationAccessor)>/goApplicationAccessor#_0	goApplicationAccessor#_0
<com.matt_richardson.gocd.websocket_notifier.GoNotificationPlugin: void initializeGoApplicationAccessor(com.thoughtworks.go.plugin.api.GoApplicationAccessor)>/s#_38	s#_38
<com.matt_richardson.gocd.websocket_notifier.GoNotificationPlugin: void initializeGoApplicationAccessor(com.thoughtworks.go.plugin.api.GoApplicationAccessor)>/s_$$A_1#_40	s_$$A_1#_40
<com.matt_richardson.gocd.websocket_notifier.GoNotificationPlugin: void initializeGoApplicationAccessor(com.thoughtworks.go.plugin.api.GoApplicationAccessor)>/s_$$A_2#_41	s_$$A_2#_41
<com.matt_richardson.gocd.websocket_notifier.GoNotificationPlugin: void initializeGoApplicationAccessor(com.thoughtworks.go.plugin.api.GoApplicationAccessor)>/s_$$A_3#_48	s_$$A_3#_48
<com.matt_richardson.gocd.websocket_notifier.GoNotificationPlugin: void initializeGoApplicationAccessor(com.thoughtworks.go.plugin.api.GoApplicationAccessor)>/s_$$A_4#_47	s_$$A_4#_47
<com.matt_richardson.gocd.websocket_notifier.GoNotificationPlugin: void initializeGoApplicationAccessor(com.thoughtworks.go.plugin.api.GoApplicationAccessor)>/$stringconstant0	$stringconstant0
<com.matt_richardson.gocd.websocket_notifier.GoNotificationPlugin: void initializeGoApplicationAccessor(com.thoughtworks.go.plugin.api.GoApplicationAccessor)>/$stringconstant1	$stringconstant1
<com.matt_richardson.gocd.websocket_notifier.GoNotificationPlugin: void initializeGoApplicationAccessor(com.thoughtworks.go.plugin.api.GoApplicationAccessor)>/$stringconstant2	$stringconstant2
<com.matt_richardson.gocd.websocket_notifier.GoNotificationPlugin: void <init>()>/this#_0	this#_0
<com.matt_richardson.gocd.websocket_notifier.GoNotificationPlugin: void <init>(com.matt_richardson.gocd.websocket_notifier.WebSocketPipelineListener)>/this#_0	this#_0
<com.matt_richardson.gocd.websocket_notifier.GoNotificationPlugin: void <init>(com.matt_richardson.gocd.websocket_notifier.WebSocketPipelineListener)>/pipelineListener#_0	pipelineListener#_0
<com.matt_richardson.gocd.websocket_notifier.GoNotificationPlugin: com.thoughtworks.go.plugin.api.response.GoPluginApiResponse handle(com.thoughtworks.go.plugin.api.request.GoPluginApiRequest)>/$stack4	$stack4
<com.matt_richardson.gocd.websocket_notifier.GoNotificationPlugin: com.thoughtworks.go.plugin.api.response.GoPluginApiResponse handle(com.thoughtworks.go.plugin.api.request.GoPluginApiRequest)>/goPluginApiRequest#_0	goPluginApiRequest#_0
<com.matt_richardson.gocd.websocket_notifier.GoNotificationPlugin: com.thoughtworks.go.plugin.api.response.GoPluginApiResponse handle(com.thoughtworks.go.plugin.api.request.GoPluginApiRequest)>/$stack5	$stack5
<com.matt_richardson.gocd.websocket_notifier.GoNotificationPlugin: com.thoughtworks.go.plugin.api.response.GoPluginApiResponse handle(com.thoughtworks.go.plugin.api.request.GoPluginApiRequest)>/$stack6	$stack6
<com.matt_richardson.gocd.websocket_notifier.GoNotificationPlugin: com.thoughtworks.go.plugin.api.response.GoPluginApiResponse handle(com.thoughtworks.go.plugin.api.request.GoPluginApiRequest)>/$stack7	$stack7
<com.matt_richardson.gocd.websocket_notifier.GoNotificationPlugin: com.thoughtworks.go.plugin.api.response.GoPluginApiResponse handle(com.thoughtworks.go.plugin.api.request.GoPluginApiRequest)>/$stack8	$stack8
<com.matt_richardson.gocd.websocket_notifier.GoNotificationPlugin: com.thoughtworks.go.plugin.api.response.GoPluginApiResponse handle(com.thoughtworks.go.plugin.api.request.GoPluginApiRequest)>/$stack9	$stack9
<com.matt_richardson.gocd.websocket_notifier.GoNotificationPlugin: com.thoughtworks.go.plugin.api.response.GoPluginApiResponse handle(com.thoughtworks.go.plugin.api.request.GoPluginApiRequest)>/$stack10	$stack10
<com.matt_richardson.gocd.websocket_notifier.GoNotificationPlugin: com.thoughtworks.go.plugin.api.response.GoPluginApiResponse handle(com.thoughtworks.go.plugin.api.request.GoPluginApiRequest)>/$stack11	$stack11
<com.matt_richardson.gocd.websocket_notifier.GoNotificationPlugin: com.thoughtworks.go.plugin.api.response.GoPluginApiResponse handle(com.thoughtworks.go.plugin.api.request.GoPluginApiRequest)>/$stack12	$stack12
<com.matt_richardson.gocd.websocket_notifier.GoNotificationPlugin: com.thoughtworks.go.plugin.api.response.GoPluginApiResponse handle(com.thoughtworks.go.plugin.api.request.GoPluginApiRequest)>/$stack14	$stack14
<com.matt_richardson.gocd.websocket_notifier.GoNotificationPlugin: com.thoughtworks.go.plugin.api.response.GoPluginApiResponse handle(com.thoughtworks.go.plugin.api.request.GoPluginApiRequest)>/$stack15	$stack15
<com.matt_richardson.gocd.websocket_notifier.GoNotificationPlugin: com.thoughtworks.go.plugin.api.response.GoPluginApiResponse handle(com.thoughtworks.go.plugin.api.request.GoPluginApiRequest)>/$stack16	$stack16
<com.matt_richardson.gocd.websocket_notifier.GoNotificationPlugin: com.thoughtworks.go.plugin.api.response.GoPluginApiResponse handle(com.thoughtworks.go.plugin.api.request.GoPluginApiRequest)>/$stack17	$stack17
<com.matt_richardson.gocd.websocket_notifier.GoNotificationPlugin: com.thoughtworks.go.plugin.api.response.GoPluginApiResponse handle(com.thoughtworks.go.plugin.api.request.GoPluginApiRequest)>/$stack18	$stack18
<com.matt_richardson.gocd.websocket_notifier.GoNotificationPlugin: com.thoughtworks.go.plugin.api.response.GoPluginApiResponse handle(com.thoughtworks.go.plugin.api.request.GoPluginApiRequest)>/this#_0	this#_0
<com.matt_richardson.gocd.websocket_notifier.GoNotificationPlugin: com.thoughtworks.go.plugin.api.response.GoPluginApiResponse handle(com.thoughtworks.go.plugin.api.request.GoPluginApiRequest)>/$stack19	$stack19
<com.matt_richardson.gocd.websocket_notifier.GoNotificationPlugin: com.thoughtworks.go.plugin.api.response.GoPluginApiResponse handle(com.thoughtworks.go.plugin.api.request.GoPluginApiRequest)>/$stack20	$stack20
<com.matt_richardson.gocd.websocket_notifier.GoNotificationPlugin: com.thoughtworks.go.plugin.api.response.GoPluginApiResponse handle(com.thoughtworks.go.plugin.api.request.GoPluginApiRequest)>/$stack21	$stack21
<com.matt_richardson.gocd.websocket_notifier.GoNotificationPlugin: com.thoughtworks.go.plugin.api.response.GoPluginApiResponse handle(com.thoughtworks.go.plugin.api.request.GoPluginApiRequest)>/$stack22	$stack22
<com.matt_richardson.gocd.websocket_notifier.GoNotificationPlugin: com.thoughtworks.go.plugin.api.response.GoPluginApiResponse handle(com.thoughtworks.go.plugin.api.request.GoPluginApiRequest)>/$stack23	$stack23
<com.matt_richardson.gocd.websocket_notifier.GoNotificationPlugin: com.thoughtworks.go.plugin.api.response.GoPluginApiResponse handle(com.thoughtworks.go.plugin.api.request.GoPluginApiRequest)>/$stack24	$stack24
<com.matt_richardson.gocd.websocket_notifier.GoNotificationPlugin: com.thoughtworks.go.plugin.api.response.GoPluginApiResponse handle(com.thoughtworks.go.plugin.api.request.GoPluginApiRequest)>/$stack25	$stack25
<com.matt_richardson.gocd.websocket_notifier.GoNotificationPlugin: com.thoughtworks.go.plugin.api.response.GoPluginApiResponse handle(com.thoughtworks.go.plugin.api.request.GoPluginApiRequest)>/$stack26	$stack26
<com.matt_richardson.gocd.websocket_notifier.GoNotificationPlugin: com.thoughtworks.go.plugin.api.response.GoPluginApiResponse handle(com.thoughtworks.go.plugin.api.request.GoPluginApiRequest)>/$stack27	$stack27
<com.matt_richardson.gocd.websocket_notifier.GoNotificationPlugin: com.thoughtworks.go.plugin.api.response.GoPluginApiResponse handle(com.thoughtworks.go.plugin.api.request.GoPluginApiRequest)>/$stack28	$stack28
<com.matt_richardson.gocd.websocket_notifier.GoNotificationPlugin: com.thoughtworks.go.plugin.api.response.GoPluginApiResponse handle(com.thoughtworks.go.plugin.api.request.GoPluginApiRequest)>/$u0	$u0
<com.matt_richardson.gocd.websocket_notifier.GoNotificationPlugin: com.thoughtworks.go.plugin.api.response.GoPluginApiResponse handle(com.thoughtworks.go.plugin.api.request.GoPluginApiRequest)>/$u1	$u1
<com.matt_richardson.gocd.websocket_notifier.GoNotificationPlugin: com.thoughtworks.go.plugin.api.response.GoPluginApiResponse handle(com.thoughtworks.go.plugin.api.request.GoPluginApiRequest)>/$r0	$r0
<com.matt_richardson.gocd.websocket_notifier.GoNotificationPlugin: com.thoughtworks.go.plugin.api.response.GoPluginApiResponse handle(com.thoughtworks.go.plugin.api.request.GoPluginApiRequest)>/$r1	$r1
<com.matt_richardson.gocd.websocket_notifier.GoNotificationPlugin: com.thoughtworks.go.plugin.api.response.GoPluginApiResponse handle(com.thoughtworks.go.plugin.api.request.GoPluginApiRequest)>/$stringconstant0	$stringconstant0
<com.matt_richardson.gocd.websocket_notifier.GoNotificationPlugin: com.thoughtworks.go.plugin.api.response.GoPluginApiResponse handle(com.thoughtworks.go.plugin.api.request.GoPluginApiRequest)>/$stringconstant1	$stringconstant1
<com.matt_richardson.gocd.websocket_notifier.GoNotificationPlugin: com.thoughtworks.go.plugin.api.response.GoPluginApiResponse handle(com.thoughtworks.go.plugin.api.request.GoPluginApiRequest)>/$stringconstant2	$stringconstant2
<com.matt_richardson.gocd.websocket_notifier.GoNotificationPlugin: com.thoughtworks.go.plugin.api.response.GoPluginApiResponse handle(com.thoughtworks.go.plugin.api.request.GoPluginApiRequest)>/$stringconstant3	$stringconstant3
<com.matt_richardson.gocd.websocket_notifier.GoNotificationPlugin: com.thoughtworks.go.plugin.api.response.GoPluginApiResponse handle(com.thoughtworks.go.plugin.api.request.GoPluginApiRequest)>/$stringconstant4	$stringconstant4
<com.matt_richardson.gocd.websocket_notifier.GoNotificationPlugin: com.thoughtworks.go.plugin.api.GoPluginIdentifier pluginIdentifier()>/$stack1	$stack1
<com.matt_richardson.gocd.websocket_notifier.GoNotificationPlugin: com.thoughtworks.go.plugin.api.GoPluginIdentifier pluginIdentifier()>/$stack2	$stack2
<com.matt_richardson.gocd.websocket_notifier.GoNotificationPlugin: com.thoughtworks.go.plugin.api.GoPluginIdentifier pluginIdentifier()>/$stack3	$stack3
<com.matt_richardson.gocd.websocket_notifier.GoNotificationPlugin: com.thoughtworks.go.plugin.api.GoPluginIdentifier pluginIdentifier()>/this#_0	this#_0
<com.matt_richardson.gocd.websocket_notifier.GoNotificationPlugin: com.thoughtworks.go.plugin.api.GoPluginIdentifier pluginIdentifier()>/$stringconstant0	$stringconstant0
<com.matt_richardson.gocd.websocket_notifier.GoNotificationPlugin: com.thoughtworks.go.plugin.api.GoPluginIdentifier pluginIdentifier()>/$stringconstant1	$stringconstant1
<com.matt_richardson.gocd.websocket_notifier.GoNotificationPlugin: com.thoughtworks.go.plugin.api.response.GoPluginApiResponse handleNotificationsInterestedIn()>/$stack2	$stack2
<com.matt_richardson.gocd.websocket_notifier.GoNotificationPlugin: com.thoughtworks.go.plugin.api.response.GoPluginApiResponse handleNotificationsInterestedIn()>/$stack3	$stack3
<com.matt_richardson.gocd.websocket_notifier.GoNotificationPlugin: com.thoughtworks.go.plugin.api.response.GoPluginApiResponse handleNotificationsInterestedIn()>/$stack4	$stack4
<com.matt_richardson.gocd.websocket_notifier.GoNotificationPlugin: com.thoughtworks.go.plugin.api.response.GoPluginApiResponse handleNotificationsInterestedIn()>/$stack6	$stack6
<com.matt_richardson.gocd.websocket_notifier.GoNotificationPlugin: com.thoughtworks.go.plugin.api.response.GoPluginApiResponse handleNotificationsInterestedIn()>/this#_0	this#_0
<com.matt_richardson.gocd.websocket_notifier.GoNotificationPlugin: com.thoughtworks.go.plugin.api.response.GoPluginApiResponse handleNotificationsInterestedIn()>/$stack7	$stack7
<com.matt_richardson.gocd.websocket_notifier.GoNotificationPlugin: com.thoughtworks.go.plugin.api.response.GoPluginApiResponse handleNotificationsInterestedIn()>/$stringconstant0	$stringconstant0
<com.matt_richardson.gocd.websocket_notifier.GoNotificationPlugin: com.thoughtworks.go.plugin.api.response.GoPluginApiResponse handleNotificationsInterestedIn()>/$stringconstant1	$stringconstant1
<com.matt_richardson.gocd.websocket_notifier.GoNotificationPlugin: com.thoughtworks.go.plugin.api.response.GoPluginApiResponse handleNotificationsInterestedIn()>/$stringconstant2	$stringconstant2
<com.matt_richardson.gocd.websocket_notifier.GoNotificationPlugin: com.thoughtworks.go.plugin.api.response.GoPluginApiResponse handleNotificationsInterestedIn()>/$numconstant0	$numconstant0
<com.matt_richardson.gocd.websocket_notifier.GoNotificationPlugin: com.thoughtworks.go.plugin.api.response.GoPluginApiResponse handleStageNotification(com.thoughtworks.go.plugin.api.request.GoPluginApiRequest)>/$stack6	$stack6
<com.matt_richardson.gocd.websocket_notifier.GoNotificationPlugin: com.thoughtworks.go.plugin.api.response.GoPluginApiResponse handleStageNotification(com.thoughtworks.go.plugin.api.request.GoPluginApiRequest)>/$stack7	$stack7
<com.matt_richardson.gocd.websocket_notifier.GoNotificationPlugin: com.thoughtworks.go.plugin.api.response.GoPluginApiResponse handleStageNotification(com.thoughtworks.go.plugin.api.request.GoPluginApiRequest)>/$stack8	$stack8
<com.matt_richardson.gocd.websocket_notifier.GoNotificationPlugin: com.thoughtworks.go.plugin.api.response.GoPluginApiResponse handleStageNotification(com.thoughtworks.go.plugin.api.request.GoPluginApiRequest)>/goPluginApiRequest#_0	goPluginApiRequest#_0
<com.matt_richardson.gocd.websocket_notifier.GoNotificationPlugin: com.thoughtworks.go.plugin.api.response.GoPluginApiResponse handleStageNotification(com.thoughtworks.go.plugin.api.request.GoPluginApiRequest)>/$stack10	$stack10
<com.matt_richardson.gocd.websocket_notifier.GoNotificationPlugin: com.thoughtworks.go.plugin.api.response.GoPluginApiResponse handleStageNotification(com.thoughtworks.go.plugin.api.request.GoPluginApiRequest)>/this#_0	this#_0
<com.matt_richardson.gocd.websocket_notifier.GoNotificationPlugin: com.thoughtworks.go.plugin.api.response.GoPluginApiResponse handleStageNotification(com.thoughtworks.go.plugin.api.request.GoPluginApiRequest)>/$stack12	$stack12
<com.matt_richardson.gocd.websocket_notifier.GoNotificationPlugin: com.thoughtworks.go.plugin.api.response.GoPluginApiResponse handleStageNotification(com.thoughtworks.go.plugin.api.request.GoPluginApiRequest)>/$stack13	$stack13
<com.matt_richardson.gocd.websocket_notifier.GoNotificationPlugin: com.thoughtworks.go.plugin.api.response.GoPluginApiResponse handleStageNotification(com.thoughtworks.go.plugin.api.request.GoPluginApiRequest)>/$stack14	$stack14
<com.matt_richardson.gocd.websocket_notifier.GoNotificationPlugin: com.thoughtworks.go.plugin.api.response.GoPluginApiResponse handleStageNotification(com.thoughtworks.go.plugin.api.request.GoPluginApiRequest)>/$stack16	$stack16
<com.matt_richardson.gocd.websocket_notifier.GoNotificationPlugin: com.thoughtworks.go.plugin.api.response.GoPluginApiResponse handleStageNotification(com.thoughtworks.go.plugin.api.request.GoPluginApiRequest)>/responseCode#_89	responseCode#_89
<com.matt_richardson.gocd.websocket_notifier.GoNotificationPlugin: com.thoughtworks.go.plugin.api.response.GoPluginApiResponse handleStageNotification(com.thoughtworks.go.plugin.api.request.GoPluginApiRequest)>/responseCode_$$A_1#_98	responseCode_$$A_1#_98
<com.matt_richardson.gocd.websocket_notifier.GoNotificationPlugin: com.thoughtworks.go.plugin.api.response.GoPluginApiResponse handleStageNotification(com.thoughtworks.go.plugin.api.request.GoPluginApiRequest)>/responseCode_$$A_2#_101	responseCode_$$A_2#_101
<com.matt_richardson.gocd.websocket_notifier.GoNotificationPlugin: com.thoughtworks.go.plugin.api.response.GoPluginApiResponse handleStageNotification(com.thoughtworks.go.plugin.api.request.GoPluginApiRequest)>/$stringconstant0	$stringconstant0
<com.matt_richardson.gocd.websocket_notifier.GoNotificationPlugin: com.thoughtworks.go.plugin.api.response.GoPluginApiResponse handleStageNotification(com.thoughtworks.go.plugin.api.request.GoPluginApiRequest)>/$stringconstant1	$stringconstant1
<com.matt_richardson.gocd.websocket_notifier.GoNotificationPlugin: com.thoughtworks.go.plugin.api.response.GoPluginApiResponse handleStageNotification(com.thoughtworks.go.plugin.api.request.GoPluginApiRequest)>/$stringconstant2	$stringconstant2
<com.matt_richardson.gocd.websocket_notifier.GoNotificationPlugin: com.thoughtworks.go.plugin.api.response.GoPluginApiResponse handleStageNotification(com.thoughtworks.go.plugin.api.request.GoPluginApiRequest)>/$stringconstant3	$stringconstant3
<com.matt_richardson.gocd.websocket_notifier.GoNotificationPlugin: com.thoughtworks.go.plugin.api.response.GoPluginApiResponse handleStageNotification(com.thoughtworks.go.plugin.api.request.GoPluginApiRequest)>/$stringconstant4	$stringconstant4
<com.matt_richardson.gocd.websocket_notifier.GoNotificationPlugin: com.thoughtworks.go.plugin.api.response.GoPluginApiResponse handleStageNotification(com.thoughtworks.go.plugin.api.request.GoPluginApiRequest)>/$stringconstant5	$stringconstant5
<com.matt_richardson.gocd.websocket_notifier.GoNotificationPlugin: com.thoughtworks.go.plugin.api.response.GoPluginApiResponse handleStageNotification(com.thoughtworks.go.plugin.api.request.GoPluginApiRequest)>/$stringconstant6	$stringconstant6
<com.matt_richardson.gocd.websocket_notifier.GoNotificationPlugin: com.thoughtworks.go.plugin.api.response.GoPluginApiResponse renderJSON(int,java.lang.Object)>/response#_0	response#_0
<com.matt_richardson.gocd.websocket_notifier.GoNotificationPlugin: com.thoughtworks.go.plugin.api.response.GoPluginApiResponse renderJSON(int,java.lang.Object)>/$stack4	$stack4
<com.matt_richardson.gocd.websocket_notifier.GoNotificationPlugin: com.thoughtworks.go.plugin.api.response.GoPluginApiResponse renderJSON(int,java.lang.Object)>/$stack5	$stack5
<com.matt_richardson.gocd.websocket_notifier.GoNotificationPlugin: com.thoughtworks.go.plugin.api.response.GoPluginApiResponse renderJSON(int,java.lang.Object)>/$stack6	$stack6
<com.matt_richardson.gocd.websocket_notifier.GoNotificationPlugin: com.thoughtworks.go.plugin.api.response.GoPluginApiResponse renderJSON(int,java.lang.Object)>/this#_0	this#_0
<com.matt_richardson.gocd.websocket_notifier.GoNotificationPlugin: com.thoughtworks.go.plugin.api.response.GoPluginApiResponse renderJSON(int,java.lang.Object)>/responseCode#_0	responseCode#_0
<com.matt_richardson.gocd.websocket_notifier.GoNotificationPlugin: com.thoughtworks.go.plugin.api.response.GoPluginApiResponse renderJSON(int,java.lang.Object)>/$stack7	$stack7
<com.matt_richardson.gocd.websocket_notifier.GoNotificationPlugin: com.thoughtworks.go.plugin.api.response.GoPluginApiResponse renderJSON(int,java.lang.Object)>/$stack7_$$A_1	$stack7_$$A_1
<com.matt_richardson.gocd.websocket_notifier.GoNotificationPlugin: com.thoughtworks.go.plugin.api.response.GoPluginApiResponse renderJSON(int,java.lang.Object)>/$stack7_$$A_2	$stack7_$$A_2
<com.matt_richardson.gocd.websocket_notifier.GoNotificationPlugin: void <clinit>()>/$stack0	$stack0
<com.matt_richardson.gocd.websocket_notifier.GoNotificationPlugin: void <clinit>()>/$stack1	$stack1
<com.matt_richardson.gocd.websocket_notifier.GoNotificationPlugin: void <clinit>()>/$stack2	$stack2
<com.matt_richardson.gocd.websocket_notifier.GoNotificationPlugin: void <clinit>()>/$classconstant0	$classconstant0
<com.matt_richardson.gocd.websocket_notifier.GoNotificationPlugin: void <clinit>()>/$stringconstant0	$stringconstant0
<com.matt_richardson.gocd.websocket_notifier.GoNotificationPlugin$1: void <init>(com.matt_richardson.gocd.websocket_notifier.GoNotificationPlugin,int,java.lang.String)>/this#_0	this#_0
<com.matt_richardson.gocd.websocket_notifier.GoNotificationPlugin$1: void <init>(com.matt_richardson.gocd.websocket_notifier.GoNotificationPlugin,int,java.lang.String)>/this$0#_0	this$0#_0
<com.matt_richardson.gocd.websocket_notifier.GoNotificationPlugin$1: void <init>(com.matt_richardson.gocd.websocket_notifier.GoNotificationPlugin,int,java.lang.String)>/l2#_0	l2#_0
<com.matt_richardson.gocd.websocket_notifier.GoNotificationPlugin$1: void <init>(com.matt_richardson.gocd.websocket_notifier.GoNotificationPlugin,int,java.lang.String)>/l3#_0	l3#_0
<com.matt_richardson.gocd.websocket_notifier.GoNotificationPlugin$1: int responseCode()>/this#_0	this#_0
<com.matt_richardson.gocd.websocket_notifier.GoNotificationPlugin$1: int responseCode()>/$stack1	$stack1
<com.matt_richardson.gocd.websocket_notifier.GoNotificationPlugin$1: java.util.Map responseHeaders()>/this#_0	this#_0
<com.matt_richardson.gocd.websocket_notifier.GoNotificationPlugin$1: java.util.Map responseHeaders()>/$null0	$null0
<com.matt_richardson.gocd.websocket_notifier.GoNotificationPlugin$1: java.lang.String responseBody()>/this#_0	this#_0
<com.matt_richardson.gocd.websocket_notifier.GoNotificationPlugin$1: java.lang.String responseBody()>/$stack1	$stack1
<com.matt_richardson.gocd.websocket_notifier.PluginConfig: void <init>()>/this#_0	this#_0
<com.matt_richardson.gocd.websocket_notifier.PluginConfig: void <init>()>/userHome#_22	userHome#_22
<com.matt_richardson.gocd.websocket_notifier.PluginConfig: void <init>()>/$stack4	$stack4
<com.matt_richardson.gocd.websocket_notifier.PluginConfig: void <init>()>/$stack5	$stack5
<com.matt_richardson.gocd.websocket_notifier.PluginConfig: void <init>()>/$stack6	$stack6
<com.matt_richardson.gocd.websocket_notifier.PluginConfig: void <init>()>/$stack7	$stack7
<com.matt_richardson.gocd.websocket_notifier.PluginConfig: void <init>()>/$stack8	$stack8
<com.matt_richardson.gocd.websocket_notifier.PluginConfig: void <init>()>/$stack9	$stack9
<com.matt_richardson.gocd.websocket_notifier.PluginConfig: void <init>()>/$stack10	$stack10
<com.matt_richardson.gocd.websocket_notifier.PluginConfig: void <init>()>/$stack11	$stack11
<com.matt_richardson.gocd.websocket_notifier.PluginConfig: void <init>()>/config#_28	config#_28
<com.matt_richardson.gocd.websocket_notifier.PluginConfig: void <init>()>/$stack12	$stack12
<com.matt_richardson.gocd.websocket_notifier.PluginConfig: void <init>()>/$stack13	$stack13
<com.matt_richardson.gocd.websocket_notifier.PluginConfig: void <init>()>/$stack14	$stack14
<com.matt_richardson.gocd.websocket_notifier.PluginConfig: void <init>()>/$stack15	$stack15
<com.matt_richardson.gocd.websocket_notifier.PluginConfig: void <init>()>/$stack16	$stack16
<com.matt_richardson.gocd.websocket_notifier.PluginConfig: void <init>()>/$stack17	$stack17
<com.matt_richardson.gocd.websocket_notifier.PluginConfig: void <init>()>/$stack18	$stack18
<com.matt_richardson.gocd.websocket_notifier.PluginConfig: void <init>()>/$stack21	$stack21
<com.matt_richardson.gocd.websocket_notifier.PluginConfig: void <init>()>/$stack24	$stack24
<com.matt_richardson.gocd.websocket_notifier.PluginConfig: void <init>()>/$stack27	$stack27
<com.matt_richardson.gocd.websocket_notifier.PluginConfig: void <init>()>/$stack30	$stack30
<com.matt_richardson.gocd.websocket_notifier.PluginConfig: void <init>()>/$stack31	$stack31
<com.matt_richardson.gocd.websocket_notifier.PluginConfig: void <init>()>/$stack32	$stack32
<com.matt_richardson.gocd.websocket_notifier.PluginConfig: void <init>()>/$numconstant0	$numconstant0
<com.matt_richardson.gocd.websocket_notifier.PluginConfig: void <init>()>/$stringconstant0	$stringconstant0
<com.matt_richardson.gocd.websocket_notifier.PluginConfig: void <init>()>/$numconstant1	$numconstant1
<com.matt_richardson.gocd.websocket_notifier.PluginConfig: void <init>()>/$stringconstant1	$stringconstant1
<com.matt_richardson.gocd.websocket_notifier.PluginConfig: void <init>()>/$stringconstant2	$stringconstant2
<com.matt_richardson.gocd.websocket_notifier.PluginConfig: void <init>()>/$stringconstant3	$stringconstant3
<com.matt_richardson.gocd.websocket_notifier.PluginConfig: void <init>()>/$stringconstant4	$stringconstant4
<com.matt_richardson.gocd.websocket_notifier.PluginConfig: void <init>()>/$stringconstant5	$stringconstant5
<com.matt_richardson.gocd.websocket_notifier.PluginConfig: void <init>()>/$stringconstant6	$stringconstant6
<com.matt_richardson.gocd.websocket_notifier.PluginConfig: void <init>()>/$stringconstant7	$stringconstant7
<com.matt_richardson.gocd.websocket_notifier.PluginConfig: void <init>()>/$stringconstant8	$stringconstant8
<com.matt_richardson.gocd.websocket_notifier.PluginConfig: void <init>()>/$stringconstant9	$stringconstant9
<com.matt_richardson.gocd.websocket_notifier.PluginConfig: void <init>()>/$stringconstant10	$stringconstant10
<com.matt_richardson.gocd.websocket_notifier.PluginConfig: void <init>()>/$stringconstant11	$stringconstant11
<com.matt_richardson.gocd.websocket_notifier.PluginConfig: void <init>()>/$stringconstant12	$stringconstant12
<com.matt_richardson.gocd.websocket_notifier.PluginConfig: void <init>()>/$stringconstant13	$stringconstant13
<com.matt_richardson.gocd.websocket_notifier.PluginConfig: void <init>()>/$stringconstant14	$stringconstant14
<com.matt_richardson.gocd.websocket_notifier.PluginConfig: int getPort()>/this#_0	this#_0
<com.matt_richardson.gocd.websocket_notifier.PluginConfig: int getPort()>/$stack1	$stack1
<com.matt_richardson.gocd.websocket_notifier.PluginConfig: void setPort(int)>/this#_0	this#_0
<com.matt_richardson.gocd.websocket_notifier.PluginConfig: void setPort(int)>/port#_0	port#_0
<com.matt_richardson.gocd.websocket_notifier.PluginConfig: java.lang.String getHost()>/this#_0	this#_0
<com.matt_richardson.gocd.websocket_notifier.PluginConfig: java.lang.String getHost()>/$stack1	$stack1
<com.matt_richardson.gocd.websocket_notifier.PluginConfig: void setHost(java.lang.String)>/this#_0	this#_0
<com.matt_richardson.gocd.websocket_notifier.PluginConfig: void setHost(java.lang.String)>/host#_0	host#_0
<com.matt_richardson.gocd.websocket_notifier.PluginConfig: boolean isHostSet()>/this#_0	this#_0
<com.matt_richardson.gocd.websocket_notifier.PluginConfig: boolean isHostSet()>/$stack1	$stack1
<com.matt_richardson.gocd.websocket_notifier.PluginConfig: boolean isHostSet()>/$stack2	$stack2
<com.matt_richardson.gocd.websocket_notifier.PluginConfig: boolean isHostSet()>/$stack3	$stack3
<com.matt_richardson.gocd.websocket_notifier.PluginConfig: boolean isHostSet()>/$stack3_$$A_1	$stack3_$$A_1
<com.matt_richardson.gocd.websocket_notifier.PluginConfig: boolean isHostSet()>/$stack3_$$A_2	$stack3_$$A_2
<com.matt_richardson.gocd.websocket_notifier.PluginConfig: int getGoHttpPort()>/this#_0	this#_0
<com.matt_richardson.gocd.websocket_notifier.PluginConfig: int getGoHttpPort()>/$stack1	$stack1
<com.matt_richardson.gocd.websocket_notifier.PluginConfig: void setGoHttpPort(int)>/this#_0	this#_0
<com.matt_richardson.gocd.websocket_notifier.PluginConfig: void setGoHttpPort(int)>/port#_0	port#_0
<com.matt_richardson.gocd.websocket_notifier.PluginConfig: java.lang.String getGoUser()>/this#_0	this#_0
<com.matt_richardson.gocd.websocket_notifier.PluginConfig: java.lang.String getGoUser()>/$stack1	$stack1
<com.matt_richardson.gocd.websocket_notifier.PluginConfig: void setGoUser(java.lang.String)>/this#_0	this#_0
<com.matt_richardson.gocd.websocket_notifier.PluginConfig: void setGoUser(java.lang.String)>/user#_0	user#_0
<com.matt_richardson.gocd.websocket_notifier.PluginConfig: boolean isGoUserSet()>/this#_0	this#_0
<com.matt_richardson.gocd.websocket_notifier.PluginConfig: boolean isGoUserSet()>/$stack1	$stack1
<com.matt_richardson.gocd.websocket_notifier.PluginConfig: boolean isGoUserSet()>/$stack2	$stack2
<com.matt_richardson.gocd.websocket_notifier.PluginConfig: boolean isGoUserSet()>/$stack2_$$A_1	$stack2_$$A_1
<com.matt_richardson.gocd.websocket_notifier.PluginConfig: boolean isGoUserSet()>/$stack2_$$A_2	$stack2_$$A_2
<com.matt_richardson.gocd.websocket_notifier.PluginConfig: java.lang.String getGoPassword()>/this#_0	this#_0
<com.matt_richardson.gocd.websocket_notifier.PluginConfig: java.lang.String getGoPassword()>/$stack1	$stack1
<com.matt_richardson.gocd.websocket_notifier.PluginConfig: void setGoPassword(java.lang.String)>/this#_0	this#_0
<com.matt_richardson.gocd.websocket_notifier.PluginConfig: void setGoPassword(java.lang.String)>/password#_0	password#_0
<com.matt_richardson.gocd.websocket_notifier.PluginConfig: boolean isGoPasswordSet()>/this#_0	this#_0
<com.matt_richardson.gocd.websocket_notifier.PluginConfig: boolean isGoPasswordSet()>/$stack1	$stack1
<com.matt_richardson.gocd.websocket_notifier.PluginConfig: boolean isGoPasswordSet()>/$stack2	$stack2
<com.matt_richardson.gocd.websocket_notifier.PluginConfig: boolean isGoPasswordSet()>/$stack2_$$A_1	$stack2_$$A_1
<com.matt_richardson.gocd.websocket_notifier.PluginConfig: boolean isGoPasswordSet()>/$stack2_$$A_2	$stack2_$$A_2
<com.matt_richardson.gocd.websocket_notifier.PluginConfig: boolean hasBasicAuth()>/this#_0	this#_0
<com.matt_richardson.gocd.websocket_notifier.PluginConfig: boolean hasBasicAuth()>/$stack1	$stack1
<com.matt_richardson.gocd.websocket_notifier.PluginConfig: boolean hasBasicAuth()>/$stack2	$stack2
<com.matt_richardson.gocd.websocket_notifier.PluginConfig: boolean hasBasicAuth()>/$stack3	$stack3
<com.matt_richardson.gocd.websocket_notifier.PluginConfig: boolean hasBasicAuth()>/$stack3_$$A_1	$stack3_$$A_1
<com.matt_richardson.gocd.websocket_notifier.PluginConfig: boolean hasBasicAuth()>/$stack3_$$A_2	$stack3_$$A_2
<com.matt_richardson.gocd.websocket_notifier.PluginConfig: void <clinit>()>/$stack0	$stack0
<com.matt_richardson.gocd.websocket_notifier.PluginConfig: void <clinit>()>/$classconstant0	$classconstant0
<com.matt_richardson.gocd.websocket_notifier.WebSocketPipelineListener: void <init>(com.matt_richardson.gocd.websocket_notifier.PipelineWebSocketServer,com.matt_richardson.gocd.websocket_notifier.PluginConfig)>/this#_0	this#_0
<com.matt_richardson.gocd.websocket_notifier.WebSocketPipelineListener: void <init>(com.matt_richardson.gocd.websocket_notifier.PipelineWebSocketServer,com.matt_richardson.gocd.websocket_notifier.PluginConfig)>/$stack3	$stack3
<com.matt_richardson.gocd.websocket_notifier.WebSocketPipelineListener: void <init>(com.matt_richardson.gocd.websocket_notifier.PipelineWebSocketServer,com.matt_richardson.gocd.websocket_notifier.PluginConfig)>/webSocketServer#_0	webSocketServer#_0
<com.matt_richardson.gocd.websocket_notifier.WebSocketPipelineListener: void <init>(com.matt_richardson.gocd.websocket_notifier.PipelineWebSocketServer,com.matt_richardson.gocd.websocket_notifier.PluginConfig)>/$stack4	$stack4
<com.matt_richardson.gocd.websocket_notifier.WebSocketPipelineListener: void <init>(com.matt_richardson.gocd.websocket_notifier.PipelineWebSocketServer,com.matt_richardson.gocd.websocket_notifier.PluginConfig)>/pluginConfig#_0	pluginConfig#_0
<com.matt_richardson.gocd.websocket_notifier.WebSocketPipelineListener: void <init>(com.matt_richardson.gocd.websocket_notifier.PipelineWebSocketServer,com.matt_richardson.gocd.websocket_notifier.PluginConfig)>/$classconstant0	$classconstant0
<com.matt_richardson.gocd.websocket_notifier.WebSocketPipelineListener: void notify(com.thoughtworks.go.plugin.api.request.GoPluginApiRequest)>/this#_0	this#_0
<com.matt_richardson.gocd.websocket_notifier.WebSocketPipelineListener: void notify(com.thoughtworks.go.plugin.api.request.GoPluginApiRequest)>/$stack3	$stack3
<com.matt_richardson.gocd.websocket_notifier.WebSocketPipelineListener: void notify(com.thoughtworks.go.plugin.api.request.GoPluginApiRequest)>/$stack4	$stack4
<com.matt_richardson.gocd.websocket_notifier.WebSocketPipelineListener: void notify(com.thoughtworks.go.plugin.api.request.GoPluginApiRequest)>/message#_0	message#_0
<com.matt_richardson.gocd.websocket_notifier.WebSocketPipelineListener: void notify(com.thoughtworks.go.plugin.api.request.GoPluginApiRequest)>/$stack5	$stack5
<com.matt_richardson.gocd.websocket_notifier.WebSocketPipelineListener: void notify(com.thoughtworks.go.plugin.api.request.GoPluginApiRequest)>/$stack6	$stack6
<com.matt_richardson.gocd.websocket_notifier.WebSocketPipelineListener: void notify(com.thoughtworks.go.plugin.api.request.GoPluginApiRequest)>/$stack7	$stack7
<com.matt_richardson.gocd.websocket_notifier.WebSocketPipelineListener: void notify(com.thoughtworks.go.plugin.api.request.GoPluginApiRequest)>/$stack8	$stack8
<com.matt_richardson.gocd.websocket_notifier.WebSocketPipelineListener: void notify(com.thoughtworks.go.plugin.api.request.GoPluginApiRequest)>/$stack9	$stack9
<com.matt_richardson.gocd.websocket_notifier.WebSocketPipelineListener: void notify(com.thoughtworks.go.plugin.api.request.GoPluginApiRequest)>/$stack10	$stack10
<com.matt_richardson.gocd.websocket_notifier.WebSocketPipelineListener: void notify(com.thoughtworks.go.plugin.api.request.GoPluginApiRequest)>/$stack11	$stack11
<com.matt_richardson.gocd.websocket_notifier.WebSocketPipelineListener: void notify(com.thoughtworks.go.plugin.api.request.GoPluginApiRequest)>/$stack12	$stack12
<com.matt_richardson.gocd.websocket_notifier.WebSocketPipelineListener: void notify(com.thoughtworks.go.plugin.api.request.GoPluginApiRequest)>/$stack13	$stack13
<com.matt_richardson.gocd.websocket_notifier.WebSocketPipelineListener: void notify(com.thoughtworks.go.plugin.api.request.GoPluginApiRequest)>/$stack14	$stack14
<com.matt_richardson.gocd.websocket_notifier.WebSocketPipelineListener: void notify(com.thoughtworks.go.plugin.api.request.GoPluginApiRequest)>/expandedMessage#_19	expandedMessage#_19
<com.matt_richardson.gocd.websocket_notifier.WebSocketPipelineListener: void notify(com.thoughtworks.go.plugin.api.request.GoPluginApiRequest)>/$stack15	$stack15
<com.matt_richardson.gocd.websocket_notifier.WebSocketPipelineListener: void notify(com.thoughtworks.go.plugin.api.request.GoPluginApiRequest)>/$stringconstant0	$stringconstant0
<com.matt_richardson.gocd.websocket_notifier.WebSocketPipelineListener: void notify(com.thoughtworks.go.plugin.api.request.GoPluginApiRequest)>/$stringconstant1	$stringconstant1
<com.matt_richardson.gocd.websocket_notifier.WebSocketPipelineListener: void notify(com.thoughtworks.go.plugin.api.request.GoPluginApiRequest)>/$stringconstant2	$stringconstant2
<com.matt_richardson.gocd.websocket_notifier.PipelineDetailsPopulator: void <init>(com.matt_richardson.gocd.websocket_notifier.PluginConfig)>/this#_0	this#_0
<com.matt_richardson.gocd.websocket_notifier.PipelineDetailsPopulator: void <init>(com.matt_richardson.gocd.websocket_notifier.PluginConfig)>/pluginConfig#_0	pluginConfig#_0
<com.matt_richardson.gocd.websocket_notifier.PipelineDetailsPopulator: java.lang.String mergeInPipelineInstanceDetails(com.google.gson.JsonElement,com.google.gson.JsonElement)>/notification#_0	notification#_0
<com.matt_richardson.gocd.websocket_notifier.PipelineDetailsPopulator: java.lang.String mergeInPipelineInstanceDetails(com.google.gson.JsonElement,com.google.gson.JsonElement)>/json#_26	json#_26
<com.matt_richardson.gocd.websocket_notifier.PipelineDetailsPopulator: java.lang.String mergeInPipelineInstanceDetails(com.google.gson.JsonElement,com.google.gson.JsonElement)>/pipelineInstance#_0	pipelineInstance#_0
<com.matt_richardson.gocd.websocket_notifier.PipelineDetailsPopulator: java.lang.String mergeInPipelineInstanceDetails(com.google.gson.JsonElement,com.google.gson.JsonElement)>/$stack4	$stack4
<com.matt_richardson.gocd.websocket_notifier.PipelineDetailsPopulator: java.lang.String mergeInPipelineInstanceDetails(com.google.gson.JsonElement,com.google.gson.JsonElement)>/this#_0	this#_0
<com.matt_richardson.gocd.websocket_notifier.PipelineDetailsPopulator: java.lang.String mergeInPipelineInstanceDetails(com.google.gson.JsonElement,com.google.gson.JsonElement)>/$stringconstant0	$stringconstant0
<com.matt_richardson.gocd.websocket_notifier.PipelineDetailsPopulator: com.google.gson.JsonElement downloadPipelineInstanceDetails(java.lang.String)>/this#_0	this#_0
<com.matt_richardson.gocd.websocket_notifier.PipelineDetailsPopulator: com.google.gson.JsonElement downloadPipelineInstanceDetails(java.lang.String)>/$stack10	$stack10
<com.matt_richardson.gocd.websocket_notifier.PipelineDetailsPopulator: com.google.gson.JsonElement downloadPipelineInstanceDetails(java.lang.String)>/goHttpPort#_32	goHttpPort#_32
<com.matt_richardson.gocd.websocket_notifier.PipelineDetailsPopulator: com.google.gson.JsonElement downloadPipelineInstanceDetails(java.lang.String)>/$stack11	$stack11
<com.matt_richardson.gocd.websocket_notifier.PipelineDetailsPopulator: com.google.gson.JsonElement downloadPipelineInstanceDetails(java.lang.String)>/$stack12	$stack12
<com.matt_richardson.gocd.websocket_notifier.PipelineDetailsPopulator: com.google.gson.JsonElement downloadPipelineInstanceDetails(java.lang.String)>/$stack13	$stack13
<com.matt_richardson.gocd.websocket_notifier.PipelineDetailsPopulator: com.google.gson.JsonElement downloadPipelineInstanceDetails(java.lang.String)>/pipelineName#_0	pipelineName#_0
<com.matt_richardson.gocd.websocket_notifier.PipelineDetailsPopulator: com.google.gson.JsonElement downloadPipelineInstanceDetails(java.lang.String)>/$stack14	$stack14
<com.matt_richardson.gocd.websocket_notifier.PipelineDetailsPopulator: com.google.gson.JsonElement downloadPipelineInstanceDetails(java.lang.String)>/$stack15	$stack15
<com.matt_richardson.gocd.websocket_notifier.PipelineDetailsPopulator: com.google.gson.JsonElement downloadPipelineInstanceDetails(java.lang.String)>/$stack16	$stack16
<com.matt_richardson.gocd.websocket_notifier.PipelineDetailsPopulator: com.google.gson.JsonElement downloadPipelineInstanceDetails(java.lang.String)>/sURL#_33	sURL#_33
<com.matt_richardson.gocd.websocket_notifier.PipelineDetailsPopulator: com.google.gson.JsonElement downloadPipelineInstanceDetails(java.lang.String)>/$stack17	$stack17
<com.matt_richardson.gocd.websocket_notifier.PipelineDetailsPopulator: com.google.gson.JsonElement downloadPipelineInstanceDetails(java.lang.String)>/$stack18	$stack18
<com.matt_richardson.gocd.websocket_notifier.PipelineDetailsPopulator: com.google.gson.JsonElement downloadPipelineInstanceDetails(java.lang.String)>/request#_36	request#_36
<com.matt_richardson.gocd.websocket_notifier.PipelineDetailsPopulator: com.google.gson.JsonElement downloadPipelineInstanceDetails(java.lang.String)>/$stack19	$stack19
<com.matt_richardson.gocd.websocket_notifier.PipelineDetailsPopulator: com.google.gson.JsonElement downloadPipelineInstanceDetails(java.lang.String)>/$stack20	$stack20
<com.matt_richardson.gocd.websocket_notifier.PipelineDetailsPopulator: com.google.gson.JsonElement downloadPipelineInstanceDetails(java.lang.String)>/$stack21	$stack21
<com.matt_richardson.gocd.websocket_notifier.PipelineDetailsPopulator: com.google.gson.JsonElement downloadPipelineInstanceDetails(java.lang.String)>/$stack22	$stack22
<com.matt_richardson.gocd.websocket_notifier.PipelineDetailsPopulator: com.google.gson.JsonElement downloadPipelineInstanceDetails(java.lang.String)>/$stack23	$stack23
<com.matt_richardson.gocd.websocket_notifier.PipelineDetailsPopulator: com.google.gson.JsonElement downloadPipelineInstanceDetails(java.lang.String)>/$stack24	$stack24
<com.matt_richardson.gocd.websocket_notifier.PipelineDetailsPopulator: com.google.gson.JsonElement downloadPipelineInstanceDetails(java.lang.String)>/$stack25	$stack25
<com.matt_richardson.gocd.websocket_notifier.PipelineDetailsPopulator: com.google.gson.JsonElement downloadPipelineInstanceDetails(java.lang.String)>/$stack26	$stack26
<com.matt_richardson.gocd.websocket_notifier.PipelineDetailsPopulator: com.google.gson.JsonElement downloadPipelineInstanceDetails(java.lang.String)>/$stack27	$stack27
<com.matt_richardson.gocd.websocket_notifier.PipelineDetailsPopulator: com.google.gson.JsonElement downloadPipelineInstanceDetails(java.lang.String)>/$stack28	$stack28
<com.matt_richardson.gocd.websocket_notifier.PipelineDetailsPopulator: com.google.gson.JsonElement downloadPipelineInstanceDetails(java.lang.String)>/$stack29	$stack29
<com.matt_richardson.gocd.websocket_notifier.PipelineDetailsPopulator: com.google.gson.JsonElement downloadPipelineInstanceDetails(java.lang.String)>/$stack30	$stack30
<com.matt_richardson.gocd.websocket_notifier.PipelineDetailsPopulator: com.google.gson.JsonElement downloadPipelineInstanceDetails(java.lang.String)>/$stack31	$stack31
<com.matt_richardson.gocd.websocket_notifier.PipelineDetailsPopulator: com.google.gson.JsonElement downloadPipelineInstanceDetails(java.lang.String)>/$stack32	$stack32
<com.matt_richardson.gocd.websocket_notifier.PipelineDetailsPopulator: com.google.gson.JsonElement downloadPipelineInstanceDetails(java.lang.String)>/$stack33	$stack33
<com.matt_richardson.gocd.websocket_notifier.PipelineDetailsPopulator: com.google.gson.JsonElement downloadPipelineInstanceDetails(java.lang.String)>/$stack34	$stack34
<com.matt_richardson.gocd.websocket_notifier.PipelineDetailsPopulator: com.google.gson.JsonElement downloadPipelineInstanceDetails(java.lang.String)>/$stack35	$stack35
<com.matt_richardson.gocd.websocket_notifier.PipelineDetailsPopulator: com.google.gson.JsonElement downloadPipelineInstanceDetails(java.lang.String)>/$stack36	$stack36
<com.matt_richardson.gocd.websocket_notifier.PipelineDetailsPopulator: com.google.gson.JsonElement downloadPipelineInstanceDetails(java.lang.String)>/$stack37	$stack37
<com.matt_richardson.gocd.websocket_notifier.PipelineDetailsPopulator: com.google.gson.JsonElement downloadPipelineInstanceDetails(java.lang.String)>/$stack38	$stack38
<com.matt_richardson.gocd.websocket_notifier.PipelineDetailsPopulator: com.google.gson.JsonElement downloadPipelineInstanceDetails(java.lang.String)>/$stack39	$stack39
<com.matt_richardson.gocd.websocket_notifier.PipelineDetailsPopulator: com.google.gson.JsonElement downloadPipelineInstanceDetails(java.lang.String)>/$stack43	$stack43
<com.matt_richardson.gocd.websocket_notifier.PipelineDetailsPopulator: com.google.gson.JsonElement downloadPipelineInstanceDetails(java.lang.String)>/$stack45	$stack45
<com.matt_richardson.gocd.websocket_notifier.PipelineDetailsPopulator: com.google.gson.JsonElement downloadPipelineInstanceDetails(java.lang.String)>/$stack48	$stack48
<com.matt_richardson.gocd.websocket_notifier.PipelineDetailsPopulator: com.google.gson.JsonElement downloadPipelineInstanceDetails(java.lang.String)>/user#_38	user#_38
<com.matt_richardson.gocd.websocket_notifier.PipelineDetailsPopulator: com.google.gson.JsonElement downloadPipelineInstanceDetails(java.lang.String)>/password#_39	password#_39
<com.matt_richardson.gocd.websocket_notifier.PipelineDetailsPopulator: com.google.gson.JsonElement downloadPipelineInstanceDetails(java.lang.String)>/authString#_41	authString#_41
<com.matt_richardson.gocd.websocket_notifier.PipelineDetailsPopulator: com.google.gson.JsonElement downloadPipelineInstanceDetails(java.lang.String)>/$stringconstant0	$stringconstant0
<com.matt_richardson.gocd.websocket_notifier.PipelineDetailsPopulator: com.google.gson.JsonElement downloadPipelineInstanceDetails(java.lang.String)>/$stringconstant1	$stringconstant1
<com.matt_richardson.gocd.websocket_notifier.PipelineDetailsPopulator: com.google.gson.JsonElement downloadPipelineInstanceDetails(java.lang.String)>/$stringconstant2	$stringconstant2
<com.matt_richardson.gocd.websocket_notifier.PipelineDetailsPopulator: com.google.gson.JsonElement downloadPipelineInstanceDetails(java.lang.String)>/$stringconstant3	$stringconstant3
<com.matt_richardson.gocd.websocket_notifier.PipelineDetailsPopulator: com.google.gson.JsonElement downloadPipelineInstanceDetails(java.lang.String)>/$stringconstant4	$stringconstant4
<com.matt_richardson.gocd.websocket_notifier.PipelineDetailsPopulator: com.google.gson.JsonElement downloadPipelineInstanceDetails(java.lang.String)>/$stringconstant5	$stringconstant5
<com.matt_richardson.gocd.websocket_notifier.PipelineDetailsPopulator: com.google.gson.JsonElement downloadPipelineInstanceDetails(java.lang.String)>/$stringconstant6	$stringconstant6
<com.matt_richardson.gocd.websocket_notifier.PipelineDetailsPopulator: com.google.gson.JsonElement downloadPipelineInstanceDetails(java.lang.String)>/$numconstant0	$numconstant0
<com.matt_richardson.gocd.websocket_notifier.PipelineDetailsPopulator: java.lang.String extendMessageToIncludePipelineDetails(java.lang.String)>/requestBody#_0	requestBody#_0
<com.matt_richardson.gocd.websocket_notifier.PipelineDetailsPopulator: java.lang.String extendMessageToIncludePipelineDetails(java.lang.String)>/$stack8	$stack8
<com.matt_richardson.gocd.websocket_notifier.PipelineDetailsPopulator: java.lang.String extendMessageToIncludePipelineDetails(java.lang.String)>/json#_56	json#_56
<com.matt_richardson.gocd.websocket_notifier.PipelineDetailsPopulator: java.lang.String extendMessageToIncludePipelineDetails(java.lang.String)>/this#_0	this#_0
<com.matt_richardson.gocd.websocket_notifier.PipelineDetailsPopulator: java.lang.String extendMessageToIncludePipelineDetails(java.lang.String)>/$stack9	$stack9
<com.matt_richardson.gocd.websocket_notifier.PipelineDetailsPopulator: java.lang.String extendMessageToIncludePipelineDetails(java.lang.String)>/$stack10	$stack10
<com.matt_richardson.gocd.websocket_notifier.PipelineDetailsPopulator: java.lang.String extendMessageToIncludePipelineDetails(java.lang.String)>/$stack13	$stack13
<com.matt_richardson.gocd.websocket_notifier.PipelineDetailsPopulator: java.lang.String extendMessageToIncludePipelineDetails(java.lang.String)>/$stack18	$stack18
<com.matt_richardson.gocd.websocket_notifier.PipelineDetailsPopulator: java.lang.String extendMessageToIncludePipelineDetails(java.lang.String)>/$stack20	$stack20
<com.matt_richardson.gocd.websocket_notifier.PipelineDetailsPopulator: java.lang.String extendMessageToIncludePipelineDetails(java.lang.String)>/$stack21	$stack21
<com.matt_richardson.gocd.websocket_notifier.PipelineDetailsPopulator: java.lang.String extendMessageToIncludePipelineDetails(java.lang.String)>/$stack22	$stack22
<com.matt_richardson.gocd.websocket_notifier.PipelineDetailsPopulator: java.lang.String extendMessageToIncludePipelineDetails(java.lang.String)>/$stack23	$stack23
<com.matt_richardson.gocd.websocket_notifier.PipelineDetailsPopulator: java.lang.String extendMessageToIncludePipelineDetails(java.lang.String)>/$stack24	$stack24
<com.matt_richardson.gocd.websocket_notifier.PipelineDetailsPopulator: java.lang.String extendMessageToIncludePipelineDetails(java.lang.String)>/result#_58	result#_58
<com.matt_richardson.gocd.websocket_notifier.PipelineDetailsPopulator: java.lang.String extendMessageToIncludePipelineDetails(java.lang.String)>/pipelineName#_60	pipelineName#_60
<com.matt_richardson.gocd.websocket_notifier.PipelineDetailsPopulator: java.lang.String extendMessageToIncludePipelineDetails(java.lang.String)>/pipeline#_63	pipeline#_63
<com.matt_richardson.gocd.websocket_notifier.PipelineDetailsPopulator: java.lang.String extendMessageToIncludePipelineDetails(java.lang.String)>/$u0	$u0
<com.matt_richardson.gocd.websocket_notifier.PipelineDetailsPopulator: java.lang.String extendMessageToIncludePipelineDetails(java.lang.String)>/$u1	$u1
<com.matt_richardson.gocd.websocket_notifier.PipelineDetailsPopulator: java.lang.String extendMessageToIncludePipelineDetails(java.lang.String)>/$r0	$r0
<com.matt_richardson.gocd.websocket_notifier.PipelineDetailsPopulator: java.lang.String extendMessageToIncludePipelineDetails(java.lang.String)>/pipelineName_$$A_1#_64	pipelineName_$$A_1#_64
<com.matt_richardson.gocd.websocket_notifier.PipelineDetailsPopulator: java.lang.String extendMessageToIncludePipelineDetails(java.lang.String)>/pipelineName_$$A_2#_65	pipelineName_$$A_2#_65
<com.matt_richardson.gocd.websocket_notifier.PipelineDetailsPopulator: java.lang.String extendMessageToIncludePipelineDetails(java.lang.String)>/result_$$A_1#_67	result_$$A_1#_67
<com.matt_richardson.gocd.websocket_notifier.PipelineDetailsPopulator: java.lang.String extendMessageToIncludePipelineDetails(java.lang.String)>/pipelineName_$$A_3#_71	pipelineName_$$A_3#_71
<com.matt_richardson.gocd.websocket_notifier.PipelineDetailsPopulator: java.lang.String extendMessageToIncludePipelineDetails(java.lang.String)>/result_$$A_2#_71	result_$$A_2#_71
<com.matt_richardson.gocd.websocket_notifier.PipelineDetailsPopulator: java.lang.String extendMessageToIncludePipelineDetails(java.lang.String)>/pipelineName_$$A_4#_70	pipelineName_$$A_4#_70
<com.matt_richardson.gocd.websocket_notifier.PipelineDetailsPopulator: java.lang.String extendMessageToIncludePipelineDetails(java.lang.String)>/result_$$A_3#_70	result_$$A_3#_70
<com.matt_richardson.gocd.websocket_notifier.PipelineDetailsPopulator: java.lang.String extendMessageToIncludePipelineDetails(java.lang.String)>/$stringconstant0	$stringconstant0
<com.matt_richardson.gocd.websocket_notifier.PipelineDetailsPopulator: java.lang.String extendMessageToIncludePipelineDetails(java.lang.String)>/$stringconstant1	$stringconstant1
<com.matt_richardson.gocd.websocket_notifier.PipelineDetailsPopulator: java.lang.String extendMessageToIncludePipelineDetails(java.lang.String)>/$stringconstant2	$stringconstant2
<com.matt_richardson.gocd.websocket_notifier.PipelineDetailsPopulator: java.lang.String extendMessageToIncludePipelineDetails(java.lang.String)>/$stringconstant3	$stringconstant3
<com.matt_richardson.gocd.websocket_notifier.PipelineDetailsPopulator: java.lang.String extendMessageToIncludePipelineDetails(java.lang.String)>/$stringconstant4	$stringconstant4
<com.matt_richardson.gocd.websocket_notifier.PipelineDetailsPopulator: void <clinit>()>/$stack0	$stack0
<com.matt_richardson.gocd.websocket_notifier.PipelineDetailsPopulator: void <clinit>()>/$classconstant0	$classconstant0
