<com.matt_richardson.gocd.websocket_notifier.PipelineWebSocketServer: void <init>(int)>/@this	<com.matt_richardson.gocd.websocket_notifier.PipelineWebSocketServer: void <init>(int)>
<com.matt_richardson.gocd.websocket_notifier.PipelineWebSocketServer: void <init>(int)>/@parameter0	<com.matt_richardson.gocd.websocket_notifier.PipelineWebSocketServer: void <init>(int)>
<com.matt_richardson.gocd.websocket_notifier.PipelineWebSocketServer: void <init>(int)>/this#_0	<com.matt_richardson.gocd.websocket_notifier.PipelineWebSocketServer: void <init>(int)>
<com.matt_richardson.gocd.websocket_notifier.PipelineWebSocketServer: void <init>(int)>/$stack2	<com.matt_richardson.gocd.websocket_notifier.PipelineWebSocketServer: void <init>(int)>
<com.matt_richardson.gocd.websocket_notifier.PipelineWebSocketServer: void <init>(int)>/port#_0	<com.matt_richardson.gocd.websocket_notifier.PipelineWebSocketServer: void <init>(int)>
<com.matt_richardson.gocd.websocket_notifier.PipelineWebSocketServer: void <init>(int)>/$stack3	<com.matt_richardson.gocd.websocket_notifier.PipelineWebSocketServer: void <init>(int)>
<com.matt_richardson.gocd.websocket_notifier.PipelineWebSocketServer: void <init>(int)>/$classconstant0	<com.matt_richardson.gocd.websocket_notifier.PipelineWebSocketServer: void <init>(int)>
<com.matt_richardson.gocd.websocket_notifier.PipelineWebSocketServer: void <init>(java.lang.String,int)>/@this	<com.matt_richardson.gocd.websocket_notifier.PipelineWebSocketServer: void <init>(java.lang.String,int)>
<com.matt_richardson.gocd.websocket_notifier.PipelineWebSocketServer: void <init>(java.lang.String,int)>/@parameter0	<com.matt_richardson.gocd.websocket_notifier.PipelineWebSocketServer: void <init>(java.lang.String,int)>
<com.matt_richardson.gocd.websocket_notifier.PipelineWebSocketServer: void <init>(java.lang.String,int)>/@parameter1	<com.matt_richardson.gocd.websocket_notifier.PipelineWebSocketServer: void <init>(java.lang.String,int)>
<com.matt_richardson.gocd.websocket_notifier.PipelineWebSocketServer: void <init>(java.lang.String,int)>/this#_0	<com.matt_richardson.gocd.websocket_notifier.PipelineWebSocketServer: void <init>(java.lang.String,int)>
<com.matt_richardson.gocd.websocket_notifier.PipelineWebSocketServer: void <init>(java.lang.String,int)>/$stack3	<com.matt_richardson.gocd.websocket_notifier.PipelineWebSocketServer: void <init>(java.lang.String,int)>
<com.matt_richardson.gocd.websocket_notifier.PipelineWebSocketServer: void <init>(java.lang.String,int)>/host#_0	<com.matt_richardson.gocd.websocket_notifier.PipelineWebSocketServer: void <init>(java.lang.String,int)>
<com.matt_richardson.gocd.websocket_notifier.PipelineWebSocketServer: void <init>(java.lang.String,int)>/port#_0	<com.matt_richardson.gocd.websocket_notifier.PipelineWebSocketServer: void <init>(java.lang.String,int)>
<com.matt_richardson.gocd.websocket_notifier.PipelineWebSocketServer: void <init>(java.lang.String,int)>/$stack4	<com.matt_richardson.gocd.websocket_notifier.PipelineWebSocketServer: void <init>(java.lang.String,int)>
<com.matt_richardson.gocd.websocket_notifier.PipelineWebSocketServer: void <init>(java.lang.String,int)>/$classconstant0	<com.matt_richardson.gocd.websocket_notifier.PipelineWebSocketServer: void <init>(java.lang.String,int)>
<com.matt_richardson.gocd.websocket_notifier.PipelineWebSocketServer: void onOpen(org.java_websocket.WebSocket,org.java_websocket.handshake.ClientHandshake)>/@this	<com.matt_richardson.gocd.websocket_notifier.PipelineWebSocketServer: void onOpen(org.java_websocket.WebSocket,org.java_websocket.handshake.ClientHandshake)>
<com.matt_richardson.gocd.websocket_notifier.PipelineWebSocketServer: void onOpen(org.java_websocket.WebSocket,org.java_websocket.handshake.ClientHandshake)>/@parameter0	<com.matt_richardson.gocd.websocket_notifier.PipelineWebSocketServer: void onOpen(org.java_websocket.WebSocket,org.java_websocket.handshake.ClientHandshake)>
<com.matt_richardson.gocd.websocket_notifier.PipelineWebSocketServer: void onOpen(org.java_websocket.WebSocket,org.java_websocket.handshake.ClientHandshake)>/@parameter1	<com.matt_richardson.gocd.websocket_notifier.PipelineWebSocketServer: void onOpen(org.java_websocket.WebSocket,org.java_websocket.handshake.ClientHandshake)>
<com.matt_richardson.gocd.websocket_notifier.PipelineWebSocketServer: void onOpen(org.java_websocket.WebSocket,org.java_websocket.handshake.ClientHandshake)>/this#_0	<com.matt_richardson.gocd.websocket_notifier.PipelineWebSocketServer: void onOpen(org.java_websocket.WebSocket,org.java_websocket.handshake.ClientHandshake)>
<com.matt_richardson.gocd.websocket_notifier.PipelineWebSocketServer: void onOpen(org.java_websocket.WebSocket,org.java_websocket.handshake.ClientHandshake)>/$stack3	<com.matt_richardson.gocd.websocket_notifier.PipelineWebSocketServer: void onOpen(org.java_websocket.WebSocket,org.java_websocket.handshake.ClientHandshake)>
<com.matt_richardson.gocd.websocket_notifier.PipelineWebSocketServer: void onOpen(org.java_websocket.WebSocket,org.java_websocket.handshake.ClientHandshake)>/$stack4	<com.matt_richardson.gocd.websocket_notifier.PipelineWebSocketServer: void onOpen(org.java_websocket.WebSocket,org.java_websocket.handshake.ClientHandshake)>
<com.matt_richardson.gocd.websocket_notifier.PipelineWebSocketServer: void onOpen(org.java_websocket.WebSocket,org.java_websocket.handshake.ClientHandshake)>/conn#_0	<com.matt_richardson.gocd.websocket_notifier.PipelineWebSocketServer: void onOpen(org.java_websocket.WebSocket,org.java_websocket.handshake.ClientHandshake)>
<com.matt_richardson.gocd.websocket_notifier.PipelineWebSocketServer: void onOpen(org.java_websocket.WebSocket,org.java_websocket.handshake.ClientHandshake)>/$stack5	<com.matt_richardson.gocd.websocket_notifier.PipelineWebSocketServer: void onOpen(org.java_websocket.WebSocket,org.java_websocket.handshake.ClientHandshake)>
<com.matt_richardson.gocd.websocket_notifier.PipelineWebSocketServer: void onOpen(org.java_websocket.WebSocket,org.java_websocket.handshake.ClientHandshake)>/$stack6	<com.matt_richardson.gocd.websocket_notifier.PipelineWebSocketServer: void onOpen(org.java_websocket.WebSocket,org.java_websocket.handshake.ClientHandshake)>
<com.matt_richardson.gocd.websocket_notifier.PipelineWebSocketServer: void onOpen(org.java_websocket.WebSocket,org.java_websocket.handshake.ClientHandshake)>/$stack7	<com.matt_richardson.gocd.websocket_notifier.PipelineWebSocketServer: void onOpen(org.java_websocket.WebSocket,org.java_websocket.handshake.ClientHandshake)>
<com.matt_richardson.gocd.websocket_notifier.PipelineWebSocketServer: void onOpen(org.java_websocket.WebSocket,org.java_websocket.handshake.ClientHandshake)>/$stack8	<com.matt_richardson.gocd.websocket_notifier.PipelineWebSocketServer: void onOpen(org.java_websocket.WebSocket,org.java_websocket.handshake.ClientHandshake)>
<com.matt_richardson.gocd.websocket_notifier.PipelineWebSocketServer: void onOpen(org.java_websocket.WebSocket,org.java_websocket.handshake.ClientHandshake)>/$stack9	<com.matt_richardson.gocd.websocket_notifier.PipelineWebSocketServer: void onOpen(org.java_websocket.WebSocket,org.java_websocket.handshake.ClientHandshake)>
<com.matt_richardson.gocd.websocket_notifier.PipelineWebSocketServer: void onOpen(org.java_websocket.WebSocket,org.java_websocket.handshake.ClientHandshake)>/$stack10	<com.matt_richardson.gocd.websocket_notifier.PipelineWebSocketServer: void onOpen(org.java_websocket.WebSocket,org.java_websocket.handshake.ClientHandshake)>
<com.matt_richardson.gocd.websocket_notifier.PipelineWebSocketServer: void onOpen(org.java_websocket.WebSocket,org.java_websocket.handshake.ClientHandshake)>/handshake#_0	<com.matt_richardson.gocd.websocket_notifier.PipelineWebSocketServer: void onOpen(org.java_websocket.WebSocket,org.java_websocket.handshake.ClientHandshake)>
<com.matt_richardson.gocd.websocket_notifier.PipelineWebSocketServer: void onOpen(org.java_websocket.WebSocket,org.java_websocket.handshake.ClientHandshake)>/$stringconstant0	<com.matt_richardson.gocd.websocket_notifier.PipelineWebSocketServer: void onOpen(org.java_websocket.WebSocket,org.java_websocket.handshake.ClientHandshake)>
<com.matt_richardson.gocd.websocket_notifier.PipelineWebSocketServer: void onClose(org.java_websocket.WebSocket,int,java.lang.String,boolean)>/@this	<com.matt_richardson.gocd.websocket_notifier.PipelineWebSocketServer: void onClose(org.java_websocket.WebSocket,int,java.lang.String,boolean)>
<com.matt_richardson.gocd.websocket_notifier.PipelineWebSocketServer: void onClose(org.java_websocket.WebSocket,int,java.lang.String,boolean)>/@parameter0	<com.matt_richardson.gocd.websocket_notifier.PipelineWebSocketServer: void onClose(org.java_websocket.WebSocket,int,java.lang.String,boolean)>
<com.matt_richardson.gocd.websocket_notifier.PipelineWebSocketServer: void onClose(org.java_websocket.WebSocket,int,java.lang.String,boolean)>/@parameter1	<com.matt_richardson.gocd.websocket_notifier.PipelineWebSocketServer: void onClose(org.java_websocket.WebSocket,int,java.lang.String,boolean)>
<com.matt_richardson.gocd.websocket_notifier.PipelineWebSocketServer: void onClose(org.java_websocket.WebSocket,int,java.lang.String,boolean)>/@parameter2	<com.matt_richardson.gocd.websocket_notifier.PipelineWebSocketServer: void onClose(org.java_websocket.WebSocket,int,java.lang.String,boolean)>
<com.matt_richardson.gocd.websocket_notifier.PipelineWebSocketServer: void onClose(org.java_websocket.WebSocket,int,java.lang.String,boolean)>/@parameter3	<com.matt_richardson.gocd.websocket_notifier.PipelineWebSocketServer: void onClose(org.java_websocket.WebSocket,int,java.lang.String,boolean)>
<com.matt_richardson.gocd.websocket_notifier.PipelineWebSocketServer: void onClose(org.java_websocket.WebSocket,int,java.lang.String,boolean)>/this#_0	<com.matt_richardson.gocd.websocket_notifier.PipelineWebSocketServer: void onClose(org.java_websocket.WebSocket,int,java.lang.String,boolean)>
<com.matt_richardson.gocd.websocket_notifier.PipelineWebSocketServer: void onClose(org.java_websocket.WebSocket,int,java.lang.String,boolean)>/$stack5	<com.matt_richardson.gocd.websocket_notifier.PipelineWebSocketServer: void onClose(org.java_websocket.WebSocket,int,java.lang.String,boolean)>
<com.matt_richardson.gocd.websocket_notifier.PipelineWebSocketServer: void onClose(org.java_websocket.WebSocket,int,java.lang.String,boolean)>/$stack6	<com.matt_richardson.gocd.websocket_notifier.PipelineWebSocketServer: void onClose(org.java_websocket.WebSocket,int,java.lang.String,boolean)>
<com.matt_richardson.gocd.websocket_notifier.PipelineWebSocketServer: void onClose(org.java_websocket.WebSocket,int,java.lang.String,boolean)>/conn#_0	<com.matt_richardson.gocd.websocket_notifier.PipelineWebSocketServer: void onClose(org.java_websocket.WebSocket,int,java.lang.String,boolean)>
<com.matt_richardson.gocd.websocket_notifier.PipelineWebSocketServer: void onClose(org.java_websocket.WebSocket,int,java.lang.String,boolean)>/$stack7	<com.matt_richardson.gocd.websocket_notifier.PipelineWebSocketServer: void onClose(org.java_websocket.WebSocket,int,java.lang.String,boolean)>
<com.matt_richardson.gocd.websocket_notifier.PipelineWebSocketServer: void onClose(org.java_websocket.WebSocket,int,java.lang.String,boolean)>/$stack8	<com.matt_richardson.gocd.websocket_notifier.PipelineWebSocketServer: void onClose(org.java_websocket.WebSocket,int,java.lang.String,boolean)>
<com.matt_richardson.gocd.websocket_notifier.PipelineWebSocketServer: void onClose(org.java_websocket.WebSocket,int,java.lang.String,boolean)>/$stack9	<com.matt_richardson.gocd.websocket_notifier.PipelineWebSocketServer: void onClose(org.java_websocket.WebSocket,int,java.lang.String,boolean)>
<com.matt_richardson.gocd.websocket_notifier.PipelineWebSocketServer: void onClose(org.java_websocket.WebSocket,int,java.lang.String,boolean)>/code#_0	<com.matt_richardson.gocd.websocket_notifier.PipelineWebSocketServer: void onClose(org.java_websocket.WebSocket,int,java.lang.String,boolean)>
<com.matt_richardson.gocd.websocket_notifier.PipelineWebSocketServer: void onClose(org.java_websocket.WebSocket,int,java.lang.String,boolean)>/reason#_0	<com.matt_richardson.gocd.websocket_notifier.PipelineWebSocketServer: void onClose(org.java_websocket.WebSocket,int,java.lang.String,boolean)>
<com.matt_richardson.gocd.websocket_notifier.PipelineWebSocketServer: void onClose(org.java_websocket.WebSocket,int,java.lang.String,boolean)>/remote#_0	<com.matt_richardson.gocd.websocket_notifier.PipelineWebSocketServer: void onClose(org.java_websocket.WebSocket,int,java.lang.String,boolean)>
<com.matt_richardson.gocd.websocket_notifier.PipelineWebSocketServer: void onClose(org.java_websocket.WebSocket,int,java.lang.String,boolean)>/$stringconstant0	<com.matt_richardson.gocd.websocket_notifier.PipelineWebSocketServer: void onClose(org.java_websocket.WebSocket,int,java.lang.String,boolean)>
<com.matt_richardson.gocd.websocket_notifier.PipelineWebSocketServer: void onMessage(org.java_websocket.WebSocket,java.lang.String)>/@this	<com.matt_richardson.gocd.websocket_notifier.PipelineWebSocketServer: void onMessage(org.java_websocket.WebSocket,java.lang.String)>
<com.matt_richardson.gocd.websocket_notifier.PipelineWebSocketServer: void onMessage(org.java_websocket.WebSocket,java.lang.String)>/@parameter0	<com.matt_richardson.gocd.websocket_notifier.PipelineWebSocketServer: void onMessage(org.java_websocket.WebSocket,java.lang.String)>
<com.matt_richardson.gocd.websocket_notifier.PipelineWebSocketServer: void onMessage(org.java_websocket.WebSocket,java.lang.String)>/@parameter1	<com.matt_richardson.gocd.websocket_notifier.PipelineWebSocketServer: void onMessage(org.java_websocket.WebSocket,java.lang.String)>
<com.matt_richardson.gocd.websocket_notifier.PipelineWebSocketServer: void onMessage(org.java_websocket.WebSocket,java.lang.String)>/this#_0	<com.matt_richardson.gocd.websocket_notifier.PipelineWebSocketServer: void onMessage(org.java_websocket.WebSocket,java.lang.String)>
<com.matt_richardson.gocd.websocket_notifier.PipelineWebSocketServer: void onMessage(org.java_websocket.WebSocket,java.lang.String)>/conn#_0	<com.matt_richardson.gocd.websocket_notifier.PipelineWebSocketServer: void onMessage(org.java_websocket.WebSocket,java.lang.String)>
<com.matt_richardson.gocd.websocket_notifier.PipelineWebSocketServer: void onMessage(org.java_websocket.WebSocket,java.lang.String)>/message#_0	<com.matt_richardson.gocd.websocket_notifier.PipelineWebSocketServer: void onMessage(org.java_websocket.WebSocket,java.lang.String)>
<com.matt_richardson.gocd.websocket_notifier.PipelineWebSocketServer: void onError(org.java_websocket.WebSocket,java.lang.Exception)>/@this	<com.matt_richardson.gocd.websocket_notifier.PipelineWebSocketServer: void onError(org.java_websocket.WebSocket,java.lang.Exception)>
<com.matt_richardson.gocd.websocket_notifier.PipelineWebSocketServer: void onError(org.java_websocket.WebSocket,java.lang.Exception)>/@parameter0	<com.matt_richardson.gocd.websocket_notifier.PipelineWebSocketServer: void onError(org.java_websocket.WebSocket,java.lang.Exception)>
<com.matt_richardson.gocd.websocket_notifier.PipelineWebSocketServer: void onError(org.java_websocket.WebSocket,java.lang.Exception)>/@parameter1	<com.matt_richardson.gocd.websocket_notifier.PipelineWebSocketServer: void onError(org.java_websocket.WebSocket,java.lang.Exception)>
<com.matt_richardson.gocd.websocket_notifier.PipelineWebSocketServer: void onError(org.java_websocket.WebSocket,java.lang.Exception)>/this#_0	<com.matt_richardson.gocd.websocket_notifier.PipelineWebSocketServer: void onError(org.java_websocket.WebSocket,java.lang.Exception)>
<com.matt_richardson.gocd.websocket_notifier.PipelineWebSocketServer: void onError(org.java_websocket.WebSocket,java.lang.Exception)>/ex#_0	<com.matt_richardson.gocd.websocket_notifier.PipelineWebSocketServer: void onError(org.java_websocket.WebSocket,java.lang.Exception)>
<com.matt_richardson.gocd.websocket_notifier.PipelineWebSocketServer: void onError(org.java_websocket.WebSocket,java.lang.Exception)>/$stack3	<com.matt_richardson.gocd.websocket_notifier.PipelineWebSocketServer: void onError(org.java_websocket.WebSocket,java.lang.Exception)>
<com.matt_richardson.gocd.websocket_notifier.PipelineWebSocketServer: void onError(org.java_websocket.WebSocket,java.lang.Exception)>/conn#_0	<com.matt_richardson.gocd.websocket_notifier.PipelineWebSocketServer: void onError(org.java_websocket.WebSocket,java.lang.Exception)>
<com.matt_richardson.gocd.websocket_notifier.PipelineWebSocketServer: void onError(org.java_websocket.WebSocket,java.lang.Exception)>/$stringconstant0	<com.matt_richardson.gocd.websocket_notifier.PipelineWebSocketServer: void onError(org.java_websocket.WebSocket,java.lang.Exception)>
<com.matt_richardson.gocd.websocket_notifier.PipelineWebSocketServer: void sendToAll(java.lang.String)>/@this	<com.matt_richardson.gocd.websocket_notifier.PipelineWebSocketServer: void sendToAll(java.lang.String)>
<com.matt_richardson.gocd.websocket_notifier.PipelineWebSocketServer: void sendToAll(java.lang.String)>/@parameter0	<com.matt_richardson.gocd.websocket_notifier.PipelineWebSocketServer: void sendToAll(java.lang.String)>
<com.matt_richardson.gocd.websocket_notifier.PipelineWebSocketServer: void sendToAll(java.lang.String)>/this#_0	<com.matt_richardson.gocd.websocket_notifier.PipelineWebSocketServer: void sendToAll(java.lang.String)>
<com.matt_richardson.gocd.websocket_notifier.PipelineWebSocketServer: void sendToAll(java.lang.String)>/con#_42	<com.matt_richardson.gocd.websocket_notifier.PipelineWebSocketServer: void sendToAll(java.lang.String)>
<com.matt_richardson.gocd.websocket_notifier.PipelineWebSocketServer: void sendToAll(java.lang.String)>/l4#_44	<com.matt_richardson.gocd.websocket_notifier.PipelineWebSocketServer: void sendToAll(java.lang.String)>
<com.matt_richardson.gocd.websocket_notifier.PipelineWebSocketServer: void sendToAll(java.lang.String)>/$stack8	<com.matt_richardson.gocd.websocket_notifier.PipelineWebSocketServer: void sendToAll(java.lang.String)>
<com.matt_richardson.gocd.websocket_notifier.PipelineWebSocketServer: void sendToAll(java.lang.String)>/$stack10	<com.matt_richardson.gocd.websocket_notifier.PipelineWebSocketServer: void sendToAll(java.lang.String)>
<com.matt_richardson.gocd.websocket_notifier.PipelineWebSocketServer: void sendToAll(java.lang.String)>/c#_44	<com.matt_richardson.gocd.websocket_notifier.PipelineWebSocketServer: void sendToAll(java.lang.String)>
<com.matt_richardson.gocd.websocket_notifier.PipelineWebSocketServer: void sendToAll(java.lang.String)>/$stack11	<com.matt_richardson.gocd.websocket_notifier.PipelineWebSocketServer: void sendToAll(java.lang.String)>
<com.matt_richardson.gocd.websocket_notifier.PipelineWebSocketServer: void sendToAll(java.lang.String)>/$stack12	<com.matt_richardson.gocd.websocket_notifier.PipelineWebSocketServer: void sendToAll(java.lang.String)>
<com.matt_richardson.gocd.websocket_notifier.PipelineWebSocketServer: void sendToAll(java.lang.String)>/text#_0	<com.matt_richardson.gocd.websocket_notifier.PipelineWebSocketServer: void sendToAll(java.lang.String)>
<com.matt_richardson.gocd.websocket_notifier.PipelineWebSocketServer: void sendToAll(java.lang.String)>/$stack13	<com.matt_richardson.gocd.websocket_notifier.PipelineWebSocketServer: void sendToAll(java.lang.String)>
<com.matt_richardson.gocd.websocket_notifier.PipelineWebSocketServer: void sendToAll(java.lang.String)>/$stack14	<com.matt_richardson.gocd.websocket_notifier.PipelineWebSocketServer: void sendToAll(java.lang.String)>
<com.matt_richardson.gocd.websocket_notifier.PipelineWebSocketServer: void sendToAll(java.lang.String)>/$stack15	<com.matt_richardson.gocd.websocket_notifier.PipelineWebSocketServer: void sendToAll(java.lang.String)>
<com.matt_richardson.gocd.websocket_notifier.PipelineWebSocketServer: void sendToAll(java.lang.String)>/$stack16	<com.matt_richardson.gocd.websocket_notifier.PipelineWebSocketServer: void sendToAll(java.lang.String)>
<com.matt_richardson.gocd.websocket_notifier.PipelineWebSocketServer: void sendToAll(java.lang.String)>/$stack17	<com.matt_richardson.gocd.websocket_notifier.PipelineWebSocketServer: void sendToAll(java.lang.String)>
<com.matt_richardson.gocd.websocket_notifier.PipelineWebSocketServer: void sendToAll(java.lang.String)>/$stack19	<com.matt_richardson.gocd.websocket_notifier.PipelineWebSocketServer: void sendToAll(java.lang.String)>
<com.matt_richardson.gocd.websocket_notifier.PipelineWebSocketServer: void sendToAll(java.lang.String)>/$stringconstant0	<com.matt_richardson.gocd.websocket_notifier.PipelineWebSocketServer: void sendToAll(java.lang.String)>
<com.matt_richardson.gocd.websocket_notifier.PipelineWebSocketServer: void sendToAll(java.lang.String)>/$stringconstant1	<com.matt_richardson.gocd.websocket_notifier.PipelineWebSocketServer: void sendToAll(java.lang.String)>
<com.matt_richardson.gocd.websocket_notifier.GoNotificationPlugin: void initializeGoApplicationAccessor(com.thoughtworks.go.plugin.api.GoApplicationAccessor)>/@this	<com.matt_richardson.gocd.websocket_notifier.GoNotificationPlugin: void initializeGoApplicationAccessor(com.thoughtworks.go.plugin.api.GoApplicationAccessor)>
<com.matt_richardson.gocd.websocket_notifier.GoNotificationPlugin: void initializeGoApplicationAccessor(com.thoughtworks.go.plugin.api.GoApplicationAccessor)>/@parameter0	<com.matt_richardson.gocd.websocket_notifier.GoNotificationPlugin: void initializeGoApplicationAccessor(com.thoughtworks.go.plugin.api.GoApplicationAccessor)>
<com.matt_richardson.gocd.websocket_notifier.GoNotificationPlugin: void initializeGoApplicationAccessor(com.thoughtworks.go.plugin.api.GoApplicationAccessor)>/$stack7	<com.matt_richardson.gocd.websocket_notifier.GoNotificationPlugin: void initializeGoApplicationAccessor(com.thoughtworks.go.plugin.api.GoApplicationAccessor)>
<com.matt_richardson.gocd.websocket_notifier.GoNotificationPlugin: void initializeGoApplicationAccessor(com.thoughtworks.go.plugin.api.GoApplicationAccessor)>/$stack8	<com.matt_richardson.gocd.websocket_notifier.GoNotificationPlugin: void initializeGoApplicationAccessor(com.thoughtworks.go.plugin.api.GoApplicationAccessor)>
<com.matt_richardson.gocd.websocket_notifier.GoNotificationPlugin: void initializeGoApplicationAccessor(com.thoughtworks.go.plugin.api.GoApplicationAccessor)>/port#_30	<com.matt_richardson.gocd.websocket_notifier.GoNotificationPlugin: void initializeGoApplicationAccessor(com.thoughtworks.go.plugin.api.GoApplicationAccessor)>
<com.matt_richardson.gocd.websocket_notifier.GoNotificationPlugin: void initializeGoApplicationAccessor(com.thoughtworks.go.plugin.api.GoApplicationAccessor)>/host#_31	<com.matt_richardson.gocd.websocket_notifier.GoNotificationPlugin: void initializeGoApplicationAccessor(com.thoughtworks.go.plugin.api.GoApplicationAccessor)>
<com.matt_richardson.gocd.websocket_notifier.GoNotificationPlugin: void initializeGoApplicationAccessor(com.thoughtworks.go.plugin.api.GoApplicationAccessor)>/$stack9	<com.matt_richardson.gocd.websocket_notifier.GoNotificationPlugin: void initializeGoApplicationAccessor(com.thoughtworks.go.plugin.api.GoApplicationAccessor)>
<com.matt_richardson.gocd.websocket_notifier.GoNotificationPlugin: void initializeGoApplicationAccessor(com.thoughtworks.go.plugin.api.GoApplicationAccessor)>/$stack10	<com.matt_richardson.gocd.websocket_notifier.GoNotificationPlugin: void initializeGoApplicationAccessor(com.thoughtworks.go.plugin.api.GoApplicationAccessor)>
<com.matt_richardson.gocd.websocket_notifier.GoNotificationPlugin: void initializeGoApplicationAccessor(com.thoughtworks.go.plugin.api.GoApplicationAccessor)>/$stack11	<com.matt_richardson.gocd.websocket_notifier.GoNotificationPlugin: void initializeGoApplicationAccessor(com.thoughtworks.go.plugin.api.GoApplicationAccessor)>
<com.matt_richardson.gocd.websocket_notifier.GoNotificationPlugin: void initializeGoApplicationAccessor(com.thoughtworks.go.plugin.api.GoApplicationAccessor)>/$stack12	<com.matt_richardson.gocd.websocket_notifier.GoNotificationPlugin: void initializeGoApplicationAccessor(com.thoughtworks.go.plugin.api.GoApplicationAccessor)>
<com.matt_richardson.gocd.websocket_notifier.GoNotificationPlugin: void initializeGoApplicationAccessor(com.thoughtworks.go.plugin.api.GoApplicationAccessor)>/$stack13	<com.matt_richardson.gocd.websocket_notifier.GoNotificationPlugin: void initializeGoApplicationAccessor(com.thoughtworks.go.plugin.api.GoApplicationAccessor)>
<com.matt_richardson.gocd.websocket_notifier.GoNotificationPlugin: void initializeGoApplicationAccessor(com.thoughtworks.go.plugin.api.GoApplicationAccessor)>/$stack14	<com.matt_richardson.gocd.websocket_notifier.GoNotificationPlugin: void initializeGoApplicationAccessor(com.thoughtworks.go.plugin.api.GoApplicationAccessor)>
<com.matt_richardson.gocd.websocket_notifier.GoNotificationPlugin: void initializeGoApplicationAccessor(com.thoughtworks.go.plugin.api.GoApplicationAccessor)>/$stack15	<com.matt_richardson.gocd.websocket_notifier.GoNotificationPlugin: void initializeGoApplicationAccessor(com.thoughtworks.go.plugin.api.GoApplicationAccessor)>
<com.matt_richardson.gocd.websocket_notifier.GoNotificationPlugin: void initializeGoApplicationAccessor(com.thoughtworks.go.plugin.api.GoApplicationAccessor)>/$stack16	<com.matt_richardson.gocd.websocket_notifier.GoNotificationPlugin: void initializeGoApplicationAccessor(com.thoughtworks.go.plugin.api.GoApplicationAccessor)>
<com.matt_richardson.gocd.websocket_notifier.GoNotificationPlugin: void initializeGoApplicationAccessor(com.thoughtworks.go.plugin.api.GoApplicationAccessor)>/$stack17	<com.matt_richardson.gocd.websocket_notifier.GoNotificationPlugin: void initializeGoApplicationAccessor(com.thoughtworks.go.plugin.api.GoApplicationAccessor)>
<com.matt_richardson.gocd.websocket_notifier.GoNotificationPlugin: void initializeGoApplicationAccessor(com.thoughtworks.go.plugin.api.GoApplicationAccessor)>/$stack18	<com.matt_richardson.gocd.websocket_notifier.GoNotificationPlugin: void initializeGoApplicationAccessor(com.thoughtworks.go.plugin.api.GoApplicationAccessor)>
<com.matt_richardson.gocd.websocket_notifier.GoNotificationPlugin: void initializeGoApplicationAccessor(com.thoughtworks.go.plugin.api.GoApplicationAccessor)>/$stack19	<com.matt_richardson.gocd.websocket_notifier.GoNotificationPlugin: void initializeGoApplicationAccessor(com.thoughtworks.go.plugin.api.GoApplicationAccessor)>
<com.matt_richardson.gocd.websocket_notifier.GoNotificationPlugin: void initializeGoApplicationAccessor(com.thoughtworks.go.plugin.api.GoApplicationAccessor)>/$stack20	<com.matt_richardson.gocd.websocket_notifier.GoNotificationPlugin: void initializeGoApplicationAccessor(com.thoughtworks.go.plugin.api.GoApplicationAccessor)>
<com.matt_richardson.gocd.websocket_notifier.GoNotificationPlugin: void initializeGoApplicationAccessor(com.thoughtworks.go.plugin.api.GoApplicationAccessor)>/$stack21	<com.matt_richardson.gocd.websocket_notifier.GoNotificationPlugin: void initializeGoApplicationAccessor(com.thoughtworks.go.plugin.api.GoApplicationAccessor)>
<com.matt_richardson.gocd.websocket_notifier.GoNotificationPlugin: void initializeGoApplicationAccessor(com.thoughtworks.go.plugin.api.GoApplicationAccessor)>/$stack22	<com.matt_richardson.gocd.websocket_notifier.GoNotificationPlugin: void initializeGoApplicationAccessor(com.thoughtworks.go.plugin.api.GoApplicationAccessor)>
<com.matt_richardson.gocd.websocket_notifier.GoNotificationPlugin: void initializeGoApplicationAccessor(com.thoughtworks.go.plugin.api.GoApplicationAccessor)>/$stack23	<com.matt_richardson.gocd.websocket_notifier.GoNotificationPlugin: void initializeGoApplicationAccessor(com.thoughtworks.go.plugin.api.GoApplicationAccessor)>
<com.matt_richardson.gocd.websocket_notifier.GoNotificationPlugin: void initializeGoApplicationAccessor(com.thoughtworks.go.plugin.api.GoApplicationAccessor)>/$stack29	<com.matt_richardson.gocd.websocket_notifier.GoNotificationPlugin: void initializeGoApplicationAccessor(com.thoughtworks.go.plugin.api.GoApplicationAccessor)>
<com.matt_richardson.gocd.websocket_notifier.GoNotificationPlugin: void initializeGoApplicationAccessor(com.thoughtworks.go.plugin.api.GoApplicationAccessor)>/$stack30	<com.matt_richardson.gocd.websocket_notifier.GoNotificationPlugin: void initializeGoApplicationAccessor(com.thoughtworks.go.plugin.api.GoApplicationAccessor)>
<com.matt_richardson.gocd.websocket_notifier.GoNotificationPlugin: void initializeGoApplicationAccessor(com.thoughtworks.go.plugin.api.GoApplicationAccessor)>/$stack31	<com.matt_richardson.gocd.websocket_notifier.GoNotificationPlugin: void initializeGoApplicationAccessor(com.thoughtworks.go.plugin.api.GoApplicationAccessor)>
<com.matt_richardson.gocd.websocket_notifier.GoNotificationPlugin: void initializeGoApplicationAccessor(com.thoughtworks.go.plugin.api.GoApplicationAccessor)>/$stack32	<com.matt_richardson.gocd.websocket_notifier.GoNotificationPlugin: void initializeGoApplicationAccessor(com.thoughtworks.go.plugin.api.GoApplicationAccessor)>
<com.matt_richardson.gocd.websocket_notifier.GoNotificationPlugin: void initializeGoApplicationAccessor(com.thoughtworks.go.plugin.api.GoApplicationAccessor)>/$stack33	<com.matt_richardson.gocd.websocket_notifier.GoNotificationPlugin: void initializeGoApplicationAccessor(com.thoughtworks.go.plugin.api.GoApplicationAccessor)>
<com.matt_richardson.gocd.websocket_notifier.GoNotificationPlugin: void initializeGoApplicationAccessor(com.thoughtworks.go.plugin.api.GoApplicationAccessor)>/$stack34	<com.matt_richardson.gocd.websocket_notifier.GoNotificationPlugin: void initializeGoApplicationAccessor(com.thoughtworks.go.plugin.api.GoApplicationAccessor)>
<com.matt_richardson.gocd.websocket_notifier.GoNotificationPlugin: void initializeGoApplicationAccessor(com.thoughtworks.go.plugin.api.GoApplicationAccessor)>/this#_0	<com.matt_richardson.gocd.websocket_notifier.GoNotificationPlugin: void initializeGoApplicationAccessor(com.thoughtworks.go.plugin.api.GoApplicationAccessor)>
<com.matt_richardson.gocd.websocket_notifier.GoNotificationPlugin: void initializeGoApplicationAccessor(com.thoughtworks.go.plugin.api.GoApplicationAccessor)>/goApplicationAccessor#_0	<com.matt_richardson.gocd.websocket_notifier.GoNotificationPlugin: void initializeGoApplicationAccessor(com.thoughtworks.go.plugin.api.GoApplicationAccessor)>
<com.matt_richardson.gocd.websocket_notifier.GoNotificationPlugin: void initializeGoApplicationAccessor(com.thoughtworks.go.plugin.api.GoApplicationAccessor)>/s#_38	<com.matt_richardson.gocd.websocket_notifier.GoNotificationPlugin: void initializeGoApplicationAccessor(com.thoughtworks.go.plugin.api.GoApplicationAccessor)>
<com.matt_richardson.gocd.websocket_notifier.GoNotificationPlugin: void initializeGoApplicationAccessor(com.thoughtworks.go.plugin.api.GoApplicationAccessor)>/s_$$A_1#_40	<com.matt_richardson.gocd.websocket_notifier.GoNotificationPlugin: void initializeGoApplicationAccessor(com.thoughtworks.go.plugin.api.GoApplicationAccessor)>
<com.matt_richardson.gocd.websocket_notifier.GoNotificationPlugin: void initializeGoApplicationAccessor(com.thoughtworks.go.plugin.api.GoApplicationAccessor)>/s_$$A_2#_41	<com.matt_richardson.gocd.websocket_notifier.GoNotificationPlugin: void initializeGoApplicationAccessor(com.thoughtworks.go.plugin.api.GoApplicationAccessor)>
<com.matt_richardson.gocd.websocket_notifier.GoNotificationPlugin: void initializeGoApplicationAccessor(com.thoughtworks.go.plugin.api.GoApplicationAccessor)>/s_$$A_3#_48	<com.matt_richardson.gocd.websocket_notifier.GoNotificationPlugin: void initializeGoApplicationAccessor(com.thoughtworks.go.plugin.api.GoApplicationAccessor)>
<com.matt_richardson.gocd.websocket_notifier.GoNotificationPlugin: void initializeGoApplicationAccessor(com.thoughtworks.go.plugin.api.GoApplicationAccessor)>/s_$$A_4#_47	<com.matt_richardson.gocd.websocket_notifier.GoNotificationPlugin: void initializeGoApplicationAccessor(com.thoughtworks.go.plugin.api.GoApplicationAccessor)>
<com.matt_richardson.gocd.websocket_notifier.GoNotificationPlugin: void initializeGoApplicationAccessor(com.thoughtworks.go.plugin.api.GoApplicationAccessor)>/$stringconstant0	<com.matt_richardson.gocd.websocket_notifier.GoNotificationPlugin: void initializeGoApplicationAccessor(com.thoughtworks.go.plugin.api.GoApplicationAccessor)>
<com.matt_richardson.gocd.websocket_notifier.GoNotificationPlugin: void initializeGoApplicationAccessor(com.thoughtworks.go.plugin.api.GoApplicationAccessor)>/$stringconstant1	<com.matt_richardson.gocd.websocket_notifier.GoNotificationPlugin: void initializeGoApplicationAccessor(com.thoughtworks.go.plugin.api.GoApplicationAccessor)>
<com.matt_richardson.gocd.websocket_notifier.GoNotificationPlugin: void initializeGoApplicationAccessor(com.thoughtworks.go.plugin.api.GoApplicationAccessor)>/$stringconstant2	<com.matt_richardson.gocd.websocket_notifier.GoNotificationPlugin: void initializeGoApplicationAccessor(com.thoughtworks.go.plugin.api.GoApplicationAccessor)>
<com.matt_richardson.gocd.websocket_notifier.GoNotificationPlugin: void <init>()>/@this	<com.matt_richardson.gocd.websocket_notifier.GoNotificationPlugin: void <init>()>
<com.matt_richardson.gocd.websocket_notifier.GoNotificationPlugin: void <init>()>/this#_0	<com.matt_richardson.gocd.websocket_notifier.GoNotificationPlugin: void <init>()>
<com.matt_richardson.gocd.websocket_notifier.GoNotificationPlugin: void <init>(com.matt_richardson.gocd.websocket_notifier.WebSocketPipelineListener)>/@this	<com.matt_richardson.gocd.websocket_notifier.GoNotificationPlugin: void <init>(com.matt_richardson.gocd.websocket_notifier.WebSocketPipelineListener)>
<com.matt_richardson.gocd.websocket_notifier.GoNotificationPlugin: void <init>(com.matt_richardson.gocd.websocket_notifier.WebSocketPipelineListener)>/@parameter0	<com.matt_richardson.gocd.websocket_notifier.GoNotificationPlugin: void <init>(com.matt_richardson.gocd.websocket_notifier.WebSocketPipelineListener)>
<com.matt_richardson.gocd.websocket_notifier.GoNotificationPlugin: void <init>(com.matt_richardson.gocd.websocket_notifier.WebSocketPipelineListener)>/this#_0	<com.matt_richardson.gocd.websocket_notifier.GoNotificationPlugin: void <init>(com.matt_richardson.gocd.websocket_notifier.WebSocketPipelineListener)>
<com.matt_richardson.gocd.websocket_notifier.GoNotificationPlugin: void <init>(com.matt_richardson.gocd.websocket_notifier.WebSocketPipelineListener)>/pipelineListener#_0	<com.matt_richardson.gocd.websocket_notifier.GoNotificationPlugin: void <init>(com.matt_richardson.gocd.websocket_notifier.WebSocketPipelineListener)>
<com.matt_richardson.gocd.websocket_notifier.GoNotificationPlugin: com.thoughtworks.go.plugin.api.response.GoPluginApiResponse handle(com.thoughtworks.go.plugin.api.request.GoPluginApiRequest)>/@this	<com.matt_richardson.gocd.websocket_notifier.GoNotificationPlugin: com.thoughtworks.go.plugin.api.response.GoPluginApiResponse handle(com.thoughtworks.go.plugin.api.request.GoPluginApiRequest)>
<com.matt_richardson.gocd.websocket_notifier.GoNotificationPlugin: com.thoughtworks.go.plugin.api.response.GoPluginApiResponse handle(com.thoughtworks.go.plugin.api.request.GoPluginApiRequest)>/@parameter0	<com.matt_richardson.gocd.websocket_notifier.GoNotificationPlugin: com.thoughtworks.go.plugin.api.response.GoPluginApiResponse handle(com.thoughtworks.go.plugin.api.request.GoPluginApiRequest)>
<com.matt_richardson.gocd.websocket_notifier.GoNotificationPlugin: com.thoughtworks.go.plugin.api.response.GoPluginApiResponse handle(com.thoughtworks.go.plugin.api.request.GoPluginApiRequest)>/$stack4	<com.matt_richardson.gocd.websocket_notifier.GoNotificationPlugin: com.thoughtworks.go.plugin.api.response.GoPluginApiResponse handle(com.thoughtworks.go.plugin.api.request.GoPluginApiRequest)>
<com.matt_richardson.gocd.websocket_notifier.GoNotificationPlugin: com.thoughtworks.go.plugin.api.response.GoPluginApiResponse handle(com.thoughtworks.go.plugin.api.request.GoPluginApiRequest)>/goPluginApiRequest#_0	<com.matt_richardson.gocd.websocket_notifier.GoNotificationPlugin: com.thoughtworks.go.plugin.api.response.GoPluginApiResponse handle(com.thoughtworks.go.plugin.api.request.GoPluginApiRequest)>
<com.matt_richardson.gocd.websocket_notifier.GoNotificationPlugin: com.thoughtworks.go.plugin.api.response.GoPluginApiResponse handle(com.thoughtworks.go.plugin.api.request.GoPluginApiRequest)>/$stack5	<com.matt_richardson.gocd.websocket_notifier.GoNotificationPlugin: com.thoughtworks.go.plugin.api.response.GoPluginApiResponse handle(com.thoughtworks.go.plugin.api.request.GoPluginApiRequest)>
<com.matt_richardson.gocd.websocket_notifier.GoNotificationPlugin: com.thoughtworks.go.plugin.api.response.GoPluginApiResponse handle(com.thoughtworks.go.plugin.api.request.GoPluginApiRequest)>/$stack6	<com.matt_richardson.gocd.websocket_notifier.GoNotificationPlugin: com.thoughtworks.go.plugin.api.response.GoPluginApiResponse handle(com.thoughtworks.go.plugin.api.request.GoPluginApiRequest)>
<com.matt_richardson.gocd.websocket_notifier.GoNotificationPlugin: com.thoughtworks.go.plugin.api.response.GoPluginApiResponse handle(com.thoughtworks.go.plugin.api.request.GoPluginApiRequest)>/$stack7	<com.matt_richardson.gocd.websocket_notifier.GoNotificationPlugin: com.thoughtworks.go.plugin.api.response.GoPluginApiResponse handle(com.thoughtworks.go.plugin.api.request.GoPluginApiRequest)>
<com.matt_richardson.gocd.websocket_notifier.GoNotificationPlugin: com.thoughtworks.go.plugin.api.response.GoPluginApiResponse handle(com.thoughtworks.go.plugin.api.request.GoPluginApiRequest)>/$stack8	<com.matt_richardson.gocd.websocket_notifier.GoNotificationPlugin: com.thoughtworks.go.plugin.api.response.GoPluginApiResponse handle(com.thoughtworks.go.plugin.api.request.GoPluginApiRequest)>
<com.matt_richardson.gocd.websocket_notifier.GoNotificationPlugin: com.thoughtworks.go.plugin.api.response.GoPluginApiResponse handle(com.thoughtworks.go.plugin.api.request.GoPluginApiRequest)>/$stack9	<com.matt_richardson.gocd.websocket_notifier.GoNotificationPlugin: com.thoughtworks.go.plugin.api.response.GoPluginApiResponse handle(com.thoughtworks.go.plugin.api.request.GoPluginApiRequest)>
<com.matt_richardson.gocd.websocket_notifier.GoNotificationPlugin: com.thoughtworks.go.plugin.api.response.GoPluginApiResponse handle(com.thoughtworks.go.plugin.api.request.GoPluginApiRequest)>/$stack10	<com.matt_richardson.gocd.websocket_notifier.GoNotificationPlugin: com.thoughtworks.go.plugin.api.response.GoPluginApiResponse handle(com.thoughtworks.go.plugin.api.request.GoPluginApiRequest)>
<com.matt_richardson.gocd.websocket_notifier.GoNotificationPlugin: com.thoughtworks.go.plugin.api.response.GoPluginApiResponse handle(com.thoughtworks.go.plugin.api.request.GoPluginApiRequest)>/$stack11	<com.matt_richardson.gocd.websocket_notifier.GoNotificationPlugin: com.thoughtworks.go.plugin.api.response.GoPluginApiResponse handle(com.thoughtworks.go.plugin.api.request.GoPluginApiRequest)>
<com.matt_richardson.gocd.websocket_notifier.GoNotificationPlugin: com.thoughtworks.go.plugin.api.response.GoPluginApiResponse handle(com.thoughtworks.go.plugin.api.request.GoPluginApiRequest)>/$stack12	<com.matt_richardson.gocd.websocket_notifier.GoNotificationPlugin: com.thoughtworks.go.plugin.api.response.GoPluginApiResponse handle(com.thoughtworks.go.plugin.api.request.GoPluginApiRequest)>
<com.matt_richardson.gocd.websocket_notifier.GoNotificationPlugin: com.thoughtworks.go.plugin.api.response.GoPluginApiResponse handle(com.thoughtworks.go.plugin.api.request.GoPluginApiRequest)>/$stack14	<com.matt_richardson.gocd.websocket_notifier.GoNotificationPlugin: com.thoughtworks.go.plugin.api.response.GoPluginApiResponse handle(com.thoughtworks.go.plugin.api.request.GoPluginApiRequest)>
<com.matt_richardson.gocd.websocket_notifier.GoNotificationPlugin: com.thoughtworks.go.plugin.api.response.GoPluginApiResponse handle(com.thoughtworks.go.plugin.api.request.GoPluginApiRequest)>/$stack15	<com.matt_richardson.gocd.websocket_notifier.GoNotificationPlugin: com.thoughtworks.go.plugin.api.response.GoPluginApiResponse handle(com.thoughtworks.go.plugin.api.request.GoPluginApiRequest)>
<com.matt_richardson.gocd.websocket_notifier.GoNotificationPlugin: com.thoughtworks.go.plugin.api.response.GoPluginApiResponse handle(com.thoughtworks.go.plugin.api.request.GoPluginApiRequest)>/$stack16	<com.matt_richardson.gocd.websocket_notifier.GoNotificationPlugin: com.thoughtworks.go.plugin.api.response.GoPluginApiResponse handle(com.thoughtworks.go.plugin.api.request.GoPluginApiRequest)>
<com.matt_richardson.gocd.websocket_notifier.GoNotificationPlugin: com.thoughtworks.go.plugin.api.response.GoPluginApiResponse handle(com.thoughtworks.go.plugin.api.request.GoPluginApiRequest)>/$stack17	<com.matt_richardson.gocd.websocket_notifier.GoNotificationPlugin: com.thoughtworks.go.plugin.api.response.GoPluginApiResponse handle(com.thoughtworks.go.plugin.api.request.GoPluginApiRequest)>
<com.matt_richardson.gocd.websocket_notifier.GoNotificationPlugin: com.thoughtworks.go.plugin.api.response.GoPluginApiResponse handle(com.thoughtworks.go.plugin.api.request.GoPluginApiRequest)>/$stack18	<com.matt_richardson.gocd.websocket_notifier.GoNotificationPlugin: com.thoughtworks.go.plugin.api.response.GoPluginApiResponse handle(com.thoughtworks.go.plugin.api.request.GoPluginApiRequest)>
<com.matt_richardson.gocd.websocket_notifier.GoNotificationPlugin: com.thoughtworks.go.plugin.api.response.GoPluginApiResponse handle(com.thoughtworks.go.plugin.api.request.GoPluginApiRequest)>/this#_0	<com.matt_richardson.gocd.websocket_notifier.GoNotificationPlugin: com.thoughtworks.go.plugin.api.response.GoPluginApiResponse handle(com.thoughtworks.go.plugin.api.request.GoPluginApiRequest)>
<com.matt_richardson.gocd.websocket_notifier.GoNotificationPlugin: com.thoughtworks.go.plugin.api.response.GoPluginApiResponse handle(com.thoughtworks.go.plugin.api.request.GoPluginApiRequest)>/$stack19	<com.matt_richardson.gocd.websocket_notifier.GoNotificationPlugin: com.thoughtworks.go.plugin.api.response.GoPluginApiResponse handle(com.thoughtworks.go.plugin.api.request.GoPluginApiRequest)>
<com.matt_richardson.gocd.websocket_notifier.GoNotificationPlugin: com.thoughtworks.go.plugin.api.response.GoPluginApiResponse handle(com.thoughtworks.go.plugin.api.request.GoPluginApiRequest)>/$stack20	<com.matt_richardson.gocd.websocket_notifier.GoNotificationPlugin: com.thoughtworks.go.plugin.api.response.GoPluginApiResponse handle(com.thoughtworks.go.plugin.api.request.GoPluginApiRequest)>
<com.matt_richardson.gocd.websocket_notifier.GoNotificationPlugin: com.thoughtworks.go.plugin.api.response.GoPluginApiResponse handle(com.thoughtworks.go.plugin.api.request.GoPluginApiRequest)>/$stack21	<com.matt_richardson.gocd.websocket_notifier.GoNotificationPlugin: com.thoughtworks.go.plugin.api.response.GoPluginApiResponse handle(com.thoughtworks.go.plugin.api.request.GoPluginApiRequest)>
<com.matt_richardson.gocd.websocket_notifier.GoNotificationPlugin: com.thoughtworks.go.plugin.api.response.GoPluginApiResponse handle(com.thoughtworks.go.plugin.api.request.GoPluginApiRequest)>/$stack22	<com.matt_richardson.gocd.websocket_notifier.GoNotificationPlugin: com.thoughtworks.go.plugin.api.response.GoPluginApiResponse handle(com.thoughtworks.go.plugin.api.request.GoPluginApiRequest)>
<com.matt_richardson.gocd.websocket_notifier.GoNotificationPlugin: com.thoughtworks.go.plugin.api.response.GoPluginApiResponse handle(com.thoughtworks.go.plugin.api.request.GoPluginApiRequest)>/$stack23	<com.matt_richardson.gocd.websocket_notifier.GoNotificationPlugin: com.thoughtworks.go.plugin.api.response.GoPluginApiResponse handle(com.thoughtworks.go.plugin.api.request.GoPluginApiRequest)>
<com.matt_richardson.gocd.websocket_notifier.GoNotificationPlugin: com.thoughtworks.go.plugin.api.response.GoPluginApiResponse handle(com.thoughtworks.go.plugin.api.request.GoPluginApiRequest)>/$stack24	<com.matt_richardson.gocd.websocket_notifier.GoNotificationPlugin: com.thoughtworks.go.plugin.api.response.GoPluginApiResponse handle(com.thoughtworks.go.plugin.api.request.GoPluginApiRequest)>
<com.matt_richardson.gocd.websocket_notifier.GoNotificationPlugin: com.thoughtworks.go.plugin.api.response.GoPluginApiResponse handle(com.thoughtworks.go.plugin.api.request.GoPluginApiRequest)>/$stack25	<com.matt_richardson.gocd.websocket_notifier.GoNotificationPlugin: com.thoughtworks.go.plugin.api.response.GoPluginApiResponse handle(com.thoughtworks.go.plugin.api.request.GoPluginApiRequest)>
<com.matt_richardson.gocd.websocket_notifier.GoNotificationPlugin: com.thoughtworks.go.plugin.api.response.GoPluginApiResponse handle(com.thoughtworks.go.plugin.api.request.GoPluginApiRequest)>/$stack26	<com.matt_richardson.gocd.websocket_notifier.GoNotificationPlugin: com.thoughtworks.go.plugin.api.response.GoPluginApiResponse handle(com.thoughtworks.go.plugin.api.request.GoPluginApiRequest)>
<com.matt_richardson.gocd.websocket_notifier.GoNotificationPlugin: com.thoughtworks.go.plugin.api.response.GoPluginApiResponse handle(com.thoughtworks.go.plugin.api.request.GoPluginApiRequest)>/$stack27	<com.matt_richardson.gocd.websocket_notifier.GoNotificationPlugin: com.thoughtworks.go.plugin.api.response.GoPluginApiResponse handle(com.thoughtworks.go.plugin.api.request.GoPluginApiRequest)>
<com.matt_richardson.gocd.websocket_notifier.GoNotificationPlugin: com.thoughtworks.go.plugin.api.response.GoPluginApiResponse handle(com.thoughtworks.go.plugin.api.request.GoPluginApiRequest)>/$stack28	<com.matt_richardson.gocd.websocket_notifier.GoNotificationPlugin: com.thoughtworks.go.plugin.api.response.GoPluginApiResponse handle(com.thoughtworks.go.plugin.api.request.GoPluginApiRequest)>
<com.matt_richardson.gocd.websocket_notifier.GoNotificationPlugin: com.thoughtworks.go.plugin.api.response.GoPluginApiResponse handle(com.thoughtworks.go.plugin.api.request.GoPluginApiRequest)>/$u0	<com.matt_richardson.gocd.websocket_notifier.GoNotificationPlugin: com.thoughtworks.go.plugin.api.response.GoPluginApiResponse handle(com.thoughtworks.go.plugin.api.request.GoPluginApiRequest)>
<com.matt_richardson.gocd.websocket_notifier.GoNotificationPlugin: com.thoughtworks.go.plugin.api.response.GoPluginApiResponse handle(com.thoughtworks.go.plugin.api.request.GoPluginApiRequest)>/$u1	<com.matt_richardson.gocd.websocket_notifier.GoNotificationPlugin: com.thoughtworks.go.plugin.api.response.GoPluginApiResponse handle(com.thoughtworks.go.plugin.api.request.GoPluginApiRequest)>
<com.matt_richardson.gocd.websocket_notifier.GoNotificationPlugin: com.thoughtworks.go.plugin.api.response.GoPluginApiResponse handle(com.thoughtworks.go.plugin.api.request.GoPluginApiRequest)>/$r0	<com.matt_richardson.gocd.websocket_notifier.GoNotificationPlugin: com.thoughtworks.go.plugin.api.response.GoPluginApiResponse handle(com.thoughtworks.go.plugin.api.request.GoPluginApiRequest)>
<com.matt_richardson.gocd.websocket_notifier.GoNotificationPlugin: com.thoughtworks.go.plugin.api.response.GoPluginApiResponse handle(com.thoughtworks.go.plugin.api.request.GoPluginApiRequest)>/$r1	<com.matt_richardson.gocd.websocket_notifier.GoNotificationPlugin: com.thoughtworks.go.plugin.api.response.GoPluginApiResponse handle(com.thoughtworks.go.plugin.api.request.GoPluginApiRequest)>
<com.matt_richardson.gocd.websocket_notifier.GoNotificationPlugin: com.thoughtworks.go.plugin.api.response.GoPluginApiResponse handle(com.thoughtworks.go.plugin.api.request.GoPluginApiRequest)>/$stringconstant0	<com.matt_richardson.gocd.websocket_notifier.GoNotificationPlugin: com.thoughtworks.go.plugin.api.response.GoPluginApiResponse handle(com.thoughtworks.go.plugin.api.request.GoPluginApiRequest)>
<com.matt_richardson.gocd.websocket_notifier.GoNotificationPlugin: com.thoughtworks.go.plugin.api.response.GoPluginApiResponse handle(com.thoughtworks.go.plugin.api.request.GoPluginApiRequest)>/$stringconstant1	<com.matt_richardson.gocd.websocket_notifier.GoNotificationPlugin: com.thoughtworks.go.plugin.api.response.GoPluginApiResponse handle(com.thoughtworks.go.plugin.api.request.GoPluginApiRequest)>
<com.matt_richardson.gocd.websocket_notifier.GoNotificationPlugin: com.thoughtworks.go.plugin.api.response.GoPluginApiResponse handle(com.thoughtworks.go.plugin.api.request.GoPluginApiRequest)>/$stringconstant2	<com.matt_richardson.gocd.websocket_notifier.GoNotificationPlugin: com.thoughtworks.go.plugin.api.response.GoPluginApiResponse handle(com.thoughtworks.go.plugin.api.request.GoPluginApiRequest)>
<com.matt_richardson.gocd.websocket_notifier.GoNotificationPlugin: com.thoughtworks.go.plugin.api.response.GoPluginApiResponse handle(com.thoughtworks.go.plugin.api.request.GoPluginApiRequest)>/$stringconstant3	<com.matt_richardson.gocd.websocket_notifier.GoNotificationPlugin: com.thoughtworks.go.plugin.api.response.GoPluginApiResponse handle(com.thoughtworks.go.plugin.api.request.GoPluginApiRequest)>
<com.matt_richardson.gocd.websocket_notifier.GoNotificationPlugin: com.thoughtworks.go.plugin.api.response.GoPluginApiResponse handle(com.thoughtworks.go.plugin.api.request.GoPluginApiRequest)>/$stringconstant4	<com.matt_richardson.gocd.websocket_notifier.GoNotificationPlugin: com.thoughtworks.go.plugin.api.response.GoPluginApiResponse handle(com.thoughtworks.go.plugin.api.request.GoPluginApiRequest)>
<com.matt_richardson.gocd.websocket_notifier.GoNotificationPlugin: com.thoughtworks.go.plugin.api.GoPluginIdentifier pluginIdentifier()>/@this	<com.matt_richardson.gocd.websocket_notifier.GoNotificationPlugin: com.thoughtworks.go.plugin.api.GoPluginIdentifier pluginIdentifier()>
<com.matt_richardson.gocd.websocket_notifier.GoNotificationPlugin: com.thoughtworks.go.plugin.api.GoPluginIdentifier pluginIdentifier()>/$stack1	<com.matt_richardson.gocd.websocket_notifier.GoNotificationPlugin: com.thoughtworks.go.plugin.api.GoPluginIdentifier pluginIdentifier()>
<com.matt_richardson.gocd.websocket_notifier.GoNotificationPlugin: com.thoughtworks.go.plugin.api.GoPluginIdentifier pluginIdentifier()>/$stack2	<com.matt_richardson.gocd.websocket_notifier.GoNotificationPlugin: com.thoughtworks.go.plugin.api.GoPluginIdentifier pluginIdentifier()>
<com.matt_richardson.gocd.websocket_notifier.GoNotificationPlugin: com.thoughtworks.go.plugin.api.GoPluginIdentifier pluginIdentifier()>/$stack3	<com.matt_richardson.gocd.websocket_notifier.GoNotificationPlugin: com.thoughtworks.go.plugin.api.GoPluginIdentifier pluginIdentifier()>
<com.matt_richardson.gocd.websocket_notifier.GoNotificationPlugin: com.thoughtworks.go.plugin.api.GoPluginIdentifier pluginIdentifier()>/this#_0	<com.matt_richardson.gocd.websocket_notifier.GoNotificationPlugin: com.thoughtworks.go.plugin.api.GoPluginIdentifier pluginIdentifier()>
<com.matt_richardson.gocd.websocket_notifier.GoNotificationPlugin: com.thoughtworks.go.plugin.api.GoPluginIdentifier pluginIdentifier()>/$stringconstant0	<com.matt_richardson.gocd.websocket_notifier.GoNotificationPlugin: com.thoughtworks.go.plugin.api.GoPluginIdentifier pluginIdentifier()>
<com.matt_richardson.gocd.websocket_notifier.GoNotificationPlugin: com.thoughtworks.go.plugin.api.GoPluginIdentifier pluginIdentifier()>/$stringconstant1	<com.matt_richardson.gocd.websocket_notifier.GoNotificationPlugin: com.thoughtworks.go.plugin.api.GoPluginIdentifier pluginIdentifier()>
<com.matt_richardson.gocd.websocket_notifier.GoNotificationPlugin: com.thoughtworks.go.plugin.api.response.GoPluginApiResponse handleNotificationsInterestedIn()>/@this	<com.matt_richardson.gocd.websocket_notifier.GoNotificationPlugin: com.thoughtworks.go.plugin.api.response.GoPluginApiResponse handleNotificationsInterestedIn()>
<com.matt_richardson.gocd.websocket_notifier.GoNotificationPlugin: com.thoughtworks.go.plugin.api.response.GoPluginApiResponse handleNotificationsInterestedIn()>/$stack2	<com.matt_richardson.gocd.websocket_notifier.GoNotificationPlugin: com.thoughtworks.go.plugin.api.response.GoPluginApiResponse handleNotificationsInterestedIn()>
<com.matt_richardson.gocd.websocket_notifier.GoNotificationPlugin: com.thoughtworks.go.plugin.api.response.GoPluginApiResponse handleNotificationsInterestedIn()>/$stack3	<com.matt_richardson.gocd.websocket_notifier.GoNotificationPlugin: com.thoughtworks.go.plugin.api.response.GoPluginApiResponse handleNotificationsInterestedIn()>
<com.matt_richardson.gocd.websocket_notifier.GoNotificationPlugin: com.thoughtworks.go.plugin.api.response.GoPluginApiResponse handleNotificationsInterestedIn()>/$stack4	<com.matt_richardson.gocd.websocket_notifier.GoNotificationPlugin: com.thoughtworks.go.plugin.api.response.GoPluginApiResponse handleNotificationsInterestedIn()>
<com.matt_richardson.gocd.websocket_notifier.GoNotificationPlugin: com.thoughtworks.go.plugin.api.response.GoPluginApiResponse handleNotificationsInterestedIn()>/$stack6	<com.matt_richardson.gocd.websocket_notifier.GoNotificationPlugin: com.thoughtworks.go.plugin.api.response.GoPluginApiResponse handleNotificationsInterestedIn()>
<com.matt_richardson.gocd.websocket_notifier.GoNotificationPlugin: com.thoughtworks.go.plugin.api.response.GoPluginApiResponse handleNotificationsInterestedIn()>/this#_0	<com.matt_richardson.gocd.websocket_notifier.GoNotificationPlugin: com.thoughtworks.go.plugin.api.response.GoPluginApiResponse handleNotificationsInterestedIn()>
<com.matt_richardson.gocd.websocket_notifier.GoNotificationPlugin: com.thoughtworks.go.plugin.api.response.GoPluginApiResponse handleNotificationsInterestedIn()>/$stack7	<com.matt_richardson.gocd.websocket_notifier.GoNotificationPlugin: com.thoughtworks.go.plugin.api.response.GoPluginApiResponse handleNotificationsInterestedIn()>
<com.matt_richardson.gocd.websocket_notifier.GoNotificationPlugin: com.thoughtworks.go.plugin.api.response.GoPluginApiResponse handleNotificationsInterestedIn()>/$stringconstant0	<com.matt_richardson.gocd.websocket_notifier.GoNotificationPlugin: com.thoughtworks.go.plugin.api.response.GoPluginApiResponse handleNotificationsInterestedIn()>
<com.matt_richardson.gocd.websocket_notifier.GoNotificationPlugin: com.thoughtworks.go.plugin.api.response.GoPluginApiResponse handleNotificationsInterestedIn()>/$stringconstant1	<com.matt_richardson.gocd.websocket_notifier.GoNotificationPlugin: com.thoughtworks.go.plugin.api.response.GoPluginApiResponse handleNotificationsInterestedIn()>
<com.matt_richardson.gocd.websocket_notifier.GoNotificationPlugin: com.thoughtworks.go.plugin.api.response.GoPluginApiResponse handleNotificationsInterestedIn()>/$stringconstant2	<com.matt_richardson.gocd.websocket_notifier.GoNotificationPlugin: com.thoughtworks.go.plugin.api.response.GoPluginApiResponse handleNotificationsInterestedIn()>
<com.matt_richardson.gocd.websocket_notifier.GoNotificationPlugin: com.thoughtworks.go.plugin.api.response.GoPluginApiResponse handleNotificationsInterestedIn()>/$numconstant0	<com.matt_richardson.gocd.websocket_notifier.GoNotificationPlugin: com.thoughtworks.go.plugin.api.response.GoPluginApiResponse handleNotificationsInterestedIn()>
<com.matt_richardson.gocd.websocket_notifier.GoNotificationPlugin: com.thoughtworks.go.plugin.api.response.GoPluginApiResponse handleStageNotification(com.thoughtworks.go.plugin.api.request.GoPluginApiRequest)>/@this	<com.matt_richardson.gocd.websocket_notifier.GoNotificationPlugin: com.thoughtworks.go.plugin.api.response.GoPluginApiResponse handleStageNotification(com.thoughtworks.go.plugin.api.request.GoPluginApiRequest)>
<com.matt_richardson.gocd.websocket_notifier.GoNotificationPlugin: com.thoughtworks.go.plugin.api.response.GoPluginApiResponse handleStageNotification(com.thoughtworks.go.plugin.api.request.GoPluginApiRequest)>/@parameter0	<com.matt_richardson.gocd.websocket_notifier.GoNotificationPlugin: com.thoughtworks.go.plugin.api.response.GoPluginApiResponse handleStageNotification(com.thoughtworks.go.plugin.api.request.GoPluginApiRequest)>
<com.matt_richardson.gocd.websocket_notifier.GoNotificationPlugin: com.thoughtworks.go.plugin.api.response.GoPluginApiResponse handleStageNotification(com.thoughtworks.go.plugin.api.request.GoPluginApiRequest)>/$stack6	<com.matt_richardson.gocd.websocket_notifier.GoNotificationPlugin: com.thoughtworks.go.plugin.api.response.GoPluginApiResponse handleStageNotification(com.thoughtworks.go.plugin.api.request.GoPluginApiRequest)>
<com.matt_richardson.gocd.websocket_notifier.GoNotificationPlugin: com.thoughtworks.go.plugin.api.response.GoPluginApiResponse handleStageNotification(com.thoughtworks.go.plugin.api.request.GoPluginApiRequest)>/$stack7	<com.matt_richardson.gocd.websocket_notifier.GoNotificationPlugin: com.thoughtworks.go.plugin.api.response.GoPluginApiResponse handleStageNotification(com.thoughtworks.go.plugin.api.request.GoPluginApiRequest)>
<com.matt_richardson.gocd.websocket_notifier.GoNotificationPlugin: com.thoughtworks.go.plugin.api.response.GoPluginApiResponse handleStageNotification(com.thoughtworks.go.plugin.api.request.GoPluginApiRequest)>/$stack8	<com.matt_richardson.gocd.websocket_notifier.GoNotificationPlugin: com.thoughtworks.go.plugin.api.response.GoPluginApiResponse handleStageNotification(com.thoughtworks.go.plugin.api.request.GoPluginApiRequest)>
<com.matt_richardson.gocd.websocket_notifier.GoNotificationPlugin: com.thoughtworks.go.plugin.api.response.GoPluginApiResponse handleStageNotification(com.thoughtworks.go.plugin.api.request.GoPluginApiRequest)>/goPluginApiRequest#_0	<com.matt_richardson.gocd.websocket_notifier.GoNotificationPlugin: com.thoughtworks.go.plugin.api.response.GoPluginApiResponse handleStageNotification(com.thoughtworks.go.plugin.api.request.GoPluginApiRequest)>
<com.matt_richardson.gocd.websocket_notifier.GoNotificationPlugin: com.thoughtworks.go.plugin.api.response.GoPluginApiResponse handleStageNotification(com.thoughtworks.go.plugin.api.request.GoPluginApiRequest)>/$stack10	<com.matt_richardson.gocd.websocket_notifier.GoNotificationPlugin: com.thoughtworks.go.plugin.api.response.GoPluginApiResponse handleStageNotification(com.thoughtworks.go.plugin.api.request.GoPluginApiRequest)>
<com.matt_richardson.gocd.websocket_notifier.GoNotificationPlugin: com.thoughtworks.go.plugin.api.response.GoPluginApiResponse handleStageNotification(com.thoughtworks.go.plugin.api.request.GoPluginApiRequest)>/this#_0	<com.matt_richardson.gocd.websocket_notifier.GoNotificationPlugin: com.thoughtworks.go.plugin.api.response.GoPluginApiResponse handleStageNotification(com.thoughtworks.go.plugin.api.request.GoPluginApiRequest)>
<com.matt_richardson.gocd.websocket_notifier.GoNotificationPlugin: com.thoughtworks.go.plugin.api.response.GoPluginApiResponse handleStageNotification(com.thoughtworks.go.plugin.api.request.GoPluginApiRequest)>/$stack12	<com.matt_richardson.gocd.websocket_notifier.GoNotificationPlugin: com.thoughtworks.go.plugin.api.response.GoPluginApiResponse handleStageNotification(com.thoughtworks.go.plugin.api.request.GoPluginApiRequest)>
<com.matt_richardson.gocd.websocket_notifier.GoNotificationPlugin: com.thoughtworks.go.plugin.api.response.GoPluginApiResponse handleStageNotification(com.thoughtworks.go.plugin.api.request.GoPluginApiRequest)>/$stack13	<com.matt_richardson.gocd.websocket_notifier.GoNotificationPlugin: com.thoughtworks.go.plugin.api.response.GoPluginApiResponse handleStageNotification(com.thoughtworks.go.plugin.api.request.GoPluginApiRequest)>
<com.matt_richardson.gocd.websocket_notifier.GoNotificationPlugin: com.thoughtworks.go.plugin.api.response.GoPluginApiResponse handleStageNotification(com.thoughtworks.go.plugin.api.request.GoPluginApiRequest)>/$stack14	<com.matt_richardson.gocd.websocket_notifier.GoNotificationPlugin: com.thoughtworks.go.plugin.api.response.GoPluginApiResponse handleStageNotification(com.thoughtworks.go.plugin.api.request.GoPluginApiRequest)>
<com.matt_richardson.gocd.websocket_notifier.GoNotificationPlugin: com.thoughtworks.go.plugin.api.response.GoPluginApiResponse handleStageNotification(com.thoughtworks.go.plugin.api.request.GoPluginApiRequest)>/$stack16	<com.matt_richardson.gocd.websocket_notifier.GoNotificationPlugin: com.thoughtworks.go.plugin.api.response.GoPluginApiResponse handleStageNotification(com.thoughtworks.go.plugin.api.request.GoPluginApiRequest)>
<com.matt_richardson.gocd.websocket_notifier.GoNotificationPlugin: com.thoughtworks.go.plugin.api.response.GoPluginApiResponse handleStageNotification(com.thoughtworks.go.plugin.api.request.GoPluginApiRequest)>/responseCode#_89	<com.matt_richardson.gocd.websocket_notifier.GoNotificationPlugin: com.thoughtworks.go.plugin.api.response.GoPluginApiResponse handleStageNotification(com.thoughtworks.go.plugin.api.request.GoPluginApiRequest)>
<com.matt_richardson.gocd.websocket_notifier.GoNotificationPlugin: com.thoughtworks.go.plugin.api.response.GoPluginApiResponse handleStageNotification(com.thoughtworks.go.plugin.api.request.GoPluginApiRequest)>/responseCode_$$A_1#_98	<com.matt_richardson.gocd.websocket_notifier.GoNotificationPlugin: com.thoughtworks.go.plugin.api.response.GoPluginApiResponse handleStageNotification(com.thoughtworks.go.plugin.api.request.GoPluginApiRequest)>
<com.matt_richardson.gocd.websocket_notifier.GoNotificationPlugin: com.thoughtworks.go.plugin.api.response.GoPluginApiResponse handleStageNotification(com.thoughtworks.go.plugin.api.request.GoPluginApiRequest)>/responseCode_$$A_2#_101	<com.matt_richardson.gocd.websocket_notifier.GoNotificationPlugin: com.thoughtworks.go.plugin.api.response.GoPluginApiResponse handleStageNotification(com.thoughtworks.go.plugin.api.request.GoPluginApiRequest)>
<com.matt_richardson.gocd.websocket_notifier.GoNotificationPlugin: com.thoughtworks.go.plugin.api.response.GoPluginApiResponse handleStageNotification(com.thoughtworks.go.plugin.api.request.GoPluginApiRequest)>/$stringconstant0	<com.matt_richardson.gocd.websocket_notifier.GoNotificationPlugin: com.thoughtworks.go.plugin.api.response.GoPluginApiResponse handleStageNotification(com.thoughtworks.go.plugin.api.request.GoPluginApiRequest)>
<com.matt_richardson.gocd.websocket_notifier.GoNotificationPlugin: com.thoughtworks.go.plugin.api.response.GoPluginApiResponse handleStageNotification(com.thoughtworks.go.plugin.api.request.GoPluginApiRequest)>/$stringconstant1	<com.matt_richardson.gocd.websocket_notifier.GoNotificationPlugin: com.thoughtworks.go.plugin.api.response.GoPluginApiResponse handleStageNotification(com.thoughtworks.go.plugin.api.request.GoPluginApiRequest)>
<com.matt_richardson.gocd.websocket_notifier.GoNotificationPlugin: com.thoughtworks.go.plugin.api.response.GoPluginApiResponse handleStageNotification(com.thoughtworks.go.plugin.api.request.GoPluginApiRequest)>/$stringconstant2	<com.matt_richardson.gocd.websocket_notifier.GoNotificationPlugin: com.thoughtworks.go.plugin.api.response.GoPluginApiResponse handleStageNotification(com.thoughtworks.go.plugin.api.request.GoPluginApiRequest)>
<com.matt_richardson.gocd.websocket_notifier.GoNotificationPlugin: com.thoughtworks.go.plugin.api.response.GoPluginApiResponse handleStageNotification(com.thoughtworks.go.plugin.api.request.GoPluginApiRequest)>/$stringconstant3	<com.matt_richardson.gocd.websocket_notifier.GoNotificationPlugin: com.thoughtworks.go.plugin.api.response.GoPluginApiResponse handleStageNotification(com.thoughtworks.go.plugin.api.request.GoPluginApiRequest)>
<com.matt_richardson.gocd.websocket_notifier.GoNotificationPlugin: com.thoughtworks.go.plugin.api.response.GoPluginApiResponse handleStageNotification(com.thoughtworks.go.plugin.api.request.GoPluginApiRequest)>/$stringconstant4	<com.matt_richardson.gocd.websocket_notifier.GoNotificationPlugin: com.thoughtworks.go.plugin.api.response.GoPluginApiResponse handleStageNotification(com.thoughtworks.go.plugin.api.request.GoPluginApiRequest)>
<com.matt_richardson.gocd.websocket_notifier.GoNotificationPlugin: com.thoughtworks.go.plugin.api.response.GoPluginApiResponse handleStageNotification(com.thoughtworks.go.plugin.api.request.GoPluginApiRequest)>/$stringconstant5	<com.matt_richardson.gocd.websocket_notifier.GoNotificationPlugin: com.thoughtworks.go.plugin.api.response.GoPluginApiResponse handleStageNotification(com.thoughtworks.go.plugin.api.request.GoPluginApiRequest)>
<com.matt_richardson.gocd.websocket_notifier.GoNotificationPlugin: com.thoughtworks.go.plugin.api.response.GoPluginApiResponse handleStageNotification(com.thoughtworks.go.plugin.api.request.GoPluginApiRequest)>/$stringconstant6	<com.matt_richardson.gocd.websocket_notifier.GoNotificationPlugin: com.thoughtworks.go.plugin.api.response.GoPluginApiResponse handleStageNotification(com.thoughtworks.go.plugin.api.request.GoPluginApiRequest)>
<com.matt_richardson.gocd.websocket_notifier.GoNotificationPlugin: com.thoughtworks.go.plugin.api.response.GoPluginApiResponse renderJSON(int,java.lang.Object)>/@this	<com.matt_richardson.gocd.websocket_notifier.GoNotificationPlugin: com.thoughtworks.go.plugin.api.response.GoPluginApiResponse renderJSON(int,java.lang.Object)>
<com.matt_richardson.gocd.websocket_notifier.GoNotificationPlugin: com.thoughtworks.go.plugin.api.response.GoPluginApiResponse renderJSON(int,java.lang.Object)>/@parameter0	<com.matt_richardson.gocd.websocket_notifier.GoNotificationPlugin: com.thoughtworks.go.plugin.api.response.GoPluginApiResponse renderJSON(int,java.lang.Object)>
<com.matt_richardson.gocd.websocket_notifier.GoNotificationPlugin: com.thoughtworks.go.plugin.api.response.GoPluginApiResponse renderJSON(int,java.lang.Object)>/@parameter1	<com.matt_richardson.gocd.websocket_notifier.GoNotificationPlugin: com.thoughtworks.go.plugin.api.response.GoPluginApiResponse renderJSON(int,java.lang.Object)>
<com.matt_richardson.gocd.websocket_notifier.GoNotificationPlugin: com.thoughtworks.go.plugin.api.response.GoPluginApiResponse renderJSON(int,java.lang.Object)>/response#_0	<com.matt_richardson.gocd.websocket_notifier.GoNotificationPlugin: com.thoughtworks.go.plugin.api.response.GoPluginApiResponse renderJSON(int,java.lang.Object)>
<com.matt_richardson.gocd.websocket_notifier.GoNotificationPlugin: com.thoughtworks.go.plugin.api.response.GoPluginApiResponse renderJSON(int,java.lang.Object)>/$stack4	<com.matt_richardson.gocd.websocket_notifier.GoNotificationPlugin: com.thoughtworks.go.plugin.api.response.GoPluginApiResponse renderJSON(int,java.lang.Object)>
<com.matt_richardson.gocd.websocket_notifier.GoNotificationPlugin: com.thoughtworks.go.plugin.api.response.GoPluginApiResponse renderJSON(int,java.lang.Object)>/$stack5	<com.matt_richardson.gocd.websocket_notifier.GoNotificationPlugin: com.thoughtworks.go.plugin.api.response.GoPluginApiResponse renderJSON(int,java.lang.Object)>
<com.matt_richardson.gocd.websocket_notifier.GoNotificationPlugin: com.thoughtworks.go.plugin.api.response.GoPluginApiResponse renderJSON(int,java.lang.Object)>/$stack6	<com.matt_richardson.gocd.websocket_notifier.GoNotificationPlugin: com.thoughtworks.go.plugin.api.response.GoPluginApiResponse renderJSON(int,java.lang.Object)>
<com.matt_richardson.gocd.websocket_notifier.GoNotificationPlugin: com.thoughtworks.go.plugin.api.response.GoPluginApiResponse renderJSON(int,java.lang.Object)>/this#_0	<com.matt_richardson.gocd.websocket_notifier.GoNotificationPlugin: com.thoughtworks.go.plugin.api.response.GoPluginApiResponse renderJSON(int,java.lang.Object)>
<com.matt_richardson.gocd.websocket_notifier.GoNotificationPlugin: com.thoughtworks.go.plugin.api.response.GoPluginApiResponse renderJSON(int,java.lang.Object)>/responseCode#_0	<com.matt_richardson.gocd.websocket_notifier.GoNotificationPlugin: com.thoughtworks.go.plugin.api.response.GoPluginApiResponse renderJSON(int,java.lang.Object)>
<com.matt_richardson.gocd.websocket_notifier.GoNotificationPlugin: com.thoughtworks.go.plugin.api.response.GoPluginApiResponse renderJSON(int,java.lang.Object)>/$stack7	<com.matt_richardson.gocd.websocket_notifier.GoNotificationPlugin: com.thoughtworks.go.plugin.api.response.GoPluginApiResponse renderJSON(int,java.lang.Object)>
<com.matt_richardson.gocd.websocket_notifier.GoNotificationPlugin: com.thoughtworks.go.plugin.api.response.GoPluginApiResponse renderJSON(int,java.lang.Object)>/$stack7_$$A_1	<com.matt_richardson.gocd.websocket_notifier.GoNotificationPlugin: com.thoughtworks.go.plugin.api.response.GoPluginApiResponse renderJSON(int,java.lang.Object)>
<com.matt_richardson.gocd.websocket_notifier.GoNotificationPlugin: com.thoughtworks.go.plugin.api.response.GoPluginApiResponse renderJSON(int,java.lang.Object)>/$stack7_$$A_2	<com.matt_richardson.gocd.websocket_notifier.GoNotificationPlugin: com.thoughtworks.go.plugin.api.response.GoPluginApiResponse renderJSON(int,java.lang.Object)>
<com.matt_richardson.gocd.websocket_notifier.GoNotificationPlugin: void <clinit>()>/$stack0	<com.matt_richardson.gocd.websocket_notifier.GoNotificationPlugin: void <clinit>()>
<com.matt_richardson.gocd.websocket_notifier.GoNotificationPlugin: void <clinit>()>/$stack1	<com.matt_richardson.gocd.websocket_notifier.GoNotificationPlugin: void <clinit>()>
<com.matt_richardson.gocd.websocket_notifier.GoNotificationPlugin: void <clinit>()>/$stack2	<com.matt_richardson.gocd.websocket_notifier.GoNotificationPlugin: void <clinit>()>
<com.matt_richardson.gocd.websocket_notifier.GoNotificationPlugin: void <clinit>()>/$classconstant0	<com.matt_richardson.gocd.websocket_notifier.GoNotificationPlugin: void <clinit>()>
<com.matt_richardson.gocd.websocket_notifier.GoNotificationPlugin: void <clinit>()>/$stringconstant0	<com.matt_richardson.gocd.websocket_notifier.GoNotificationPlugin: void <clinit>()>
<com.matt_richardson.gocd.websocket_notifier.GoNotificationPlugin$1: void <init>(com.matt_richardson.gocd.websocket_notifier.GoNotificationPlugin,int,java.lang.String)>/@this	<com.matt_richardson.gocd.websocket_notifier.GoNotificationPlugin$1: void <init>(com.matt_richardson.gocd.websocket_notifier.GoNotificationPlugin,int,java.lang.String)>
<com.matt_richardson.gocd.websocket_notifier.GoNotificationPlugin$1: void <init>(com.matt_richardson.gocd.websocket_notifier.GoNotificationPlugin,int,java.lang.String)>/@parameter0	<com.matt_richardson.gocd.websocket_notifier.GoNotificationPlugin$1: void <init>(com.matt_richardson.gocd.websocket_notifier.GoNotificationPlugin,int,java.lang.String)>
<com.matt_richardson.gocd.websocket_notifier.GoNotificationPlugin$1: void <init>(com.matt_richardson.gocd.websocket_notifier.GoNotificationPlugin,int,java.lang.String)>/@parameter1	<com.matt_richardson.gocd.websocket_notifier.GoNotificationPlugin$1: void <init>(com.matt_richardson.gocd.websocket_notifier.GoNotificationPlugin,int,java.lang.String)>
<com.matt_richardson.gocd.websocket_notifier.GoNotificationPlugin$1: void <init>(com.matt_richardson.gocd.websocket_notifier.GoNotificationPlugin,int,java.lang.String)>/@parameter2	<com.matt_richardson.gocd.websocket_notifier.GoNotificationPlugin$1: void <init>(com.matt_richardson.gocd.websocket_notifier.GoNotificationPlugin,int,java.lang.String)>
<com.matt_richardson.gocd.websocket_notifier.GoNotificationPlugin$1: void <init>(com.matt_richardson.gocd.websocket_notifier.GoNotificationPlugin,int,java.lang.String)>/this#_0	<com.matt_richardson.gocd.websocket_notifier.GoNotificationPlugin$1: void <init>(com.matt_richardson.gocd.websocket_notifier.GoNotificationPlugin,int,java.lang.String)>
<com.matt_richardson.gocd.websocket_notifier.GoNotificationPlugin$1: void <init>(com.matt_richardson.gocd.websocket_notifier.GoNotificationPlugin,int,java.lang.String)>/this$0#_0	<com.matt_richardson.gocd.websocket_notifier.GoNotificationPlugin$1: void <init>(com.matt_richardson.gocd.websocket_notifier.GoNotificationPlugin,int,java.lang.String)>
<com.matt_richardson.gocd.websocket_notifier.GoNotificationPlugin$1: void <init>(com.matt_richardson.gocd.websocket_notifier.GoNotificationPlugin,int,java.lang.String)>/l2#_0	<com.matt_richardson.gocd.websocket_notifier.GoNotificationPlugin$1: void <init>(com.matt_richardson.gocd.websocket_notifier.GoNotificationPlugin,int,java.lang.String)>
<com.matt_richardson.gocd.websocket_notifier.GoNotificationPlugin$1: void <init>(com.matt_richardson.gocd.websocket_notifier.GoNotificationPlugin,int,java.lang.String)>/l3#_0	<com.matt_richardson.gocd.websocket_notifier.GoNotificationPlugin$1: void <init>(com.matt_richardson.gocd.websocket_notifier.GoNotificationPlugin,int,java.lang.String)>
<com.matt_richardson.gocd.websocket_notifier.GoNotificationPlugin$1: int responseCode()>/@this	<com.matt_richardson.gocd.websocket_notifier.GoNotificationPlugin$1: int responseCode()>
<com.matt_richardson.gocd.websocket_notifier.GoNotificationPlugin$1: int responseCode()>/this#_0	<com.matt_richardson.gocd.websocket_notifier.GoNotificationPlugin$1: int responseCode()>
<com.matt_richardson.gocd.websocket_notifier.GoNotificationPlugin$1: int responseCode()>/$stack1	<com.matt_richardson.gocd.websocket_notifier.GoNotificationPlugin$1: int responseCode()>
<com.matt_richardson.gocd.websocket_notifier.GoNotificationPlugin$1: java.util.Map responseHeaders()>/@this	<com.matt_richardson.gocd.websocket_notifier.GoNotificationPlugin$1: java.util.Map responseHeaders()>
<com.matt_richardson.gocd.websocket_notifier.GoNotificationPlugin$1: java.util.Map responseHeaders()>/this#_0	<com.matt_richardson.gocd.websocket_notifier.GoNotificationPlugin$1: java.util.Map responseHeaders()>
<com.matt_richardson.gocd.websocket_notifier.GoNotificationPlugin$1: java.util.Map responseHeaders()>/$null0	<com.matt_richardson.gocd.websocket_notifier.GoNotificationPlugin$1: java.util.Map responseHeaders()>
<com.matt_richardson.gocd.websocket_notifier.GoNotificationPlugin$1: java.lang.String responseBody()>/@this	<com.matt_richardson.gocd.websocket_notifier.GoNotificationPlugin$1: java.lang.String responseBody()>
<com.matt_richardson.gocd.websocket_notifier.GoNotificationPlugin$1: java.lang.String responseBody()>/this#_0	<com.matt_richardson.gocd.websocket_notifier.GoNotificationPlugin$1: java.lang.String responseBody()>
<com.matt_richardson.gocd.websocket_notifier.GoNotificationPlugin$1: java.lang.String responseBody()>/$stack1	<com.matt_richardson.gocd.websocket_notifier.GoNotificationPlugin$1: java.lang.String responseBody()>
<com.matt_richardson.gocd.websocket_notifier.PluginConfig: void <init>()>/@this	<com.matt_richardson.gocd.websocket_notifier.PluginConfig: void <init>()>
<com.matt_richardson.gocd.websocket_notifier.PluginConfig: void <init>()>/this#_0	<com.matt_richardson.gocd.websocket_notifier.PluginConfig: void <init>()>
<com.matt_richardson.gocd.websocket_notifier.PluginConfig: void <init>()>/userHome#_22	<com.matt_richardson.gocd.websocket_notifier.PluginConfig: void <init>()>
<com.matt_richardson.gocd.websocket_notifier.PluginConfig: void <init>()>/$stack4	<com.matt_richardson.gocd.websocket_notifier.PluginConfig: void <init>()>
<com.matt_richardson.gocd.websocket_notifier.PluginConfig: void <init>()>/$stack5	<com.matt_richardson.gocd.websocket_notifier.PluginConfig: void <init>()>
<com.matt_richardson.gocd.websocket_notifier.PluginConfig: void <init>()>/$stack6	<com.matt_richardson.gocd.websocket_notifier.PluginConfig: void <init>()>
<com.matt_richardson.gocd.websocket_notifier.PluginConfig: void <init>()>/$stack7	<com.matt_richardson.gocd.websocket_notifier.PluginConfig: void <init>()>
<com.matt_richardson.gocd.websocket_notifier.PluginConfig: void <init>()>/$stack8	<com.matt_richardson.gocd.websocket_notifier.PluginConfig: void <init>()>
<com.matt_richardson.gocd.websocket_notifier.PluginConfig: void <init>()>/$stack9	<com.matt_richardson.gocd.websocket_notifier.PluginConfig: void <init>()>
<com.matt_richardson.gocd.websocket_notifier.PluginConfig: void <init>()>/$stack10	<com.matt_richardson.gocd.websocket_notifier.PluginConfig: void <init>()>
<com.matt_richardson.gocd.websocket_notifier.PluginConfig: void <init>()>/$stack11	<com.matt_richardson.gocd.websocket_notifier.PluginConfig: void <init>()>
<com.matt_richardson.gocd.websocket_notifier.PluginConfig: void <init>()>/config#_28	<com.matt_richardson.gocd.websocket_notifier.PluginConfig: void <init>()>
<com.matt_richardson.gocd.websocket_notifier.PluginConfig: void <init>()>/$stack12	<com.matt_richardson.gocd.websocket_notifier.PluginConfig: void <init>()>
<com.matt_richardson.gocd.websocket_notifier.PluginConfig: void <init>()>/$stack13	<com.matt_richardson.gocd.websocket_notifier.PluginConfig: void <init>()>
<com.matt_richardson.gocd.websocket_notifier.PluginConfig: void <init>()>/$stack14	<com.matt_richardson.gocd.websocket_notifier.PluginConfig: void <init>()>
<com.matt_richardson.gocd.websocket_notifier.PluginConfig: void <init>()>/$stack15	<com.matt_richardson.gocd.websocket_notifier.PluginConfig: void <init>()>
<com.matt_richardson.gocd.websocket_notifier.PluginConfig: void <init>()>/$stack16	<com.matt_richardson.gocd.websocket_notifier.PluginConfig: void <init>()>
<com.matt_richardson.gocd.websocket_notifier.PluginConfig: void <init>()>/$stack17	<com.matt_richardson.gocd.websocket_notifier.PluginConfig: void <init>()>
<com.matt_richardson.gocd.websocket_notifier.PluginConfig: void <init>()>/$stack18	<com.matt_richardson.gocd.websocket_notifier.PluginConfig: void <init>()>
<com.matt_richardson.gocd.websocket_notifier.PluginConfig: void <init>()>/$stack21	<com.matt_richardson.gocd.websocket_notifier.PluginConfig: void <init>()>
<com.matt_richardson.gocd.websocket_notifier.PluginConfig: void <init>()>/$stack24	<com.matt_richardson.gocd.websocket_notifier.PluginConfig: void <init>()>
<com.matt_richardson.gocd.websocket_notifier.PluginConfig: void <init>()>/$stack27	<com.matt_richardson.gocd.websocket_notifier.PluginConfig: void <init>()>
<com.matt_richardson.gocd.websocket_notifier.PluginConfig: void <init>()>/$stack30	<com.matt_richardson.gocd.websocket_notifier.PluginConfig: void <init>()>
<com.matt_richardson.gocd.websocket_notifier.PluginConfig: void <init>()>/$stack31	<com.matt_richardson.gocd.websocket_notifier.PluginConfig: void <init>()>
<com.matt_richardson.gocd.websocket_notifier.PluginConfig: void <init>()>/$stack32	<com.matt_richardson.gocd.websocket_notifier.PluginConfig: void <init>()>
<com.matt_richardson.gocd.websocket_notifier.PluginConfig: void <init>()>/$numconstant0	<com.matt_richardson.gocd.websocket_notifier.PluginConfig: void <init>()>
<com.matt_richardson.gocd.websocket_notifier.PluginConfig: void <init>()>/$stringconstant0	<com.matt_richardson.gocd.websocket_notifier.PluginConfig: void <init>()>
<com.matt_richardson.gocd.websocket_notifier.PluginConfig: void <init>()>/$numconstant1	<com.matt_richardson.gocd.websocket_notifier.PluginConfig: void <init>()>
<com.matt_richardson.gocd.websocket_notifier.PluginConfig: void <init>()>/$stringconstant1	<com.matt_richardson.gocd.websocket_notifier.PluginConfig: void <init>()>
<com.matt_richardson.gocd.websocket_notifier.PluginConfig: void <init>()>/$stringconstant2	<com.matt_richardson.gocd.websocket_notifier.PluginConfig: void <init>()>
<com.matt_richardson.gocd.websocket_notifier.PluginConfig: void <init>()>/$stringconstant3	<com.matt_richardson.gocd.websocket_notifier.PluginConfig: void <init>()>
<com.matt_richardson.gocd.websocket_notifier.PluginConfig: void <init>()>/$stringconstant4	<com.matt_richardson.gocd.websocket_notifier.PluginConfig: void <init>()>
<com.matt_richardson.gocd.websocket_notifier.PluginConfig: void <init>()>/$stringconstant5	<com.matt_richardson.gocd.websocket_notifier.PluginConfig: void <init>()>
<com.matt_richardson.gocd.websocket_notifier.PluginConfig: void <init>()>/$stringconstant6	<com.matt_richardson.gocd.websocket_notifier.PluginConfig: void <init>()>
<com.matt_richardson.gocd.websocket_notifier.PluginConfig: void <init>()>/$stringconstant7	<com.matt_richardson.gocd.websocket_notifier.PluginConfig: void <init>()>
<com.matt_richardson.gocd.websocket_notifier.PluginConfig: void <init>()>/$stringconstant8	<com.matt_richardson.gocd.websocket_notifier.PluginConfig: void <init>()>
<com.matt_richardson.gocd.websocket_notifier.PluginConfig: void <init>()>/$stringconstant9	<com.matt_richardson.gocd.websocket_notifier.PluginConfig: void <init>()>
<com.matt_richardson.gocd.websocket_notifier.PluginConfig: void <init>()>/$stringconstant10	<com.matt_richardson.gocd.websocket_notifier.PluginConfig: void <init>()>
<com.matt_richardson.gocd.websocket_notifier.PluginConfig: void <init>()>/$stringconstant11	<com.matt_richardson.gocd.websocket_notifier.PluginConfig: void <init>()>
<com.matt_richardson.gocd.websocket_notifier.PluginConfig: void <init>()>/$stringconstant12	<com.matt_richardson.gocd.websocket_notifier.PluginConfig: void <init>()>
<com.matt_richardson.gocd.websocket_notifier.PluginConfig: void <init>()>/$stringconstant13	<com.matt_richardson.gocd.websocket_notifier.PluginConfig: void <init>()>
<com.matt_richardson.gocd.websocket_notifier.PluginConfig: void <init>()>/$stringconstant14	<com.matt_richardson.gocd.websocket_notifier.PluginConfig: void <init>()>
<com.matt_richardson.gocd.websocket_notifier.PluginConfig: int getPort()>/@this	<com.matt_richardson.gocd.websocket_notifier.PluginConfig: int getPort()>
<com.matt_richardson.gocd.websocket_notifier.PluginConfig: int getPort()>/this#_0	<com.matt_richardson.gocd.websocket_notifier.PluginConfig: int getPort()>
<com.matt_richardson.gocd.websocket_notifier.PluginConfig: int getPort()>/$stack1	<com.matt_richardson.gocd.websocket_notifier.PluginConfig: int getPort()>
<com.matt_richardson.gocd.websocket_notifier.PluginConfig: void setPort(int)>/@this	<com.matt_richardson.gocd.websocket_notifier.PluginConfig: void setPort(int)>
<com.matt_richardson.gocd.websocket_notifier.PluginConfig: void setPort(int)>/@parameter0	<com.matt_richardson.gocd.websocket_notifier.PluginConfig: void setPort(int)>
<com.matt_richardson.gocd.websocket_notifier.PluginConfig: void setPort(int)>/this#_0	<com.matt_richardson.gocd.websocket_notifier.PluginConfig: void setPort(int)>
<com.matt_richardson.gocd.websocket_notifier.PluginConfig: void setPort(int)>/port#_0	<com.matt_richardson.gocd.websocket_notifier.PluginConfig: void setPort(int)>
<com.matt_richardson.gocd.websocket_notifier.PluginConfig: java.lang.String getHost()>/@this	<com.matt_richardson.gocd.websocket_notifier.PluginConfig: java.lang.String getHost()>
<com.matt_richardson.gocd.websocket_notifier.PluginConfig: java.lang.String getHost()>/this#_0	<com.matt_richardson.gocd.websocket_notifier.PluginConfig: java.lang.String getHost()>
<com.matt_richardson.gocd.websocket_notifier.PluginConfig: java.lang.String getHost()>/$stack1	<com.matt_richardson.gocd.websocket_notifier.PluginConfig: java.lang.String getHost()>
<com.matt_richardson.gocd.websocket_notifier.PluginConfig: void setHost(java.lang.String)>/@this	<com.matt_richardson.gocd.websocket_notifier.PluginConfig: void setHost(java.lang.String)>
<com.matt_richardson.gocd.websocket_notifier.PluginConfig: void setHost(java.lang.String)>/@parameter0	<com.matt_richardson.gocd.websocket_notifier.PluginConfig: void setHost(java.lang.String)>
<com.matt_richardson.gocd.websocket_notifier.PluginConfig: void setHost(java.lang.String)>/this#_0	<com.matt_richardson.gocd.websocket_notifier.PluginConfig: void setHost(java.lang.String)>
<com.matt_richardson.gocd.websocket_notifier.PluginConfig: void setHost(java.lang.String)>/host#_0	<com.matt_richardson.gocd.websocket_notifier.PluginConfig: void setHost(java.lang.String)>
<com.matt_richardson.gocd.websocket_notifier.PluginConfig: boolean isHostSet()>/@this	<com.matt_richardson.gocd.websocket_notifier.PluginConfig: boolean isHostSet()>
<com.matt_richardson.gocd.websocket_notifier.PluginConfig: boolean isHostSet()>/this#_0	<com.matt_richardson.gocd.websocket_notifier.PluginConfig: boolean isHostSet()>
<com.matt_richardson.gocd.websocket_notifier.PluginConfig: boolean isHostSet()>/$stack1	<com.matt_richardson.gocd.websocket_notifier.PluginConfig: boolean isHostSet()>
<com.matt_richardson.gocd.websocket_notifier.PluginConfig: boolean isHostSet()>/$stack2	<com.matt_richardson.gocd.websocket_notifier.PluginConfig: boolean isHostSet()>
<com.matt_richardson.gocd.websocket_notifier.PluginConfig: boolean isHostSet()>/$stack3	<com.matt_richardson.gocd.websocket_notifier.PluginConfig: boolean isHostSet()>
<com.matt_richardson.gocd.websocket_notifier.PluginConfig: boolean isHostSet()>/$stack3_$$A_1	<com.matt_richardson.gocd.websocket_notifier.PluginConfig: boolean isHostSet()>
<com.matt_richardson.gocd.websocket_notifier.PluginConfig: boolean isHostSet()>/$stack3_$$A_2	<com.matt_richardson.gocd.websocket_notifier.PluginConfig: boolean isHostSet()>
<com.matt_richardson.gocd.websocket_notifier.PluginConfig: int getGoHttpPort()>/@this	<com.matt_richardson.gocd.websocket_notifier.PluginConfig: int getGoHttpPort()>
<com.matt_richardson.gocd.websocket_notifier.PluginConfig: int getGoHttpPort()>/this#_0	<com.matt_richardson.gocd.websocket_notifier.PluginConfig: int getGoHttpPort()>
<com.matt_richardson.gocd.websocket_notifier.PluginConfig: int getGoHttpPort()>/$stack1	<com.matt_richardson.gocd.websocket_notifier.PluginConfig: int getGoHttpPort()>
<com.matt_richardson.gocd.websocket_notifier.PluginConfig: void setGoHttpPort(int)>/@this	<com.matt_richardson.gocd.websocket_notifier.PluginConfig: void setGoHttpPort(int)>
<com.matt_richardson.gocd.websocket_notifier.PluginConfig: void setGoHttpPort(int)>/@parameter0	<com.matt_richardson.gocd.websocket_notifier.PluginConfig: void setGoHttpPort(int)>
<com.matt_richardson.gocd.websocket_notifier.PluginConfig: void setGoHttpPort(int)>/this#_0	<com.matt_richardson.gocd.websocket_notifier.PluginConfig: void setGoHttpPort(int)>
<com.matt_richardson.gocd.websocket_notifier.PluginConfig: void setGoHttpPort(int)>/port#_0	<com.matt_richardson.gocd.websocket_notifier.PluginConfig: void setGoHttpPort(int)>
<com.matt_richardson.gocd.websocket_notifier.PluginConfig: java.lang.String getGoUser()>/@this	<com.matt_richardson.gocd.websocket_notifier.PluginConfig: java.lang.String getGoUser()>
<com.matt_richardson.gocd.websocket_notifier.PluginConfig: java.lang.String getGoUser()>/this#_0	<com.matt_richardson.gocd.websocket_notifier.PluginConfig: java.lang.String getGoUser()>
<com.matt_richardson.gocd.websocket_notifier.PluginConfig: java.lang.String getGoUser()>/$stack1	<com.matt_richardson.gocd.websocket_notifier.PluginConfig: java.lang.String getGoUser()>
<com.matt_richardson.gocd.websocket_notifier.PluginConfig: void setGoUser(java.lang.String)>/@this	<com.matt_richardson.gocd.websocket_notifier.PluginConfig: void setGoUser(java.lang.String)>
<com.matt_richardson.gocd.websocket_notifier.PluginConfig: void setGoUser(java.lang.String)>/@parameter0	<com.matt_richardson.gocd.websocket_notifier.PluginConfig: void setGoUser(java.lang.String)>
<com.matt_richardson.gocd.websocket_notifier.PluginConfig: void setGoUser(java.lang.String)>/this#_0	<com.matt_richardson.gocd.websocket_notifier.PluginConfig: void setGoUser(java.lang.String)>
<com.matt_richardson.gocd.websocket_notifier.PluginConfig: void setGoUser(java.lang.String)>/user#_0	<com.matt_richardson.gocd.websocket_notifier.PluginConfig: void setGoUser(java.lang.String)>
<com.matt_richardson.gocd.websocket_notifier.PluginConfig: boolean isGoUserSet()>/@this	<com.matt_richardson.gocd.websocket_notifier.PluginConfig: boolean isGoUserSet()>
<com.matt_richardson.gocd.websocket_notifier.PluginConfig: boolean isGoUserSet()>/this#_0	<com.matt_richardson.gocd.websocket_notifier.PluginConfig: boolean isGoUserSet()>
<com.matt_richardson.gocd.websocket_notifier.PluginConfig: boolean isGoUserSet()>/$stack1	<com.matt_richardson.gocd.websocket_notifier.PluginConfig: boolean isGoUserSet()>
<com.matt_richardson.gocd.websocket_notifier.PluginConfig: boolean isGoUserSet()>/$stack2	<com.matt_richardson.gocd.websocket_notifier.PluginConfig: boolean isGoUserSet()>
<com.matt_richardson.gocd.websocket_notifier.PluginConfig: boolean isGoUserSet()>/$stack2_$$A_1	<com.matt_richardson.gocd.websocket_notifier.PluginConfig: boolean isGoUserSet()>
<com.matt_richardson.gocd.websocket_notifier.PluginConfig: boolean isGoUserSet()>/$stack2_$$A_2	<com.matt_richardson.gocd.websocket_notifier.PluginConfig: boolean isGoUserSet()>
<com.matt_richardson.gocd.websocket_notifier.PluginConfig: java.lang.String getGoPassword()>/@this	<com.matt_richardson.gocd.websocket_notifier.PluginConfig: java.lang.String getGoPassword()>
<com.matt_richardson.gocd.websocket_notifier.PluginConfig: java.lang.String getGoPassword()>/this#_0	<com.matt_richardson.gocd.websocket_notifier.PluginConfig: java.lang.String getGoPassword()>
<com.matt_richardson.gocd.websocket_notifier.PluginConfig: java.lang.String getGoPassword()>/$stack1	<com.matt_richardson.gocd.websocket_notifier.PluginConfig: java.lang.String getGoPassword()>
<com.matt_richardson.gocd.websocket_notifier.PluginConfig: void setGoPassword(java.lang.String)>/@this	<com.matt_richardson.gocd.websocket_notifier.PluginConfig: void setGoPassword(java.lang.String)>
<com.matt_richardson.gocd.websocket_notifier.PluginConfig: void setGoPassword(java.lang.String)>/@parameter0	<com.matt_richardson.gocd.websocket_notifier.PluginConfig: void setGoPassword(java.lang.String)>
<com.matt_richardson.gocd.websocket_notifier.PluginConfig: void setGoPassword(java.lang.String)>/this#_0	<com.matt_richardson.gocd.websocket_notifier.PluginConfig: void setGoPassword(java.lang.String)>
<com.matt_richardson.gocd.websocket_notifier.PluginConfig: void setGoPassword(java.lang.String)>/password#_0	<com.matt_richardson.gocd.websocket_notifier.PluginConfig: void setGoPassword(java.lang.String)>
<com.matt_richardson.gocd.websocket_notifier.PluginConfig: boolean isGoPasswordSet()>/@this	<com.matt_richardson.gocd.websocket_notifier.PluginConfig: boolean isGoPasswordSet()>
<com.matt_richardson.gocd.websocket_notifier.PluginConfig: boolean isGoPasswordSet()>/this#_0	<com.matt_richardson.gocd.websocket_notifier.PluginConfig: boolean isGoPasswordSet()>
<com.matt_richardson.gocd.websocket_notifier.PluginConfig: boolean isGoPasswordSet()>/$stack1	<com.matt_richardson.gocd.websocket_notifier.PluginConfig: boolean isGoPasswordSet()>
<com.matt_richardson.gocd.websocket_notifier.PluginConfig: boolean isGoPasswordSet()>/$stack2	<com.matt_richardson.gocd.websocket_notifier.PluginConfig: boolean isGoPasswordSet()>
<com.matt_richardson.gocd.websocket_notifier.PluginConfig: boolean isGoPasswordSet()>/$stack2_$$A_1	<com.matt_richardson.gocd.websocket_notifier.PluginConfig: boolean isGoPasswordSet()>
<com.matt_richardson.gocd.websocket_notifier.PluginConfig: boolean isGoPasswordSet()>/$stack2_$$A_2	<com.matt_richardson.gocd.websocket_notifier.PluginConfig: boolean isGoPasswordSet()>
<com.matt_richardson.gocd.websocket_notifier.PluginConfig: boolean hasBasicAuth()>/@this	<com.matt_richardson.gocd.websocket_notifier.PluginConfig: boolean hasBasicAuth()>
<com.matt_richardson.gocd.websocket_notifier.PluginConfig: boolean hasBasicAuth()>/this#_0	<com.matt_richardson.gocd.websocket_notifier.PluginConfig: boolean hasBasicAuth()>
<com.matt_richardson.gocd.websocket_notifier.PluginConfig: boolean hasBasicAuth()>/$stack1	<com.matt_richardson.gocd.websocket_notifier.PluginConfig: boolean hasBasicAuth()>
<com.matt_richardson.gocd.websocket_notifier.PluginConfig: boolean hasBasicAuth()>/$stack2	<com.matt_richardson.gocd.websocket_notifier.PluginConfig: boolean hasBasicAuth()>
<com.matt_richardson.gocd.websocket_notifier.PluginConfig: boolean hasBasicAuth()>/$stack3	<com.matt_richardson.gocd.websocket_notifier.PluginConfig: boolean hasBasicAuth()>
<com.matt_richardson.gocd.websocket_notifier.PluginConfig: boolean hasBasicAuth()>/$stack3_$$A_1	<com.matt_richardson.gocd.websocket_notifier.PluginConfig: boolean hasBasicAuth()>
<com.matt_richardson.gocd.websocket_notifier.PluginConfig: boolean hasBasicAuth()>/$stack3_$$A_2	<com.matt_richardson.gocd.websocket_notifier.PluginConfig: boolean hasBasicAuth()>
<com.matt_richardson.gocd.websocket_notifier.PluginConfig: void <clinit>()>/$stack0	<com.matt_richardson.gocd.websocket_notifier.PluginConfig: void <clinit>()>
<com.matt_richardson.gocd.websocket_notifier.PluginConfig: void <clinit>()>/$classconstant0	<com.matt_richardson.gocd.websocket_notifier.PluginConfig: void <clinit>()>
<com.matt_richardson.gocd.websocket_notifier.WebSocketPipelineListener: void <init>(com.matt_richardson.gocd.websocket_notifier.PipelineWebSocketServer,com.matt_richardson.gocd.websocket_notifier.PluginConfig)>/@this	<com.matt_richardson.gocd.websocket_notifier.WebSocketPipelineListener: void <init>(com.matt_richardson.gocd.websocket_notifier.PipelineWebSocketServer,com.matt_richardson.gocd.websocket_notifier.PluginConfig)>
<com.matt_richardson.gocd.websocket_notifier.WebSocketPipelineListener: void <init>(com.matt_richardson.gocd.websocket_notifier.PipelineWebSocketServer,com.matt_richardson.gocd.websocket_notifier.PluginConfig)>/@parameter0	<com.matt_richardson.gocd.websocket_notifier.WebSocketPipelineListener: void <init>(com.matt_richardson.gocd.websocket_notifier.PipelineWebSocketServer,com.matt_richardson.gocd.websocket_notifier.PluginConfig)>
<com.matt_richardson.gocd.websocket_notifier.WebSocketPipelineListener: void <init>(com.matt_richardson.gocd.websocket_notifier.PipelineWebSocketServer,com.matt_richardson.gocd.websocket_notifier.PluginConfig)>/@parameter1	<com.matt_richardson.gocd.websocket_notifier.WebSocketPipelineListener: void <init>(com.matt_richardson.gocd.websocket_notifier.PipelineWebSocketServer,com.matt_richardson.gocd.websocket_notifier.PluginConfig)>
<com.matt_richardson.gocd.websocket_notifier.WebSocketPipelineListener: void <init>(com.matt_richardson.gocd.websocket_notifier.PipelineWebSocketServer,com.matt_richardson.gocd.websocket_notifier.PluginConfig)>/this#_0	<com.matt_richardson.gocd.websocket_notifier.WebSocketPipelineListener: void <init>(com.matt_richardson.gocd.websocket_notifier.PipelineWebSocketServer,com.matt_richardson.gocd.websocket_notifier.PluginConfig)>
<com.matt_richardson.gocd.websocket_notifier.WebSocketPipelineListener: void <init>(com.matt_richardson.gocd.websocket_notifier.PipelineWebSocketServer,com.matt_richardson.gocd.websocket_notifier.PluginConfig)>/$stack3	<com.matt_richardson.gocd.websocket_notifier.WebSocketPipelineListener: void <init>(com.matt_richardson.gocd.websocket_notifier.PipelineWebSocketServer,com.matt_richardson.gocd.websocket_notifier.PluginConfig)>
<com.matt_richardson.gocd.websocket_notifier.WebSocketPipelineListener: void <init>(com.matt_richardson.gocd.websocket_notifier.PipelineWebSocketServer,com.matt_richardson.gocd.websocket_notifier.PluginConfig)>/webSocketServer#_0	<com.matt_richardson.gocd.websocket_notifier.WebSocketPipelineListener: void <init>(com.matt_richardson.gocd.websocket_notifier.PipelineWebSocketServer,com.matt_richardson.gocd.websocket_notifier.PluginConfig)>
<com.matt_richardson.gocd.websocket_notifier.WebSocketPipelineListener: void <init>(com.matt_richardson.gocd.websocket_notifier.PipelineWebSocketServer,com.matt_richardson.gocd.websocket_notifier.PluginConfig)>/$stack4	<com.matt_richardson.gocd.websocket_notifier.WebSocketPipelineListener: void <init>(com.matt_richardson.gocd.websocket_notifier.PipelineWebSocketServer,com.matt_richardson.gocd.websocket_notifier.PluginConfig)>
<com.matt_richardson.gocd.websocket_notifier.WebSocketPipelineListener: void <init>(com.matt_richardson.gocd.websocket_notifier.PipelineWebSocketServer,com.matt_richardson.gocd.websocket_notifier.PluginConfig)>/pluginConfig#_0	<com.matt_richardson.gocd.websocket_notifier.WebSocketPipelineListener: void <init>(com.matt_richardson.gocd.websocket_notifier.PipelineWebSocketServer,com.matt_richardson.gocd.websocket_notifier.PluginConfig)>
<com.matt_richardson.gocd.websocket_notifier.WebSocketPipelineListener: void <init>(com.matt_richardson.gocd.websocket_notifier.PipelineWebSocketServer,com.matt_richardson.gocd.websocket_notifier.PluginConfig)>/$classconstant0	<com.matt_richardson.gocd.websocket_notifier.WebSocketPipelineListener: void <init>(com.matt_richardson.gocd.websocket_notifier.PipelineWebSocketServer,com.matt_richardson.gocd.websocket_notifier.PluginConfig)>
<com.matt_richardson.gocd.websocket_notifier.WebSocketPipelineListener: void notify(com.thoughtworks.go.plugin.api.request.GoPluginApiRequest)>/@this	<com.matt_richardson.gocd.websocket_notifier.WebSocketPipelineListener: void notify(com.thoughtworks.go.plugin.api.request.GoPluginApiRequest)>
<com.matt_richardson.gocd.websocket_notifier.WebSocketPipelineListener: void notify(com.thoughtworks.go.plugin.api.request.GoPluginApiRequest)>/@parameter0	<com.matt_richardson.gocd.websocket_notifier.WebSocketPipelineListener: void notify(com.thoughtworks.go.plugin.api.request.GoPluginApiRequest)>
<com.matt_richardson.gocd.websocket_notifier.WebSocketPipelineListener: void notify(com.thoughtworks.go.plugin.api.request.GoPluginApiRequest)>/this#_0	<com.matt_richardson.gocd.websocket_notifier.WebSocketPipelineListener: void notify(com.thoughtworks.go.plugin.api.request.GoPluginApiRequest)>
<com.matt_richardson.gocd.websocket_notifier.WebSocketPipelineListener: void notify(com.thoughtworks.go.plugin.api.request.GoPluginApiRequest)>/$stack3	<com.matt_richardson.gocd.websocket_notifier.WebSocketPipelineListener: void notify(com.thoughtworks.go.plugin.api.request.GoPluginApiRequest)>
<com.matt_richardson.gocd.websocket_notifier.WebSocketPipelineListener: void notify(com.thoughtworks.go.plugin.api.request.GoPluginApiRequest)>/$stack4	<com.matt_richardson.gocd.websocket_notifier.WebSocketPipelineListener: void notify(com.thoughtworks.go.plugin.api.request.GoPluginApiRequest)>
<com.matt_richardson.gocd.websocket_notifier.WebSocketPipelineListener: void notify(com.thoughtworks.go.plugin.api.request.GoPluginApiRequest)>/message#_0	<com.matt_richardson.gocd.websocket_notifier.WebSocketPipelineListener: void notify(com.thoughtworks.go.plugin.api.request.GoPluginApiRequest)>
<com.matt_richardson.gocd.websocket_notifier.WebSocketPipelineListener: void notify(com.thoughtworks.go.plugin.api.request.GoPluginApiRequest)>/$stack5	<com.matt_richardson.gocd.websocket_notifier.WebSocketPipelineListener: void notify(com.thoughtworks.go.plugin.api.request.GoPluginApiRequest)>
<com.matt_richardson.gocd.websocket_notifier.WebSocketPipelineListener: void notify(com.thoughtworks.go.plugin.api.request.GoPluginApiRequest)>/$stack6	<com.matt_richardson.gocd.websocket_notifier.WebSocketPipelineListener: void notify(com.thoughtworks.go.plugin.api.request.GoPluginApiRequest)>
<com.matt_richardson.gocd.websocket_notifier.WebSocketPipelineListener: void notify(com.thoughtworks.go.plugin.api.request.GoPluginApiRequest)>/$stack7	<com.matt_richardson.gocd.websocket_notifier.WebSocketPipelineListener: void notify(com.thoughtworks.go.plugin.api.request.GoPluginApiRequest)>
<com.matt_richardson.gocd.websocket_notifier.WebSocketPipelineListener: void notify(com.thoughtworks.go.plugin.api.request.GoPluginApiRequest)>/$stack8	<com.matt_richardson.gocd.websocket_notifier.WebSocketPipelineListener: void notify(com.thoughtworks.go.plugin.api.request.GoPluginApiRequest)>
<com.matt_richardson.gocd.websocket_notifier.WebSocketPipelineListener: void notify(com.thoughtworks.go.plugin.api.request.GoPluginApiRequest)>/$stack9	<com.matt_richardson.gocd.websocket_notifier.WebSocketPipelineListener: void notify(com.thoughtworks.go.plugin.api.request.GoPluginApiRequest)>
<com.matt_richardson.gocd.websocket_notifier.WebSocketPipelineListener: void notify(com.thoughtworks.go.plugin.api.request.GoPluginApiRequest)>/$stack10	<com.matt_richardson.gocd.websocket_notifier.WebSocketPipelineListener: void notify(com.thoughtworks.go.plugin.api.request.GoPluginApiRequest)>
<com.matt_richardson.gocd.websocket_notifier.WebSocketPipelineListener: void notify(com.thoughtworks.go.plugin.api.request.GoPluginApiRequest)>/$stack11	<com.matt_richardson.gocd.websocket_notifier.WebSocketPipelineListener: void notify(com.thoughtworks.go.plugin.api.request.GoPluginApiRequest)>
<com.matt_richardson.gocd.websocket_notifier.WebSocketPipelineListener: void notify(com.thoughtworks.go.plugin.api.request.GoPluginApiRequest)>/$stack12	<com.matt_richardson.gocd.websocket_notifier.WebSocketPipelineListener: void notify(com.thoughtworks.go.plugin.api.request.GoPluginApiRequest)>
<com.matt_richardson.gocd.websocket_notifier.WebSocketPipelineListener: void notify(com.thoughtworks.go.plugin.api.request.GoPluginApiRequest)>/$stack13	<com.matt_richardson.gocd.websocket_notifier.WebSocketPipelineListener: void notify(com.thoughtworks.go.plugin.api.request.GoPluginApiRequest)>
<com.matt_richardson.gocd.websocket_notifier.WebSocketPipelineListener: void notify(com.thoughtworks.go.plugin.api.request.GoPluginApiRequest)>/$stack14	<com.matt_richardson.gocd.websocket_notifier.WebSocketPipelineListener: void notify(com.thoughtworks.go.plugin.api.request.GoPluginApiRequest)>
<com.matt_richardson.gocd.websocket_notifier.WebSocketPipelineListener: void notify(com.thoughtworks.go.plugin.api.request.GoPluginApiRequest)>/expandedMessage#_19	<com.matt_richardson.gocd.websocket_notifier.WebSocketPipelineListener: void notify(com.thoughtworks.go.plugin.api.request.GoPluginApiRequest)>
<com.matt_richardson.gocd.websocket_notifier.WebSocketPipelineListener: void notify(com.thoughtworks.go.plugin.api.request.GoPluginApiRequest)>/$stack15	<com.matt_richardson.gocd.websocket_notifier.WebSocketPipelineListener: void notify(com.thoughtworks.go.plugin.api.request.GoPluginApiRequest)>
<com.matt_richardson.gocd.websocket_notifier.WebSocketPipelineListener: void notify(com.thoughtworks.go.plugin.api.request.GoPluginApiRequest)>/$stringconstant0	<com.matt_richardson.gocd.websocket_notifier.WebSocketPipelineListener: void notify(com.thoughtworks.go.plugin.api.request.GoPluginApiRequest)>
<com.matt_richardson.gocd.websocket_notifier.WebSocketPipelineListener: void notify(com.thoughtworks.go.plugin.api.request.GoPluginApiRequest)>/$stringconstant1	<com.matt_richardson.gocd.websocket_notifier.WebSocketPipelineListener: void notify(com.thoughtworks.go.plugin.api.request.GoPluginApiRequest)>
<com.matt_richardson.gocd.websocket_notifier.WebSocketPipelineListener: void notify(com.thoughtworks.go.plugin.api.request.GoPluginApiRequest)>/$stringconstant2	<com.matt_richardson.gocd.websocket_notifier.WebSocketPipelineListener: void notify(com.thoughtworks.go.plugin.api.request.GoPluginApiRequest)>
<com.matt_richardson.gocd.websocket_notifier.PipelineDetailsPopulator: void <init>(com.matt_richardson.gocd.websocket_notifier.PluginConfig)>/@this	<com.matt_richardson.gocd.websocket_notifier.PipelineDetailsPopulator: void <init>(com.matt_richardson.gocd.websocket_notifier.PluginConfig)>
<com.matt_richardson.gocd.websocket_notifier.PipelineDetailsPopulator: void <init>(com.matt_richardson.gocd.websocket_notifier.PluginConfig)>/@parameter0	<com.matt_richardson.gocd.websocket_notifier.PipelineDetailsPopulator: void <init>(com.matt_richardson.gocd.websocket_notifier.PluginConfig)>
<com.matt_richardson.gocd.websocket_notifier.PipelineDetailsPopulator: void <init>(com.matt_richardson.gocd.websocket_notifier.PluginConfig)>/this#_0	<com.matt_richardson.gocd.websocket_notifier.PipelineDetailsPopulator: void <init>(com.matt_richardson.gocd.websocket_notifier.PluginConfig)>
<com.matt_richardson.gocd.websocket_notifier.PipelineDetailsPopulator: void <init>(com.matt_richardson.gocd.websocket_notifier.PluginConfig)>/pluginConfig#_0	<com.matt_richardson.gocd.websocket_notifier.PipelineDetailsPopulator: void <init>(com.matt_richardson.gocd.websocket_notifier.PluginConfig)>
<com.matt_richardson.gocd.websocket_notifier.PipelineDetailsPopulator: java.lang.String mergeInPipelineInstanceDetails(com.google.gson.JsonElement,com.google.gson.JsonElement)>/@this	<com.matt_richardson.gocd.websocket_notifier.PipelineDetailsPopulator: java.lang.String mergeInPipelineInstanceDetails(com.google.gson.JsonElement,com.google.gson.JsonElement)>
<com.matt_richardson.gocd.websocket_notifier.PipelineDetailsPopulator: java.lang.String mergeInPipelineInstanceDetails(com.google.gson.JsonElement,com.google.gson.JsonElement)>/@parameter0	<com.matt_richardson.gocd.websocket_notifier.PipelineDetailsPopulator: java.lang.String mergeInPipelineInstanceDetails(com.google.gson.JsonElement,com.google.gson.JsonElement)>
<com.matt_richardson.gocd.websocket_notifier.PipelineDetailsPopulator: java.lang.String mergeInPipelineInstanceDetails(com.google.gson.JsonElement,com.google.gson.JsonElement)>/@parameter1	<com.matt_richardson.gocd.websocket_notifier.PipelineDetailsPopulator: java.lang.String mergeInPipelineInstanceDetails(com.google.gson.JsonElement,com.google.gson.JsonElement)>
<com.matt_richardson.gocd.websocket_notifier.PipelineDetailsPopulator: java.lang.String mergeInPipelineInstanceDetails(com.google.gson.JsonElement,com.google.gson.JsonElement)>/notification#_0	<com.matt_richardson.gocd.websocket_notifier.PipelineDetailsPopulator: java.lang.String mergeInPipelineInstanceDetails(com.google.gson.JsonElement,com.google.gson.JsonElement)>
<com.matt_richardson.gocd.websocket_notifier.PipelineDetailsPopulator: java.lang.String mergeInPipelineInstanceDetails(com.google.gson.JsonElement,com.google.gson.JsonElement)>/json#_26	<com.matt_richardson.gocd.websocket_notifier.PipelineDetailsPopulator: java.lang.String mergeInPipelineInstanceDetails(com.google.gson.JsonElement,com.google.gson.JsonElement)>
<com.matt_richardson.gocd.websocket_notifier.PipelineDetailsPopulator: java.lang.String mergeInPipelineInstanceDetails(com.google.gson.JsonElement,com.google.gson.JsonElement)>/pipelineInstance#_0	<com.matt_richardson.gocd.websocket_notifier.PipelineDetailsPopulator: java.lang.String mergeInPipelineInstanceDetails(com.google.gson.JsonElement,com.google.gson.JsonElement)>
<com.matt_richardson.gocd.websocket_notifier.PipelineDetailsPopulator: java.lang.String mergeInPipelineInstanceDetails(com.google.gson.JsonElement,com.google.gson.JsonElement)>/$stack4	<com.matt_richardson.gocd.websocket_notifier.PipelineDetailsPopulator: java.lang.String mergeInPipelineInstanceDetails(com.google.gson.JsonElement,com.google.gson.JsonElement)>
<com.matt_richardson.gocd.websocket_notifier.PipelineDetailsPopulator: java.lang.String mergeInPipelineInstanceDetails(com.google.gson.JsonElement,com.google.gson.JsonElement)>/this#_0	<com.matt_richardson.gocd.websocket_notifier.PipelineDetailsPopulator: java.lang.String mergeInPipelineInstanceDetails(com.google.gson.JsonElement,com.google.gson.JsonElement)>
<com.matt_richardson.gocd.websocket_notifier.PipelineDetailsPopulator: java.lang.String mergeInPipelineInstanceDetails(com.google.gson.JsonElement,com.google.gson.JsonElement)>/$stringconstant0	<com.matt_richardson.gocd.websocket_notifier.PipelineDetailsPopulator: java.lang.String mergeInPipelineInstanceDetails(com.google.gson.JsonElement,com.google.gson.JsonElement)>
<com.matt_richardson.gocd.websocket_notifier.PipelineDetailsPopulator: com.google.gson.JsonElement downloadPipelineInstanceDetails(java.lang.String)>/@this	<com.matt_richardson.gocd.websocket_notifier.PipelineDetailsPopulator: com.google.gson.JsonElement downloadPipelineInstanceDetails(java.lang.String)>
<com.matt_richardson.gocd.websocket_notifier.PipelineDetailsPopulator: com.google.gson.JsonElement downloadPipelineInstanceDetails(java.lang.String)>/@parameter0	<com.matt_richardson.gocd.websocket_notifier.PipelineDetailsPopulator: com.google.gson.JsonElement downloadPipelineInstanceDetails(java.lang.String)>
<com.matt_richardson.gocd.websocket_notifier.PipelineDetailsPopulator: com.google.gson.JsonElement downloadPipelineInstanceDetails(java.lang.String)>/this#_0	<com.matt_richardson.gocd.websocket_notifier.PipelineDetailsPopulator: com.google.gson.JsonElement downloadPipelineInstanceDetails(java.lang.String)>
<com.matt_richardson.gocd.websocket_notifier.PipelineDetailsPopulator: com.google.gson.JsonElement downloadPipelineInstanceDetails(java.lang.String)>/$stack10	<com.matt_richardson.gocd.websocket_notifier.PipelineDetailsPopulator: com.google.gson.JsonElement downloadPipelineInstanceDetails(java.lang.String)>
<com.matt_richardson.gocd.websocket_notifier.PipelineDetailsPopulator: com.google.gson.JsonElement downloadPipelineInstanceDetails(java.lang.String)>/goHttpPort#_32	<com.matt_richardson.gocd.websocket_notifier.PipelineDetailsPopulator: com.google.gson.JsonElement downloadPipelineInstanceDetails(java.lang.String)>
<com.matt_richardson.gocd.websocket_notifier.PipelineDetailsPopulator: com.google.gson.JsonElement downloadPipelineInstanceDetails(java.lang.String)>/$stack11	<com.matt_richardson.gocd.websocket_notifier.PipelineDetailsPopulator: com.google.gson.JsonElement downloadPipelineInstanceDetails(java.lang.String)>
<com.matt_richardson.gocd.websocket_notifier.PipelineDetailsPopulator: com.google.gson.JsonElement downloadPipelineInstanceDetails(java.lang.String)>/$stack12	<com.matt_richardson.gocd.websocket_notifier.PipelineDetailsPopulator: com.google.gson.JsonElement downloadPipelineInstanceDetails(java.lang.String)>
<com.matt_richardson.gocd.websocket_notifier.PipelineDetailsPopulator: com.google.gson.JsonElement downloadPipelineInstanceDetails(java.lang.String)>/$stack13	<com.matt_richardson.gocd.websocket_notifier.PipelineDetailsPopulator: com.google.gson.JsonElement downloadPipelineInstanceDetails(java.lang.String)>
<com.matt_richardson.gocd.websocket_notifier.PipelineDetailsPopulator: com.google.gson.JsonElement downloadPipelineInstanceDetails(java.lang.String)>/pipelineName#_0	<com.matt_richardson.gocd.websocket_notifier.PipelineDetailsPopulator: com.google.gson.JsonElement downloadPipelineInstanceDetails(java.lang.String)>
<com.matt_richardson.gocd.websocket_notifier.PipelineDetailsPopulator: com.google.gson.JsonElement downloadPipelineInstanceDetails(java.lang.String)>/$stack14	<com.matt_richardson.gocd.websocket_notifier.PipelineDetailsPopulator: com.google.gson.JsonElement downloadPipelineInstanceDetails(java.lang.String)>
<com.matt_richardson.gocd.websocket_notifier.PipelineDetailsPopulator: com.google.gson.JsonElement downloadPipelineInstanceDetails(java.lang.String)>/$stack15	<com.matt_richardson.gocd.websocket_notifier.PipelineDetailsPopulator: com.google.gson.JsonElement downloadPipelineInstanceDetails(java.lang.String)>
<com.matt_richardson.gocd.websocket_notifier.PipelineDetailsPopulator: com.google.gson.JsonElement downloadPipelineInstanceDetails(java.lang.String)>/$stack16	<com.matt_richardson.gocd.websocket_notifier.PipelineDetailsPopulator: com.google.gson.JsonElement downloadPipelineInstanceDetails(java.lang.String)>
<com.matt_richardson.gocd.websocket_notifier.PipelineDetailsPopulator: com.google.gson.JsonElement downloadPipelineInstanceDetails(java.lang.String)>/sURL#_33	<com.matt_richardson.gocd.websocket_notifier.PipelineDetailsPopulator: com.google.gson.JsonElement downloadPipelineInstanceDetails(java.lang.String)>
<com.matt_richardson.gocd.websocket_notifier.PipelineDetailsPopulator: com.google.gson.JsonElement downloadPipelineInstanceDetails(java.lang.String)>/$stack17	<com.matt_richardson.gocd.websocket_notifier.PipelineDetailsPopulator: com.google.gson.JsonElement downloadPipelineInstanceDetails(java.lang.String)>
<com.matt_richardson.gocd.websocket_notifier.PipelineDetailsPopulator: com.google.gson.JsonElement downloadPipelineInstanceDetails(java.lang.String)>/$stack18	<com.matt_richardson.gocd.websocket_notifier.PipelineDetailsPopulator: com.google.gson.JsonElement downloadPipelineInstanceDetails(java.lang.String)>
<com.matt_richardson.gocd.websocket_notifier.PipelineDetailsPopulator: com.google.gson.JsonElement downloadPipelineInstanceDetails(java.lang.String)>/request#_36	<com.matt_richardson.gocd.websocket_notifier.PipelineDetailsPopulator: com.google.gson.JsonElement downloadPipelineInstanceDetails(java.lang.String)>
<com.matt_richardson.gocd.websocket_notifier.PipelineDetailsPopulator: com.google.gson.JsonElement downloadPipelineInstanceDetails(java.lang.String)>/$stack19	<com.matt_richardson.gocd.websocket_notifier.PipelineDetailsPopulator: com.google.gson.JsonElement downloadPipelineInstanceDetails(java.lang.String)>
<com.matt_richardson.gocd.websocket_notifier.PipelineDetailsPopulator: com.google.gson.JsonElement downloadPipelineInstanceDetails(java.lang.String)>/$stack20	<com.matt_richardson.gocd.websocket_notifier.PipelineDetailsPopulator: com.google.gson.JsonElement downloadPipelineInstanceDetails(java.lang.String)>
<com.matt_richardson.gocd.websocket_notifier.PipelineDetailsPopulator: com.google.gson.JsonElement downloadPipelineInstanceDetails(java.lang.String)>/$stack21	<com.matt_richardson.gocd.websocket_notifier.PipelineDetailsPopulator: com.google.gson.JsonElement downloadPipelineInstanceDetails(java.lang.String)>
<com.matt_richardson.gocd.websocket_notifier.PipelineDetailsPopulator: com.google.gson.JsonElement downloadPipelineInstanceDetails(java.lang.String)>/$stack22	<com.matt_richardson.gocd.websocket_notifier.PipelineDetailsPopulator: com.google.gson.JsonElement downloadPipelineInstanceDetails(java.lang.String)>
<com.matt_richardson.gocd.websocket_notifier.PipelineDetailsPopulator: com.google.gson.JsonElement downloadPipelineInstanceDetails(java.lang.String)>/$stack23	<com.matt_richardson.gocd.websocket_notifier.PipelineDetailsPopulator: com.google.gson.JsonElement downloadPipelineInstanceDetails(java.lang.String)>
<com.matt_richardson.gocd.websocket_notifier.PipelineDetailsPopulator: com.google.gson.JsonElement downloadPipelineInstanceDetails(java.lang.String)>/$stack24	<com.matt_richardson.gocd.websocket_notifier.PipelineDetailsPopulator: com.google.gson.JsonElement downloadPipelineInstanceDetails(java.lang.String)>
<com.matt_richardson.gocd.websocket_notifier.PipelineDetailsPopulator: com.google.gson.JsonElement downloadPipelineInstanceDetails(java.lang.String)>/$stack25	<com.matt_richardson.gocd.websocket_notifier.PipelineDetailsPopulator: com.google.gson.JsonElement downloadPipelineInstanceDetails(java.lang.String)>
<com.matt_richardson.gocd.websocket_notifier.PipelineDetailsPopulator: com.google.gson.JsonElement downloadPipelineInstanceDetails(java.lang.String)>/$stack26	<com.matt_richardson.gocd.websocket_notifier.PipelineDetailsPopulator: com.google.gson.JsonElement downloadPipelineInstanceDetails(java.lang.String)>
<com.matt_richardson.gocd.websocket_notifier.PipelineDetailsPopulator: com.google.gson.JsonElement downloadPipelineInstanceDetails(java.lang.String)>/$stack27	<com.matt_richardson.gocd.websocket_notifier.PipelineDetailsPopulator: com.google.gson.JsonElement downloadPipelineInstanceDetails(java.lang.String)>
<com.matt_richardson.gocd.websocket_notifier.PipelineDetailsPopulator: com.google.gson.JsonElement downloadPipelineInstanceDetails(java.lang.String)>/$stack28	<com.matt_richardson.gocd.websocket_notifier.PipelineDetailsPopulator: com.google.gson.JsonElement downloadPipelineInstanceDetails(java.lang.String)>
<com.matt_richardson.gocd.websocket_notifier.PipelineDetailsPopulator: com.google.gson.JsonElement downloadPipelineInstanceDetails(java.lang.String)>/$stack29	<com.matt_richardson.gocd.websocket_notifier.PipelineDetailsPopulator: com.google.gson.JsonElement downloadPipelineInstanceDetails(java.lang.String)>
<com.matt_richardson.gocd.websocket_notifier.PipelineDetailsPopulator: com.google.gson.JsonElement downloadPipelineInstanceDetails(java.lang.String)>/$stack30	<com.matt_richardson.gocd.websocket_notifier.PipelineDetailsPopulator: com.google.gson.JsonElement downloadPipelineInstanceDetails(java.lang.String)>
<com.matt_richardson.gocd.websocket_notifier.PipelineDetailsPopulator: com.google.gson.JsonElement downloadPipelineInstanceDetails(java.lang.String)>/$stack31	<com.matt_richardson.gocd.websocket_notifier.PipelineDetailsPopulator: com.google.gson.JsonElement downloadPipelineInstanceDetails(java.lang.String)>
<com.matt_richardson.gocd.websocket_notifier.PipelineDetailsPopulator: com.google.gson.JsonElement downloadPipelineInstanceDetails(java.lang.String)>/$stack32	<com.matt_richardson.gocd.websocket_notifier.PipelineDetailsPopulator: com.google.gson.JsonElement downloadPipelineInstanceDetails(java.lang.String)>
<com.matt_richardson.gocd.websocket_notifier.PipelineDetailsPopulator: com.google.gson.JsonElement downloadPipelineInstanceDetails(java.lang.String)>/$stack33	<com.matt_richardson.gocd.websocket_notifier.PipelineDetailsPopulator: com.google.gson.JsonElement downloadPipelineInstanceDetails(java.lang.String)>
<com.matt_richardson.gocd.websocket_notifier.PipelineDetailsPopulator: com.google.gson.JsonElement downloadPipelineInstanceDetails(java.lang.String)>/$stack34	<com.matt_richardson.gocd.websocket_notifier.PipelineDetailsPopulator: com.google.gson.JsonElement downloadPipelineInstanceDetails(java.lang.String)>
<com.matt_richardson.gocd.websocket_notifier.PipelineDetailsPopulator: com.google.gson.JsonElement downloadPipelineInstanceDetails(java.lang.String)>/$stack35	<com.matt_richardson.gocd.websocket_notifier.PipelineDetailsPopulator: com.google.gson.JsonElement downloadPipelineInstanceDetails(java.lang.String)>
<com.matt_richardson.gocd.websocket_notifier.PipelineDetailsPopulator: com.google.gson.JsonElement downloadPipelineInstanceDetails(java.lang.String)>/$stack36	<com.matt_richardson.gocd.websocket_notifier.PipelineDetailsPopulator: com.google.gson.JsonElement downloadPipelineInstanceDetails(java.lang.String)>
<com.matt_richardson.gocd.websocket_notifier.PipelineDetailsPopulator: com.google.gson.JsonElement downloadPipelineInstanceDetails(java.lang.String)>/$stack37	<com.matt_richardson.gocd.websocket_notifier.PipelineDetailsPopulator: com.google.gson.JsonElement downloadPipelineInstanceDetails(java.lang.String)>
<com.matt_richardson.gocd.websocket_notifier.PipelineDetailsPopulator: com.google.gson.JsonElement downloadPipelineInstanceDetails(java.lang.String)>/$stack38	<com.matt_richardson.gocd.websocket_notifier.PipelineDetailsPopulator: com.google.gson.JsonElement downloadPipelineInstanceDetails(java.lang.String)>
<com.matt_richardson.gocd.websocket_notifier.PipelineDetailsPopulator: com.google.gson.JsonElement downloadPipelineInstanceDetails(java.lang.String)>/$stack39	<com.matt_richardson.gocd.websocket_notifier.PipelineDetailsPopulator: com.google.gson.JsonElement downloadPipelineInstanceDetails(java.lang.String)>
<com.matt_richardson.gocd.websocket_notifier.PipelineDetailsPopulator: com.google.gson.JsonElement downloadPipelineInstanceDetails(java.lang.String)>/$stack43	<com.matt_richardson.gocd.websocket_notifier.PipelineDetailsPopulator: com.google.gson.JsonElement downloadPipelineInstanceDetails(java.lang.String)>
<com.matt_richardson.gocd.websocket_notifier.PipelineDetailsPopulator: com.google.gson.JsonElement downloadPipelineInstanceDetails(java.lang.String)>/$stack45	<com.matt_richardson.gocd.websocket_notifier.PipelineDetailsPopulator: com.google.gson.JsonElement downloadPipelineInstanceDetails(java.lang.String)>
<com.matt_richardson.gocd.websocket_notifier.PipelineDetailsPopulator: com.google.gson.JsonElement downloadPipelineInstanceDetails(java.lang.String)>/$stack48	<com.matt_richardson.gocd.websocket_notifier.PipelineDetailsPopulator: com.google.gson.JsonElement downloadPipelineInstanceDetails(java.lang.String)>
<com.matt_richardson.gocd.websocket_notifier.PipelineDetailsPopulator: com.google.gson.JsonElement downloadPipelineInstanceDetails(java.lang.String)>/user#_38	<com.matt_richardson.gocd.websocket_notifier.PipelineDetailsPopulator: com.google.gson.JsonElement downloadPipelineInstanceDetails(java.lang.String)>
<com.matt_richardson.gocd.websocket_notifier.PipelineDetailsPopulator: com.google.gson.JsonElement downloadPipelineInstanceDetails(java.lang.String)>/password#_39	<com.matt_richardson.gocd.websocket_notifier.PipelineDetailsPopulator: com.google.gson.JsonElement downloadPipelineInstanceDetails(java.lang.String)>
<com.matt_richardson.gocd.websocket_notifier.PipelineDetailsPopulator: com.google.gson.JsonElement downloadPipelineInstanceDetails(java.lang.String)>/authString#_41	<com.matt_richardson.gocd.websocket_notifier.PipelineDetailsPopulator: com.google.gson.JsonElement downloadPipelineInstanceDetails(java.lang.String)>
<com.matt_richardson.gocd.websocket_notifier.PipelineDetailsPopulator: com.google.gson.JsonElement downloadPipelineInstanceDetails(java.lang.String)>/$stringconstant0	<com.matt_richardson.gocd.websocket_notifier.PipelineDetailsPopulator: com.google.gson.JsonElement downloadPipelineInstanceDetails(java.lang.String)>
<com.matt_richardson.gocd.websocket_notifier.PipelineDetailsPopulator: com.google.gson.JsonElement downloadPipelineInstanceDetails(java.lang.String)>/$stringconstant1	<com.matt_richardson.gocd.websocket_notifier.PipelineDetailsPopulator: com.google.gson.JsonElement downloadPipelineInstanceDetails(java.lang.String)>
<com.matt_richardson.gocd.websocket_notifier.PipelineDetailsPopulator: com.google.gson.JsonElement downloadPipelineInstanceDetails(java.lang.String)>/$stringconstant2	<com.matt_richardson.gocd.websocket_notifier.PipelineDetailsPopulator: com.google.gson.JsonElement downloadPipelineInstanceDetails(java.lang.String)>
<com.matt_richardson.gocd.websocket_notifier.PipelineDetailsPopulator: com.google.gson.JsonElement downloadPipelineInstanceDetails(java.lang.String)>/$stringconstant3	<com.matt_richardson.gocd.websocket_notifier.PipelineDetailsPopulator: com.google.gson.JsonElement downloadPipelineInstanceDetails(java.lang.String)>
<com.matt_richardson.gocd.websocket_notifier.PipelineDetailsPopulator: com.google.gson.JsonElement downloadPipelineInstanceDetails(java.lang.String)>/$stringconstant4	<com.matt_richardson.gocd.websocket_notifier.PipelineDetailsPopulator: com.google.gson.JsonElement downloadPipelineInstanceDetails(java.lang.String)>
<com.matt_richardson.gocd.websocket_notifier.PipelineDetailsPopulator: com.google.gson.JsonElement downloadPipelineInstanceDetails(java.lang.String)>/$stringconstant5	<com.matt_richardson.gocd.websocket_notifier.PipelineDetailsPopulator: com.google.gson.JsonElement downloadPipelineInstanceDetails(java.lang.String)>
<com.matt_richardson.gocd.websocket_notifier.PipelineDetailsPopulator: com.google.gson.JsonElement downloadPipelineInstanceDetails(java.lang.String)>/$stringconstant6	<com.matt_richardson.gocd.websocket_notifier.PipelineDetailsPopulator: com.google.gson.JsonElement downloadPipelineInstanceDetails(java.lang.String)>
<com.matt_richardson.gocd.websocket_notifier.PipelineDetailsPopulator: com.google.gson.JsonElement downloadPipelineInstanceDetails(java.lang.String)>/$numconstant0	<com.matt_richardson.gocd.websocket_notifier.PipelineDetailsPopulator: com.google.gson.JsonElement downloadPipelineInstanceDetails(java.lang.String)>
<com.matt_richardson.gocd.websocket_notifier.PipelineDetailsPopulator: java.lang.String extendMessageToIncludePipelineDetails(java.lang.String)>/@this	<com.matt_richardson.gocd.websocket_notifier.PipelineDetailsPopulator: java.lang.String extendMessageToIncludePipelineDetails(java.lang.String)>
<com.matt_richardson.gocd.websocket_notifier.PipelineDetailsPopulator: java.lang.String extendMessageToIncludePipelineDetails(java.lang.String)>/@parameter0	<com.matt_richardson.gocd.websocket_notifier.PipelineDetailsPopulator: java.lang.String extendMessageToIncludePipelineDetails(java.lang.String)>
<com.matt_richardson.gocd.websocket_notifier.PipelineDetailsPopulator: java.lang.String extendMessageToIncludePipelineDetails(java.lang.String)>/requestBody#_0	<com.matt_richardson.gocd.websocket_notifier.PipelineDetailsPopulator: java.lang.String extendMessageToIncludePipelineDetails(java.lang.String)>
<com.matt_richardson.gocd.websocket_notifier.PipelineDetailsPopulator: java.lang.String extendMessageToIncludePipelineDetails(java.lang.String)>/$stack8	<com.matt_richardson.gocd.websocket_notifier.PipelineDetailsPopulator: java.lang.String extendMessageToIncludePipelineDetails(java.lang.String)>
<com.matt_richardson.gocd.websocket_notifier.PipelineDetailsPopulator: java.lang.String extendMessageToIncludePipelineDetails(java.lang.String)>/json#_56	<com.matt_richardson.gocd.websocket_notifier.PipelineDetailsPopulator: java.lang.String extendMessageToIncludePipelineDetails(java.lang.String)>
<com.matt_richardson.gocd.websocket_notifier.PipelineDetailsPopulator: java.lang.String extendMessageToIncludePipelineDetails(java.lang.String)>/this#_0	<com.matt_richardson.gocd.websocket_notifier.PipelineDetailsPopulator: java.lang.String extendMessageToIncludePipelineDetails(java.lang.String)>
<com.matt_richardson.gocd.websocket_notifier.PipelineDetailsPopulator: java.lang.String extendMessageToIncludePipelineDetails(java.lang.String)>/$stack9	<com.matt_richardson.gocd.websocket_notifier.PipelineDetailsPopulator: java.lang.String extendMessageToIncludePipelineDetails(java.lang.String)>
<com.matt_richardson.gocd.websocket_notifier.PipelineDetailsPopulator: java.lang.String extendMessageToIncludePipelineDetails(java.lang.String)>/$stack10	<com.matt_richardson.gocd.websocket_notifier.PipelineDetailsPopulator: java.lang.String extendMessageToIncludePipelineDetails(java.lang.String)>
<com.matt_richardson.gocd.websocket_notifier.PipelineDetailsPopulator: java.lang.String extendMessageToIncludePipelineDetails(java.lang.String)>/$stack13	<com.matt_richardson.gocd.websocket_notifier.PipelineDetailsPopulator: java.lang.String extendMessageToIncludePipelineDetails(java.lang.String)>
<com.matt_richardson.gocd.websocket_notifier.PipelineDetailsPopulator: java.lang.String extendMessageToIncludePipelineDetails(java.lang.String)>/$stack18	<com.matt_richardson.gocd.websocket_notifier.PipelineDetailsPopulator: java.lang.String extendMessageToIncludePipelineDetails(java.lang.String)>
<com.matt_richardson.gocd.websocket_notifier.PipelineDetailsPopulator: java.lang.String extendMessageToIncludePipelineDetails(java.lang.String)>/$stack20	<com.matt_richardson.gocd.websocket_notifier.PipelineDetailsPopulator: java.lang.String extendMessageToIncludePipelineDetails(java.lang.String)>
<com.matt_richardson.gocd.websocket_notifier.PipelineDetailsPopulator: java.lang.String extendMessageToIncludePipelineDetails(java.lang.String)>/$stack21	<com.matt_richardson.gocd.websocket_notifier.PipelineDetailsPopulator: java.lang.String extendMessageToIncludePipelineDetails(java.lang.String)>
<com.matt_richardson.gocd.websocket_notifier.PipelineDetailsPopulator: java.lang.String extendMessageToIncludePipelineDetails(java.lang.String)>/$stack22	<com.matt_richardson.gocd.websocket_notifier.PipelineDetailsPopulator: java.lang.String extendMessageToIncludePipelineDetails(java.lang.String)>
<com.matt_richardson.gocd.websocket_notifier.PipelineDetailsPopulator: java.lang.String extendMessageToIncludePipelineDetails(java.lang.String)>/$stack23	<com.matt_richardson.gocd.websocket_notifier.PipelineDetailsPopulator: java.lang.String extendMessageToIncludePipelineDetails(java.lang.String)>
<com.matt_richardson.gocd.websocket_notifier.PipelineDetailsPopulator: java.lang.String extendMessageToIncludePipelineDetails(java.lang.String)>/$stack24	<com.matt_richardson.gocd.websocket_notifier.PipelineDetailsPopulator: java.lang.String extendMessageToIncludePipelineDetails(java.lang.String)>
<com.matt_richardson.gocd.websocket_notifier.PipelineDetailsPopulator: java.lang.String extendMessageToIncludePipelineDetails(java.lang.String)>/result#_58	<com.matt_richardson.gocd.websocket_notifier.PipelineDetailsPopulator: java.lang.String extendMessageToIncludePipelineDetails(java.lang.String)>
<com.matt_richardson.gocd.websocket_notifier.PipelineDetailsPopulator: java.lang.String extendMessageToIncludePipelineDetails(java.lang.String)>/pipelineName#_60	<com.matt_richardson.gocd.websocket_notifier.PipelineDetailsPopulator: java.lang.String extendMessageToIncludePipelineDetails(java.lang.String)>
<com.matt_richardson.gocd.websocket_notifier.PipelineDetailsPopulator: java.lang.String extendMessageToIncludePipelineDetails(java.lang.String)>/pipeline#_63	<com.matt_richardson.gocd.websocket_notifier.PipelineDetailsPopulator: java.lang.String extendMessageToIncludePipelineDetails(java.lang.String)>
<com.matt_richardson.gocd.websocket_notifier.PipelineDetailsPopulator: java.lang.String extendMessageToIncludePipelineDetails(java.lang.String)>/$u0	<com.matt_richardson.gocd.websocket_notifier.PipelineDetailsPopulator: java.lang.String extendMessageToIncludePipelineDetails(java.lang.String)>
<com.matt_richardson.gocd.websocket_notifier.PipelineDetailsPopulator: java.lang.String extendMessageToIncludePipelineDetails(java.lang.String)>/$u1	<com.matt_richardson.gocd.websocket_notifier.PipelineDetailsPopulator: java.lang.String extendMessageToIncludePipelineDetails(java.lang.String)>
<com.matt_richardson.gocd.websocket_notifier.PipelineDetailsPopulator: java.lang.String extendMessageToIncludePipelineDetails(java.lang.String)>/$r0	<com.matt_richardson.gocd.websocket_notifier.PipelineDetailsPopulator: java.lang.String extendMessageToIncludePipelineDetails(java.lang.String)>
<com.matt_richardson.gocd.websocket_notifier.PipelineDetailsPopulator: java.lang.String extendMessageToIncludePipelineDetails(java.lang.String)>/pipelineName_$$A_1#_64	<com.matt_richardson.gocd.websocket_notifier.PipelineDetailsPopulator: java.lang.String extendMessageToIncludePipelineDetails(java.lang.String)>
<com.matt_richardson.gocd.websocket_notifier.PipelineDetailsPopulator: java.lang.String extendMessageToIncludePipelineDetails(java.lang.String)>/pipelineName_$$A_2#_65	<com.matt_richardson.gocd.websocket_notifier.PipelineDetailsPopulator: java.lang.String extendMessageToIncludePipelineDetails(java.lang.String)>
<com.matt_richardson.gocd.websocket_notifier.PipelineDetailsPopulator: java.lang.String extendMessageToIncludePipelineDetails(java.lang.String)>/result_$$A_1#_67	<com.matt_richardson.gocd.websocket_notifier.PipelineDetailsPopulator: java.lang.String extendMessageToIncludePipelineDetails(java.lang.String)>
<com.matt_richardson.gocd.websocket_notifier.PipelineDetailsPopulator: java.lang.String extendMessageToIncludePipelineDetails(java.lang.String)>/pipelineName_$$A_3#_71	<com.matt_richardson.gocd.websocket_notifier.PipelineDetailsPopulator: java.lang.String extendMessageToIncludePipelineDetails(java.lang.String)>
<com.matt_richardson.gocd.websocket_notifier.PipelineDetailsPopulator: java.lang.String extendMessageToIncludePipelineDetails(java.lang.String)>/result_$$A_2#_71	<com.matt_richardson.gocd.websocket_notifier.PipelineDetailsPopulator: java.lang.String extendMessageToIncludePipelineDetails(java.lang.String)>
<com.matt_richardson.gocd.websocket_notifier.PipelineDetailsPopulator: java.lang.String extendMessageToIncludePipelineDetails(java.lang.String)>/pipelineName_$$A_4#_70	<com.matt_richardson.gocd.websocket_notifier.PipelineDetailsPopulator: java.lang.String extendMessageToIncludePipelineDetails(java.lang.String)>
<com.matt_richardson.gocd.websocket_notifier.PipelineDetailsPopulator: java.lang.String extendMessageToIncludePipelineDetails(java.lang.String)>/result_$$A_3#_70	<com.matt_richardson.gocd.websocket_notifier.PipelineDetailsPopulator: java.lang.String extendMessageToIncludePipelineDetails(java.lang.String)>
<com.matt_richardson.gocd.websocket_notifier.PipelineDetailsPopulator: java.lang.String extendMessageToIncludePipelineDetails(java.lang.String)>/$stringconstant0	<com.matt_richardson.gocd.websocket_notifier.PipelineDetailsPopulator: java.lang.String extendMessageToIncludePipelineDetails(java.lang.String)>
<com.matt_richardson.gocd.websocket_notifier.PipelineDetailsPopulator: java.lang.String extendMessageToIncludePipelineDetails(java.lang.String)>/$stringconstant1	<com.matt_richardson.gocd.websocket_notifier.PipelineDetailsPopulator: java.lang.String extendMessageToIncludePipelineDetails(java.lang.String)>
<com.matt_richardson.gocd.websocket_notifier.PipelineDetailsPopulator: java.lang.String extendMessageToIncludePipelineDetails(java.lang.String)>/$stringconstant2	<com.matt_richardson.gocd.websocket_notifier.PipelineDetailsPopulator: java.lang.String extendMessageToIncludePipelineDetails(java.lang.String)>
<com.matt_richardson.gocd.websocket_notifier.PipelineDetailsPopulator: java.lang.String extendMessageToIncludePipelineDetails(java.lang.String)>/$stringconstant3	<com.matt_richardson.gocd.websocket_notifier.PipelineDetailsPopulator: java.lang.String extendMessageToIncludePipelineDetails(java.lang.String)>
<com.matt_richardson.gocd.websocket_notifier.PipelineDetailsPopulator: java.lang.String extendMessageToIncludePipelineDetails(java.lang.String)>/$stringconstant4	<com.matt_richardson.gocd.websocket_notifier.PipelineDetailsPopulator: java.lang.String extendMessageToIncludePipelineDetails(java.lang.String)>
<com.matt_richardson.gocd.websocket_notifier.PipelineDetailsPopulator: void <clinit>()>/$stack0	<com.matt_richardson.gocd.websocket_notifier.PipelineDetailsPopulator: void <clinit>()>
<com.matt_richardson.gocd.websocket_notifier.PipelineDetailsPopulator: void <clinit>()>/$classconstant0	<com.matt_richardson.gocd.websocket_notifier.PipelineDetailsPopulator: void <clinit>()>
