<simplejavacalculator.Calculator: java.lang.Double calculateMono(simplejavacalculator.Calculator$MonoOperatorModes,java.lang.Double)>/throw $stack12/0	<simplejavacalculator.Calculator: java.lang.Double calculateMono(simplejavacalculator.Calculator$MonoOperatorModes,java.lang.Double)>
<simplejavacalculator.Calculator: java.lang.Double calculateBiImpl()>/throw $stack13/0	<simplejavacalculator.Calculator: java.lang.Double calculateBiImpl()>
<simplejavacalculator.Calculator: java.lang.Double calculateBiImpl()>/read-field-num2/3	<simplejavacalculator.Calculator: java.lang.Double calculateBiImpl()>
<simplejavacalculator.Calculator: java.lang.Double calculateBiImpl()>/read-field-num2/6	<simplejavacalculator.Calculator: java.lang.Double calculateBiImpl()>
<simplejavacalculator.UI: void init()>/read-field-but/12	<simplejavacalculator.UI: void init()>
<simplejavacalculator.Calculator: java.lang.Double calculateBiImpl()>/read-field-mode/0	<simplejavacalculator.Calculator: java.lang.Double calculateBiImpl()>
<simplejavacalculator.Calculator: java.lang.Double calculateBiImpl()>/read-field-mode/3	<simplejavacalculator.Calculator: java.lang.Double calculateBiImpl()>
<simplejavacalculator.Calculator: java.lang.Double calculateBiImpl()>/read-field-num2/5	<simplejavacalculator.Calculator: java.lang.Double calculateBiImpl()>
<simplejavacalculator.UI: void actionPerformed(java.awt.event.ActionEvent)>/read-field-buttonValue/0	<simplejavacalculator.UI: void actionPerformed(java.awt.event.ActionEvent)>
<simplejavacalculator.Calculator: java.lang.Double calculateBi(simplejavacalculator.Calculator$BiOperatorModes,java.lang.Double)>/read-field-mode/0	<simplejavacalculator.Calculator: java.lang.Double calculateBi(simplejavacalculator.Calculator$BiOperatorModes,java.lang.Double)>
<simplejavacalculator.UI: void init()>/read-field-but/10	<simplejavacalculator.UI: void init()>
<simplejavacalculator.Calculator: java.lang.Double calculateBiImpl()>/read-field-mode/4	<simplejavacalculator.Calculator: java.lang.Double calculateBiImpl()>
<simplejavacalculator.Calculator: java.lang.Double calculateBiImpl()>/read-field-num1/1	<simplejavacalculator.Calculator: java.lang.Double calculateBiImpl()>
<simplejavacalculator.UI: void init()>/read-field-but/7	<simplejavacalculator.UI: void init()>
<simplejavacalculator.Calculator: java.lang.Double calculateBiImpl()>/read-field-num1/5	<simplejavacalculator.Calculator: java.lang.Double calculateBiImpl()>
<simplejavacalculator.Calculator: java.lang.Double calculateBiImpl()>/read-field-num2/4	<simplejavacalculator.Calculator: java.lang.Double calculateBiImpl()>
<simplejavacalculator.Calculator: java.lang.Double calculateBiImpl()>/read-field-num2/2	<simplejavacalculator.Calculator: java.lang.Double calculateBiImpl()>
<simplejavacalculator.UI: void init()>/read-field-but/3	<simplejavacalculator.UI: void init()>
<simplejavacalculator.UI: void init()>/read-field-text/2	<simplejavacalculator.UI: void init()>
<simplejavacalculator.UI: void init()>/read-field-but/5	<simplejavacalculator.UI: void init()>
<simplejavacalculator.UI: void init()>/read-field-but/8	<simplejavacalculator.UI: void init()>
<simplejavacalculator.Calculator: java.lang.Double calculateBiImpl()>/read-field-num1/0	<simplejavacalculator.Calculator: java.lang.Double calculateBiImpl()>
<simplejavacalculator.Calculator: java.lang.Double calculateBiImpl()>/read-field-num1/4	<simplejavacalculator.Calculator: java.lang.Double calculateBiImpl()>
<simplejavacalculator.Calculator: java.lang.Double calculateBiImpl()>/read-field-mode/1	<simplejavacalculator.Calculator: java.lang.Double calculateBiImpl()>
<simplejavacalculator.UI: void actionPerformed(java.awt.event.ActionEvent)>/read-field-but/0	<simplejavacalculator.UI: void actionPerformed(java.awt.event.ActionEvent)>
<simplejavacalculator.Calculator: java.lang.Double calculateBiImpl()>/read-field-num1/3	<simplejavacalculator.Calculator: java.lang.Double calculateBiImpl()>
<simplejavacalculator.UI: void init()>/read-field-but/11	<simplejavacalculator.UI: void init()>
<simplejavacalculator.UI: void init()>/read-field-but/6	<simplejavacalculator.UI: void init()>
<simplejavacalculator.UI: void init()>/read-field-but/2	<simplejavacalculator.UI: void init()>
<simplejavacalculator.Calculator: java.lang.Double calculateBi(simplejavacalculator.Calculator$BiOperatorModes,java.lang.Double)>/read-field-num1/0	<simplejavacalculator.Calculator: java.lang.Double calculateBi(simplejavacalculator.Calculator$BiOperatorModes,java.lang.Double)>
<simplejavacalculator.UI: void init()>/read-field-but/1	<simplejavacalculator.UI: void init()>
<simplejavacalculator.UI: java.lang.Double reader()>/read-field-text/0	<simplejavacalculator.UI: java.lang.Double reader()>
<simplejavacalculator.Calculator: java.lang.Double calculateBiImpl()>/read-field-mode/2	<simplejavacalculator.Calculator: java.lang.Double calculateBiImpl()>
<simplejavacalculator.UI: void init()>/read-field-but/4	<simplejavacalculator.UI: void init()>
<simplejavacalculator.UI: void init()>/read-field-but/9	<simplejavacalculator.UI: void init()>
<simplejavacalculator.Calculator: java.lang.Double calculateBiImpl()>/read-field-num2/1	<simplejavacalculator.Calculator: java.lang.Double calculateBiImpl()>
<simplejavacalculator.UI: void init()>/read-field-but/0	<simplejavacalculator.UI: void init()>
<simplejavacalculator.Calculator: java.lang.Double calculateBiImpl()>/read-field-mode/5	<simplejavacalculator.Calculator: java.lang.Double calculateBiImpl()>
<simplejavacalculator.Calculator: java.lang.Double calculateBiImpl()>/read-field-num1/2	<simplejavacalculator.Calculator: java.lang.Double calculateBiImpl()>
<simplejavacalculator.Calculator: java.lang.Double calculateBiImpl()>/read-field-num2/0	<simplejavacalculator.Calculator: java.lang.Double calculateBiImpl()>
<simplejavacalculator.UI: void init()>/read-field-font/4	<simplejavacalculator.UI: void init()>
<simplejavacalculator.UI: void init()>/read-field-butAdd/1	<simplejavacalculator.UI: void init()>
<simplejavacalculator.UI: void init()>/read-field-panelSub3/1	<simplejavacalculator.UI: void init()>
<simplejavacalculator.UI: void actionPerformed(java.awt.event.ActionEvent)>/read-field-calc/11	<simplejavacalculator.UI: void actionPerformed(java.awt.event.ActionEvent)>
<simplejavacalculator.UI: void actionPerformed(java.awt.event.ActionEvent)>/read-field-butSin/0	<simplejavacalculator.UI: void actionPerformed(java.awt.event.ActionEvent)>
<simplejavacalculator.UI: void actionPerformed(java.awt.event.ActionEvent)>/read-field-calc/9	<simplejavacalculator.UI: void actionPerformed(java.awt.event.ActionEvent)>
<simplejavacalculator.UI: void actionPerformed(java.awt.event.ActionEvent)>/read-field-calc/10	<simplejavacalculator.UI: void actionPerformed(java.awt.event.ActionEvent)>
<simplejavacalculator.UI: void writer(java.lang.Double)>/read-field-text/0	<simplejavacalculator.UI: void writer(java.lang.Double)>
<simplejavacalculator.UI: void init()>/read-field-butEqual/0	<simplejavacalculator.UI: void init()>
<simplejavacalculator.UI: void init()>/read-field-butSquareRoot/1	<simplejavacalculator.UI: void init()>
<simplejavacalculator.UI: void actionPerformed(java.awt.event.ActionEvent)>/read-field-butlog/0	<simplejavacalculator.UI: void actionPerformed(java.awt.event.ActionEvent)>
<simplejavacalculator.UI: void init()>/read-field-butSin/1	<simplejavacalculator.UI: void init()>
<simplejavacalculator.UI: void init()>/read-field-text/0	<simplejavacalculator.UI: void init()>
<simplejavacalculator.UI: void actionPerformed(java.awt.event.ActionEvent)>/read-field-text/0	<simplejavacalculator.UI: void actionPerformed(java.awt.event.ActionEvent)>
<simplejavacalculator.UI: void init()>/read-field-butCancel/0	<simplejavacalculator.UI: void init()>
<simplejavacalculator.UI: void init()>/read-field-panelSub2/1	<simplejavacalculator.UI: void init()>
<simplejavacalculator.UI: void init()>/read-field-panelSub1/0	<simplejavacalculator.UI: void init()>
<simplejavacalculator.UI: void actionPerformed(java.awt.event.ActionEvent)>/read-field-butAdd/0	<simplejavacalculator.UI: void actionPerformed(java.awt.event.ActionEvent)>
<simplejavacalculator.UI: void init()>/read-field-font/6	<simplejavacalculator.UI: void init()>
<simplejavacalculator.UI: void init()>/read-field-panel/4	<simplejavacalculator.UI: void init()>
<simplejavacalculator.UI: void init()>/read-field-butSquareRoot/2	<simplejavacalculator.UI: void init()>
<simplejavacalculator.UI: void init()>/read-field-butSquare/0	<simplejavacalculator.UI: void init()>
<simplejavacalculator.UI: void init()>/read-field-panelSub3/5	<simplejavacalculator.UI: void init()>
<simplejavacalculator.UI: void init()>/read-field-panelSub4/1	<simplejavacalculator.UI: void init()>
<simplejavacalculator.UI: void init()>/read-field-butAdd/2	<simplejavacalculator.UI: void init()>
<simplejavacalculator.UI: void init()>/read-field-butCos/1	<simplejavacalculator.UI: void init()>
<simplejavacalculator.UI: void init()>/read-field-butlog/2	<simplejavacalculator.UI: void init()>
<simplejavacalculator.UI: void init()>/read-field-frame/2	<simplejavacalculator.UI: void init()>
<simplejavacalculator.UI: void actionPerformed(java.awt.event.ActionEvent)>/read-field-calc/13	<simplejavacalculator.UI: void actionPerformed(java.awt.event.ActionEvent)>
<simplejavacalculator.UI: void init()>/read-field-butMultiply/2	<simplejavacalculator.UI: void init()>
<simplejavacalculator.UI: void init()>/read-field-panelSub7/2	<simplejavacalculator.UI: void init()>
<simplejavacalculator.UI: void init()>/read-field-butEqual/1	<simplejavacalculator.UI: void init()>
<simplejavacalculator.UI: void init()>/read-field-panel/7	<simplejavacalculator.UI: void init()>
<simplejavacalculator.UI: void init()>/read-field-panelSub3/3	<simplejavacalculator.UI: void init()>
<simplejavacalculator.UI: void init()>/read-field-panelSub7/0	<simplejavacalculator.UI: void init()>
<simplejavacalculator.UI: void actionPerformed(java.awt.event.ActionEvent)>/read-field-text/1	<simplejavacalculator.UI: void actionPerformed(java.awt.event.ActionEvent)>
<simplejavacalculator.UI: void init()>/read-field-panelSub6/3	<simplejavacalculator.UI: void init()>
<simplejavacalculator.UI: void init()>/read-field-panelSub2/0	<simplejavacalculator.UI: void init()>
<simplejavacalculator.UI: void init()>/read-field-panelSub2/2	<simplejavacalculator.UI: void init()>
<simplejavacalculator.UI: void init()>/read-field-frame/5	<simplejavacalculator.UI: void init()>
<simplejavacalculator.UI: void init()>/read-field-butrate/2	<simplejavacalculator.UI: void init()>
<simplejavacalculator.UI: void actionPerformed(java.awt.event.ActionEvent)>/read-field-butMultiply/0	<simplejavacalculator.UI: void actionPerformed(java.awt.event.ActionEvent)>
<simplejavacalculator.UI: void init()>/read-field-panelSub4/5	<simplejavacalculator.UI: void init()>
<simplejavacalculator.UI: void writer(java.lang.Double)>/read-field-text/1	<simplejavacalculator.UI: void writer(java.lang.Double)>
<simplejavacalculator.UI: void init()>/read-field-panelSub2/6	<simplejavacalculator.UI: void init()>
<simplejavacalculator.UI: void actionPerformed(java.awt.event.ActionEvent)>/read-field-butOneDevidedBy/0	<simplejavacalculator.UI: void actionPerformed(java.awt.event.ActionEvent)>
<simplejavacalculator.UI: void init()>/read-field-font/1	<simplejavacalculator.UI: void init()>
<simplejavacalculator.UI: void init()>/read-field-panelSub6/1	<simplejavacalculator.UI: void init()>
<simplejavacalculator.UI: void init()>/read-field-panelSub4/4	<simplejavacalculator.UI: void init()>
<simplejavacalculator.UI: void actionPerformed(java.awt.event.ActionEvent)>/read-field-calc/1	<simplejavacalculator.UI: void actionPerformed(java.awt.event.ActionEvent)>
<simplejavacalculator.UI: void init()>/read-field-butEqual/2	<simplejavacalculator.UI: void init()>
<simplejavacalculator.UI: void init()>/read-field-panelSub3/0	<simplejavacalculator.UI: void init()>
<simplejavacalculator.UI: void init()>/read-field-butMinus/2	<simplejavacalculator.UI: void init()>
<simplejavacalculator.UI: void init()>/read-field-butTan/2	<simplejavacalculator.UI: void init()>
<simplejavacalculator.UI: void init()>/read-field-butabs/0	<simplejavacalculator.UI: void init()>
<simplejavacalculator.UI: void init()>/read-field-frame/6	<simplejavacalculator.UI: void init()>
<simplejavacalculator.UI: void init()>/read-field-panelSub3/2	<simplejavacalculator.UI: void init()>
<simplejavacalculator.UI: void actionPerformed(java.awt.event.ActionEvent)>/read-field-calc/7	<simplejavacalculator.UI: void actionPerformed(java.awt.event.ActionEvent)>
<simplejavacalculator.UI: void init()>/read-field-font/0	<simplejavacalculator.UI: void init()>
<simplejavacalculator.UI: void <init>()>/read-field-panel/0	<simplejavacalculator.UI: void <init>()>
<simplejavacalculator.UI: void init()>/read-field-butDivide/1	<simplejavacalculator.UI: void init()>
<simplejavacalculator.UI: void init()>/read-field-butCancel/1	<simplejavacalculator.UI: void init()>
<simplejavacalculator.UI: void actionPerformed(java.awt.event.ActionEvent)>/read-field-butDivide/0	<simplejavacalculator.UI: void actionPerformed(java.awt.event.ActionEvent)>
<simplejavacalculator.UI: void init()>/read-field-frame/4	<simplejavacalculator.UI: void init()>
<simplejavacalculator.UI: void init()>/read-field-panelSub2/3	<simplejavacalculator.UI: void init()>
<simplejavacalculator.UI: void init()>/read-field-butBinary/2	<simplejavacalculator.UI: void init()>
<simplejavacalculator.UI: void init()>/read-field-butxpowerofy/1	<simplejavacalculator.UI: void init()>
<simplejavacalculator.UI: void init()>/read-field-panelSub6/2	<simplejavacalculator.UI: void init()>
<simplejavacalculator.UI: void init()>/read-field-panelSub1/1	<simplejavacalculator.UI: void init()>
<simplejavacalculator.UI: void actionPerformed(java.awt.event.ActionEvent)>/read-field-butSquare/0	<simplejavacalculator.UI: void actionPerformed(java.awt.event.ActionEvent)>
<simplejavacalculator.UI: void init()>/read-field-butOneDevidedBy/0	<simplejavacalculator.UI: void init()>
<simplejavacalculator.UI: void actionPerformed(java.awt.event.ActionEvent)>/read-field-butCancel/0	<simplejavacalculator.UI: void actionPerformed(java.awt.event.ActionEvent)>
<simplejavacalculator.UI: void init()>/read-field-butMinus/0	<simplejavacalculator.UI: void init()>
<simplejavacalculator.UI: void init()>/read-field-panelSub3/4	<simplejavacalculator.UI: void init()>
<simplejavacalculator.UI: void init()>/read-field-font/9	<simplejavacalculator.UI: void init()>
<simplejavacalculator.UI: void init()>/read-field-butTan/1	<simplejavacalculator.UI: void init()>
<simplejavacalculator.UI: void init()>/read-field-butrate/1	<simplejavacalculator.UI: void init()>
<simplejavacalculator.UI: void init()>/read-field-panelSub5/1	<simplejavacalculator.UI: void init()>
<simplejavacalculator.UI: void init()>/read-field-image/0	<simplejavacalculator.UI: void init()>
<simplejavacalculator.UI: void init()>/read-field-butxpowerofy/0	<simplejavacalculator.UI: void init()>
<simplejavacalculator.UI: void init()>/read-field-panel/0	<simplejavacalculator.UI: void init()>
<simplejavacalculator.UI: void init()>/read-field-panelSub5/0	<simplejavacalculator.UI: void init()>
<simplejavacalculator.UI: void init()>/read-field-frame/1	<simplejavacalculator.UI: void init()>
<simplejavacalculator.UI: void init()>/read-field-butCos/0	<simplejavacalculator.UI: void init()>
<simplejavacalculator.UI: void actionPerformed(java.awt.event.ActionEvent)>/read-field-calc/4	<simplejavacalculator.UI: void actionPerformed(java.awt.event.ActionEvent)>
<simplejavacalculator.UI: void init()>/read-field-font/12	<simplejavacalculator.UI: void init()>
<simplejavacalculator.UI: void init()>/read-field-font/17	<simplejavacalculator.UI: void init()>
<simplejavacalculator.UI: void init()>/read-field-butMultiply/0	<simplejavacalculator.UI: void init()>
<simplejavacalculator.UI: void init()>/read-field-butrate/0	<simplejavacalculator.UI: void init()>
<simplejavacalculator.UI: void init()>/read-field-font/16	<simplejavacalculator.UI: void init()>
<simplejavacalculator.UI: void actionPerformed(java.awt.event.ActionEvent)>/read-field-butTan/0	<simplejavacalculator.UI: void actionPerformed(java.awt.event.ActionEvent)>
<simplejavacalculator.UI: void init()>/read-field-butSquare/2	<simplejavacalculator.UI: void init()>
<simplejavacalculator.UI: void actionPerformed(java.awt.event.ActionEvent)>/read-field-butEqual/0	<simplejavacalculator.UI: void actionPerformed(java.awt.event.ActionEvent)>
<simplejavacalculator.UI: void init()>/read-field-frame/0	<simplejavacalculator.UI: void init()>
<simplejavacalculator.UI: void init()>/read-field-text/1	<simplejavacalculator.UI: void init()>
<simplejavacalculator.UI: void init()>/read-field-panel/1	<simplejavacalculator.UI: void init()>
<simplejavacalculator.UI: void init()>/read-field-font/10	<simplejavacalculator.UI: void init()>
<simplejavacalculator.UI: void init()>/read-field-panel/8	<simplejavacalculator.UI: void init()>
<simplejavacalculator.UI: void init()>/read-field-panelSub4/6	<simplejavacalculator.UI: void init()>
<simplejavacalculator.UI: void init()>/read-field-butSquare/1	<simplejavacalculator.UI: void init()>
<simplejavacalculator.UI: void init()>/read-field-panelSub7/1	<simplejavacalculator.UI: void init()>
<simplejavacalculator.UI: void actionPerformed(java.awt.event.ActionEvent)>/read-field-butCos/0	<simplejavacalculator.UI: void actionPerformed(java.awt.event.ActionEvent)>
<simplejavacalculator.UI: void init()>/read-field-panelSub3/6	<simplejavacalculator.UI: void init()>
<simplejavacalculator.UI: void actionPerformed(java.awt.event.ActionEvent)>/read-field-calc/8	<simplejavacalculator.UI: void actionPerformed(java.awt.event.ActionEvent)>
<simplejavacalculator.UI: void init()>/read-field-butabs/2	<simplejavacalculator.UI: void init()>
<simplejavacalculator.UI: void init()>/read-field-butCos/2	<simplejavacalculator.UI: void init()>
<simplejavacalculator.UI: void init()>/read-field-butSin/2	<simplejavacalculator.UI: void init()>
<simplejavacalculator.UI: void init()>/read-field-font/15	<simplejavacalculator.UI: void init()>
<simplejavacalculator.UI: void actionPerformed(java.awt.event.ActionEvent)>/read-field-butSquareRoot/0	<simplejavacalculator.UI: void actionPerformed(java.awt.event.ActionEvent)>
<simplejavacalculator.UI: void actionPerformed(java.awt.event.ActionEvent)>/read-field-calc/0	<simplejavacalculator.UI: void actionPerformed(java.awt.event.ActionEvent)>
<simplejavacalculator.UI: void init()>/read-field-panelSub8/2	<simplejavacalculator.UI: void init()>
<simplejavacalculator.UI: void actionPerformed(java.awt.event.ActionEvent)>/read-field-calc/2	<simplejavacalculator.UI: void actionPerformed(java.awt.event.ActionEvent)>
<simplejavacalculator.UI: void init()>/read-field-panelSub4/3	<simplejavacalculator.UI: void init()>
<simplejavacalculator.UI: void actionPerformed(java.awt.event.ActionEvent)>/read-field-butxpowerofy/0	<simplejavacalculator.UI: void actionPerformed(java.awt.event.ActionEvent)>
<simplejavacalculator.UI: void actionPerformed(java.awt.event.ActionEvent)>/read-field-calc/6	<simplejavacalculator.UI: void actionPerformed(java.awt.event.ActionEvent)>
<simplejavacalculator.UI: void init()>/read-field-frame/3	<simplejavacalculator.UI: void init()>
<simplejavacalculator.UI: void actionPerformed(java.awt.event.ActionEvent)>/read-field-calc/14	<simplejavacalculator.UI: void actionPerformed(java.awt.event.ActionEvent)>
<simplejavacalculator.UI: void actionPerformed(java.awt.event.ActionEvent)>/read-field-butBinary/0	<simplejavacalculator.UI: void actionPerformed(java.awt.event.ActionEvent)>
<simplejavacalculator.UI: void actionPerformed(java.awt.event.ActionEvent)>/read-field-calc/5	<simplejavacalculator.UI: void actionPerformed(java.awt.event.ActionEvent)>
<simplejavacalculator.UI: void init()>/read-field-panelSub8/0	<simplejavacalculator.UI: void init()>
<simplejavacalculator.UI: void init()>/read-field-panelSub8/1	<simplejavacalculator.UI: void init()>
<simplejavacalculator.UI: void <init>()>/read-field-but/0	<simplejavacalculator.UI: void <init>()>
<simplejavacalculator.UI: void init()>/read-field-font/13	<simplejavacalculator.UI: void init()>
<simplejavacalculator.UI: void init()>/read-field-butDivide/2	<simplejavacalculator.UI: void init()>
<simplejavacalculator.UI: void init()>/read-field-panelSub7/3	<simplejavacalculator.UI: void init()>
<simplejavacalculator.UI: void init()>/read-field-panel/6	<simplejavacalculator.UI: void init()>
<simplejavacalculator.UI: void parsetoBinary()>/read-field-text/0	<simplejavacalculator.UI: void parsetoBinary()>
<simplejavacalculator.UI: void init()>/read-field-font/7	<simplejavacalculator.UI: void init()>
<simplejavacalculator.UI: void actionPerformed(java.awt.event.ActionEvent)>/read-field-calc/3	<simplejavacalculator.UI: void actionPerformed(java.awt.event.ActionEvent)>
<simplejavacalculator.UI: void init()>/read-field-butTan/0	<simplejavacalculator.UI: void init()>
<simplejavacalculator.UI: void init()>/read-field-butBinary/0	<simplejavacalculator.UI: void init()>
<simplejavacalculator.UI: void init()>/read-field-panel/2	<simplejavacalculator.UI: void init()>
<simplejavacalculator.UI: void actionPerformed(java.awt.event.ActionEvent)>/read-field-calc/12	<simplejavacalculator.UI: void actionPerformed(java.awt.event.ActionEvent)>
<simplejavacalculator.UI: void actionPerformed(java.awt.event.ActionEvent)>/read-field-butrate/0	<simplejavacalculator.UI: void actionPerformed(java.awt.event.ActionEvent)>
<simplejavacalculator.UI: void init()>/read-field-font/3	<simplejavacalculator.UI: void init()>
<simplejavacalculator.UI: void init()>/read-field-butAdd/0	<simplejavacalculator.UI: void init()>
<simplejavacalculator.UI: void init()>/read-field-butOneDevidedBy/1	<simplejavacalculator.UI: void init()>
<simplejavacalculator.UI: void init()>/read-field-textFont/0	<simplejavacalculator.UI: void init()>
<simplejavacalculator.UI: void init()>/read-field-butlog/1	<simplejavacalculator.UI: void init()>
<simplejavacalculator.UI: void init()>/read-field-butOneDevidedBy/2	<simplejavacalculator.UI: void init()>
<simplejavacalculator.UI: void init()>/read-field-butSin/0	<simplejavacalculator.UI: void init()>
<simplejavacalculator.UI: void init()>/read-field-panel/5	<simplejavacalculator.UI: void init()>
<simplejavacalculator.UI: void init()>/read-field-panel/3	<simplejavacalculator.UI: void init()>
<simplejavacalculator.UI: void actionPerformed(java.awt.event.ActionEvent)>/read-field-butMinus/0	<simplejavacalculator.UI: void actionPerformed(java.awt.event.ActionEvent)>
<simplejavacalculator.UI: void init()>/read-field-butabs/1	<simplejavacalculator.UI: void init()>
<simplejavacalculator.UI: void <init>()>/read-field-panel/1	<simplejavacalculator.UI: void <init>()>
<simplejavacalculator.UI: void init()>/read-field-butDivide/0	<simplejavacalculator.UI: void init()>
<simplejavacalculator.UI: void actionPerformed(java.awt.event.ActionEvent)>/read-field-butabs/0	<simplejavacalculator.UI: void actionPerformed(java.awt.event.ActionEvent)>
<simplejavacalculator.UI: void init()>/read-field-butlog/0	<simplejavacalculator.UI: void init()>
<simplejavacalculator.UI: void init()>/read-field-panelSub4/2	<simplejavacalculator.UI: void init()>
<simplejavacalculator.UI: void init()>/read-field-butSquareRoot/0	<simplejavacalculator.UI: void init()>
<simplejavacalculator.UI: void init()>/read-field-panelSub6/0	<simplejavacalculator.UI: void init()>
<simplejavacalculator.UI: void init()>/read-field-panelSub8/4	<simplejavacalculator.UI: void init()>
<simplejavacalculator.UI: void init()>/read-field-panelSub5/2	<simplejavacalculator.UI: void init()>
<simplejavacalculator.UI: void init()>/read-field-butBinary/1	<simplejavacalculator.UI: void init()>
<simplejavacalculator.UI: void init()>/read-field-panelSub6/4	<simplejavacalculator.UI: void init()>
<simplejavacalculator.UI: void actionPerformed(java.awt.event.ActionEvent)>/read-field-calc/15	<simplejavacalculator.UI: void actionPerformed(java.awt.event.ActionEvent)>
<simplejavacalculator.UI: void init()>/read-field-panelSub4/0	<simplejavacalculator.UI: void init()>
<simplejavacalculator.UI: void init()>/read-field-butxpowerofy/2	<simplejavacalculator.UI: void init()>
<simplejavacalculator.UI: void init()>/read-field-font/8	<simplejavacalculator.UI: void init()>
<simplejavacalculator.UI: void init()>/read-field-butCancel/2	<simplejavacalculator.UI: void init()>
<simplejavacalculator.UI: void init()>/read-field-font/5	<simplejavacalculator.UI: void init()>
<simplejavacalculator.UI: void init()>/read-field-font/14	<simplejavacalculator.UI: void init()>
<simplejavacalculator.UI: void init()>/read-field-butMultiply/1	<simplejavacalculator.UI: void init()>
<simplejavacalculator.UI: void init()>/read-field-panelSub2/5	<simplejavacalculator.UI: void init()>
<simplejavacalculator.UI: void init()>/read-field-font/2	<simplejavacalculator.UI: void init()>
<simplejavacalculator.UI: void init()>/read-field-font/11	<simplejavacalculator.UI: void init()>
<simplejavacalculator.UI: void init()>/read-field-panel/9	<simplejavacalculator.UI: void init()>
<simplejavacalculator.UI: void init()>/read-field-panelSub2/4	<simplejavacalculator.UI: void init()>
<simplejavacalculator.UI: void init()>/read-field-butMinus/1	<simplejavacalculator.UI: void init()>
<simplejavacalculator.UI: void parsetoBinary()>/read-field-text/1	<simplejavacalculator.UI: void parsetoBinary()>
<simplejavacalculator.UI: void init()>/read-field-panelSub8/3	<simplejavacalculator.UI: void init()>
<simplejavacalculator.Calculator$MonoOperatorModes: void <clinit>()>/fresh-null-assign/2	<simplejavacalculator.Calculator$MonoOperatorModes: void <clinit>()>
<simplejavacalculator.Calculator$BiOperatorModes: void <clinit>()>/assign/5	<simplejavacalculator.Calculator$BiOperatorModes: void <clinit>()>
<simplejavacalculator.Calculator: java.lang.Double calculateMono(simplejavacalculator.Calculator$MonoOperatorModes,java.lang.Double)>/assign/47	<simplejavacalculator.Calculator: java.lang.Double calculateMono(simplejavacalculator.Calculator$MonoOperatorModes,java.lang.Double)>
<simplejavacalculator.Calculator$BiOperatorModes: void <clinit>()>/fresh-null-assign/10	<simplejavacalculator.Calculator$BiOperatorModes: void <clinit>()>
<simplejavacalculator.Calculator$MonoOperatorModes: void <clinit>()>/assign/6	<simplejavacalculator.Calculator$MonoOperatorModes: void <clinit>()>
<simplejavacalculator.Calculator$BiOperatorModes: void <clinit>()>/assign/6	<simplejavacalculator.Calculator$BiOperatorModes: void <clinit>()>
<simplejavacalculator.Calculator$MonoOperatorModes: void <clinit>()>/assign/9	<simplejavacalculator.Calculator$MonoOperatorModes: void <clinit>()>
<simplejavacalculator.Calculator$MonoOperatorModes: void <clinit>()>/fresh-null-assign/6	<simplejavacalculator.Calculator$MonoOperatorModes: void <clinit>()>
<simplejavacalculator.Calculator$BiOperatorModes: void <clinit>()>/assign/4	<simplejavacalculator.Calculator$BiOperatorModes: void <clinit>()>
<simplejavacalculator.Calculator$MonoOperatorModes: void <clinit>()>/fresh-null-assign/12	<simplejavacalculator.Calculator$MonoOperatorModes: void <clinit>()>
<simplejavacalculator.Calculator$MonoOperatorModes: void <clinit>()>/assign/5	<simplejavacalculator.Calculator$MonoOperatorModes: void <clinit>()>
<simplejavacalculator.Calculator$MonoOperatorModes: void <clinit>()>/assign/8	<simplejavacalculator.Calculator$MonoOperatorModes: void <clinit>()>
<simplejavacalculator.Calculator$BiOperatorModes: void <clinit>()>/fresh-null-assign/2	<simplejavacalculator.Calculator$BiOperatorModes: void <clinit>()>
<simplejavacalculator.Calculator$BiOperatorModes: void <clinit>()>/assign/0	<simplejavacalculator.Calculator$BiOperatorModes: void <clinit>()>
<simplejavacalculator.Calculator$MonoOperatorModes: void <clinit>()>/fresh-null-assign/0	<simplejavacalculator.Calculator$MonoOperatorModes: void <clinit>()>
<simplejavacalculator.Calculator$MonoOperatorModes: void <clinit>()>/assign/2	<simplejavacalculator.Calculator$MonoOperatorModes: void <clinit>()>
<simplejavacalculator.Calculator$BiOperatorModes: void <clinit>()>/assign/3	<simplejavacalculator.Calculator$BiOperatorModes: void <clinit>()>
<simplejavacalculator.Calculator$MonoOperatorModes: void <clinit>()>/assign/3	<simplejavacalculator.Calculator$MonoOperatorModes: void <clinit>()>
<simplejavacalculator.Calculator$BiOperatorModes: void <clinit>()>/assign/1	<simplejavacalculator.Calculator$BiOperatorModes: void <clinit>()>
<simplejavacalculator.Calculator$BiOperatorModes: void <clinit>()>/fresh-null-assign/4	<simplejavacalculator.Calculator$BiOperatorModes: void <clinit>()>
<simplejavacalculator.Calculator$MonoOperatorModes: void <clinit>()>/fresh-null-assign/16	<simplejavacalculator.Calculator$MonoOperatorModes: void <clinit>()>
<simplejavacalculator.Calculator$MonoOperatorModes: void <clinit>()>/assign/7	<simplejavacalculator.Calculator$MonoOperatorModes: void <clinit>()>
<simplejavacalculator.Calculator$MonoOperatorModes: void <clinit>()>/assign/1	<simplejavacalculator.Calculator$MonoOperatorModes: void <clinit>()>
<simplejavacalculator.Calculator$MonoOperatorModes: void <clinit>()>/fresh-null-assign/14	<simplejavacalculator.Calculator$MonoOperatorModes: void <clinit>()>
<simplejavacalculator.Calculator: java.lang.Double calculateBiImpl()>/assign/23	<simplejavacalculator.Calculator: java.lang.Double calculateBiImpl()>
<simplejavacalculator.Calculator$BiOperatorModes: void <clinit>()>/assign/2	<simplejavacalculator.Calculator$BiOperatorModes: void <clinit>()>
<simplejavacalculator.Calculator$MonoOperatorModes: void <clinit>()>/assign/0	<simplejavacalculator.Calculator$MonoOperatorModes: void <clinit>()>
<simplejavacalculator.Calculator$BiOperatorModes: void <clinit>()>/fresh-null-assign/6	<simplejavacalculator.Calculator$BiOperatorModes: void <clinit>()>
<simplejavacalculator.Calculator$BiOperatorModes: void <clinit>()>/fresh-null-assign/8	<simplejavacalculator.Calculator$BiOperatorModes: void <clinit>()>
<simplejavacalculator.Calculator$MonoOperatorModes: void <clinit>()>/assign/4	<simplejavacalculator.Calculator$MonoOperatorModes: void <clinit>()>
<simplejavacalculator.Calculator$MonoOperatorModes: void <clinit>()>/fresh-null-assign/10	<simplejavacalculator.Calculator$MonoOperatorModes: void <clinit>()>
<simplejavacalculator.Calculator$BiOperatorModes: void <clinit>()>/fresh-null-assign/0	<simplejavacalculator.Calculator$BiOperatorModes: void <clinit>()>
<simplejavacalculator.Calculator$MonoOperatorModes: void <clinit>()>/fresh-null-assign/8	<simplejavacalculator.Calculator$MonoOperatorModes: void <clinit>()>
<simplejavacalculator.Calculator$MonoOperatorModes: void <clinit>()>/fresh-null-assign/4	<simplejavacalculator.Calculator$MonoOperatorModes: void <clinit>()>
<simplejavacalculator.Calculator$MonoOperatorModes: simplejavacalculator.Calculator$MonoOperatorModes valueOf(java.lang.String)>/fresh-null-assign/0	<simplejavacalculator.Calculator$MonoOperatorModes: simplejavacalculator.Calculator$MonoOperatorModes valueOf(java.lang.String)>
<simplejavacalculator.UI: void <init>()>/fresh-null-assign/34	<simplejavacalculator.UI: void <init>()>
<simplejavacalculator.UI: void <init>()>/assign/3	<simplejavacalculator.UI: void <init>()>
<simplejavacalculator.UI: void <init>()>/assign/7	<simplejavacalculator.UI: void <init>()>
<simplejavacalculator.UI: void <init>()>/fresh-null-assign/8	<simplejavacalculator.UI: void <init>()>
<simplejavacalculator.UI: void <init>()>/assign/16	<simplejavacalculator.UI: void <init>()>
<simplejavacalculator.UI: void <init>()>/fresh-null-assign/31	<simplejavacalculator.UI: void <init>()>
<simplejavacalculator.UI: void <init>()>/fresh-null-assign/21	<simplejavacalculator.UI: void <init>()>
<simplejavacalculator.UI: void <init>()>/fresh-null-assign/33	<simplejavacalculator.UI: void <init>()>
<simplejavacalculator.UI: void <init>()>/assign/1	<simplejavacalculator.UI: void <init>()>
<simplejavacalculator.UI: void parsetoBinary()>/assign/1	<simplejavacalculator.UI: void parsetoBinary()>
<simplejavacalculator.UI: void <init>()>/fresh-null-assign/25	<simplejavacalculator.UI: void <init>()>
<simplejavacalculator.UI: void <init>()>/assign/48	<simplejavacalculator.UI: void <init>()>
<simplejavacalculator.UI: void <init>()>/assign/40	<simplejavacalculator.UI: void <init>()>
<simplejavacalculator.UI: void <init>()>/fresh-null-assign/22	<simplejavacalculator.UI: void <init>()>
<simplejavacalculator.Calculator$BiOperatorModes: simplejavacalculator.Calculator$BiOperatorModes valueOf(java.lang.String)>/fresh-null-assign/0	<simplejavacalculator.Calculator$BiOperatorModes: simplejavacalculator.Calculator$BiOperatorModes valueOf(java.lang.String)>
<simplejavacalculator.UI: void <init>()>/assign/6	<simplejavacalculator.UI: void <init>()>
<simplejavacalculator.UI: void <init>()>/fresh-null-assign/37	<simplejavacalculator.UI: void <init>()>
<simplejavacalculator.UI: void parsetoBinary()>/fresh-null-assign/0	<simplejavacalculator.UI: void parsetoBinary()>
<simplejavacalculator.UI: void <init>()>/assign/11	<simplejavacalculator.UI: void <init>()>
<simplejavacalculator.UI: void <init>()>/assign/46	<simplejavacalculator.UI: void <init>()>
<simplejavacalculator.UI: void <init>()>/fresh-null-assign/32	<simplejavacalculator.UI: void <init>()>
<simplejavacalculator.UI: void <init>()>/assign/34	<simplejavacalculator.UI: void <init>()>
<simplejavacalculator.UI: void <init>()>/fresh-null-assign/6	<simplejavacalculator.UI: void <init>()>
<simplejavacalculator.UI: void parsetoBinary()>/assign/10	<simplejavacalculator.UI: void parsetoBinary()>
<simplejavacalculator.UI: void <init>()>/assign/33	<simplejavacalculator.UI: void <init>()>
<simplejavacalculator.UI: void <init>()>/assign/42	<simplejavacalculator.UI: void <init>()>
<simplejavacalculator.UI: void <init>()>/fresh-null-assign/4	<simplejavacalculator.UI: void <init>()>
<simplejavacalculator.UI: void <init>()>/assign/15	<simplejavacalculator.UI: void <init>()>
<simplejavacalculator.UI: void writer(java.lang.Double)>/fresh-null-assign/0	<simplejavacalculator.UI: void writer(java.lang.Double)>
<simplejavacalculator.UI: void <init>()>/fresh-null-assign/30	<simplejavacalculator.UI: void <init>()>
<simplejavacalculator.UI: void <init>()>/fresh-null-assign/3	<simplejavacalculator.UI: void <init>()>
<simplejavacalculator.SimpleJavaCalculator: void main(java.lang.String[])>/assign/1	<simplejavacalculator.SimpleJavaCalculator: void main(java.lang.String[])>
<simplejavacalculator.UI: void <init>()>/assign/49	<simplejavacalculator.UI: void <init>()>
<simplejavacalculator.UI: void <init>()>/assign/19	<simplejavacalculator.UI: void <init>()>
<simplejavacalculator.UI: void <init>()>/fresh-null-assign/35	<simplejavacalculator.UI: void <init>()>
<simplejavacalculator.UI: void <init>()>/fresh-null-assign/7	<simplejavacalculator.UI: void <init>()>
<simplejavacalculator.UI: void <init>()>/fresh-null-assign/13	<simplejavacalculator.UI: void <init>()>
<simplejavacalculator.UI: void <init>()>/fresh-null-assign/2	<simplejavacalculator.UI: void <init>()>
<simplejavacalculator.UI: void <init>()>/assign/9	<simplejavacalculator.UI: void <init>()>
<simplejavacalculator.UI: void <init>()>/assign/44	<simplejavacalculator.UI: void <init>()>
<simplejavacalculator.UI: void <init>()>/assign/12	<simplejavacalculator.UI: void <init>()>
<simplejavacalculator.UI: void <init>()>/assign/22	<simplejavacalculator.UI: void <init>()>
<simplejavacalculator.UI: void <init>()>/assign/35	<simplejavacalculator.UI: void <init>()>
<simplejavacalculator.UI: void parsetoBinary()>/fresh-null-assign/1	<simplejavacalculator.UI: void parsetoBinary()>
<simplejavacalculator.UI: void <init>()>/fresh-null-assign/27	<simplejavacalculator.UI: void <init>()>
<simplejavacalculator.UI: void <init>()>/fresh-null-assign/26	<simplejavacalculator.UI: void <init>()>
<simplejavacalculator.UI: void <init>()>/assign/50	<simplejavacalculator.UI: void <init>()>
<simplejavacalculator.UI: void <init>()>/assign/38	<simplejavacalculator.UI: void <init>()>
<simplejavacalculator.UI: void <init>()>/fresh-null-assign/1	<simplejavacalculator.UI: void <init>()>
<simplejavacalculator.UI: void <init>()>/fresh-null-assign/9	<simplejavacalculator.UI: void <init>()>
<simplejavacalculator.UI: void <init>()>/assign/45	<simplejavacalculator.UI: void <init>()>
<simplejavacalculator.UI: void <init>()>/assign/21	<simplejavacalculator.UI: void <init>()>
<simplejavacalculator.UI: void <init>()>/assign/23	<simplejavacalculator.UI: void <init>()>
<simplejavacalculator.UI: void <init>()>/assign/10	<simplejavacalculator.UI: void <init>()>
<simplejavacalculator.UI: void <init>()>/assign/20	<simplejavacalculator.UI: void <init>()>
<simplejavacalculator.UI: void <init>()>/fresh-null-assign/0	<simplejavacalculator.UI: void <init>()>
<simplejavacalculator.UI: void <init>()>/assign/37	<simplejavacalculator.UI: void <init>()>
<simplejavacalculator.UI: void <init>()>/assign/43	<simplejavacalculator.UI: void <init>()>
<simplejavacalculator.UI: void <init>()>/fresh-null-assign/24	<simplejavacalculator.UI: void <init>()>
<simplejavacalculator.UI: void <init>()>/assign/13	<simplejavacalculator.UI: void <init>()>
<simplejavacalculator.UI: void <init>()>/assign/41	<simplejavacalculator.UI: void <init>()>
<simplejavacalculator.UI: void <init>()>/assign/47	<simplejavacalculator.UI: void <init>()>
<simplejavacalculator.UI: void <init>()>/assign/25	<simplejavacalculator.UI: void <init>()>
<simplejavacalculator.UI: void <init>()>/fresh-null-assign/23	<simplejavacalculator.UI: void <init>()>
<simplejavacalculator.UI: void <init>()>/assign/39	<simplejavacalculator.UI: void <init>()>
<simplejavacalculator.UI: void <init>()>/assign/4	<simplejavacalculator.UI: void <init>()>
<simplejavacalculator.UI: void <init>()>/assign/17	<simplejavacalculator.UI: void <init>()>
<simplejavacalculator.UI: void <init>()>/assign/30	<simplejavacalculator.UI: void <init>()>
<simplejavacalculator.UI: void <init>()>/fresh-null-assign/18	<simplejavacalculator.UI: void <init>()>
<simplejavacalculator.UI: void <init>()>/assign/24	<simplejavacalculator.UI: void <init>()>
<simplejavacalculator.UI: void <init>()>/assign/2	<simplejavacalculator.UI: void <init>()>
<simplejavacalculator.UI: void <init>()>/assign/5	<simplejavacalculator.UI: void <init>()>
<simplejavacalculator.UI: void <init>()>/fresh-null-assign/28	<simplejavacalculator.UI: void <init>()>
<simplejavacalculator.UI: void <init>()>/fresh-null-assign/5	<simplejavacalculator.UI: void <init>()>
<simplejavacalculator.UI: void <init>()>/fresh-null-assign/36	<simplejavacalculator.UI: void <init>()>
<simplejavacalculator.UI: void <init>()>/fresh-null-assign/10	<simplejavacalculator.UI: void <init>()>
<simplejavacalculator.UI: void <init>()>/assign/14	<simplejavacalculator.UI: void <init>()>
<simplejavacalculator.UI: void <init>()>/fresh-null-assign/11	<simplejavacalculator.UI: void <init>()>
<simplejavacalculator.UI: void <init>()>/assign/8	<simplejavacalculator.UI: void <init>()>
<simplejavacalculator.UI: void <init>()>/assign/18	<simplejavacalculator.UI: void <init>()>
<simplejavacalculator.UI: void <init>()>/assign/36	<simplejavacalculator.UI: void <init>()>
<simplejavacalculator.UI: void <init>()>/fresh-null-assign/29	<simplejavacalculator.UI: void <init>()>
<simplejavacalculator.UI: void init()>/phi-assign/1	<simplejavacalculator.UI: void init()>
<simplejavacalculator.UI: void actionPerformed(java.awt.event.ActionEvent)>/assign/36	<simplejavacalculator.UI: void actionPerformed(java.awt.event.ActionEvent)>
<simplejavacalculator.UI: void init()>/phi-assign/2	<simplejavacalculator.UI: void init()>
<simplejavacalculator.UI: void actionPerformed(java.awt.event.ActionEvent)>/assign/32	<simplejavacalculator.UI: void actionPerformed(java.awt.event.ActionEvent)>
<simplejavacalculator.UI: void actionPerformed(java.awt.event.ActionEvent)>/assign/39	<simplejavacalculator.UI: void actionPerformed(java.awt.event.ActionEvent)>
<simplejavacalculator.Calculator: java.lang.Double calculateBi(simplejavacalculator.Calculator$BiOperatorModes,java.lang.Double)>/assign/0	<simplejavacalculator.Calculator: java.lang.Double calculateBi(simplejavacalculator.Calculator$BiOperatorModes,java.lang.Double)>
<simplejavacalculator.UI: void actionPerformed(java.awt.event.ActionEvent)>/assign/24	<simplejavacalculator.UI: void actionPerformed(java.awt.event.ActionEvent)>
<simplejavacalculator.Calculator: java.lang.Double calculateBiImpl()>/assign/0	<simplejavacalculator.Calculator: java.lang.Double calculateBiImpl()>
<simplejavacalculator.UI: void actionPerformed(java.awt.event.ActionEvent)>/assign/55	<simplejavacalculator.UI: void actionPerformed(java.awt.event.ActionEvent)>
<simplejavacalculator.UI: void actionPerformed(java.awt.event.ActionEvent)>/assign/43	<simplejavacalculator.UI: void actionPerformed(java.awt.event.ActionEvent)>
<simplejavacalculator.Calculator: java.lang.Double calculateMono(simplejavacalculator.Calculator$MonoOperatorModes,java.lang.Double)>/assign/1	<simplejavacalculator.Calculator: java.lang.Double calculateMono(simplejavacalculator.Calculator$MonoOperatorModes,java.lang.Double)>
<simplejavacalculator.UI: void init()>/phi-assign/3	<simplejavacalculator.UI: void init()>
<simplejavacalculator.UI: void <init>()>/assign/0	<simplejavacalculator.UI: void <init>()>
<simplejavacalculator.UI: void actionPerformed(java.awt.event.ActionEvent)>/assign/31	<simplejavacalculator.UI: void actionPerformed(java.awt.event.ActionEvent)>
<simplejavacalculator.UI: void init()>/assign/55	<simplejavacalculator.UI: void init()>
<simplejavacalculator.Calculator: java.lang.Double reset()>/assign/0	<simplejavacalculator.Calculator: java.lang.Double reset()>
<simplejavacalculator.Calculator: void <init>()>/assign/0	<simplejavacalculator.Calculator: void <init>()>
<simplejavacalculator.UI: void actionPerformed(java.awt.event.ActionEvent)>/assign/40	<simplejavacalculator.UI: void actionPerformed(java.awt.event.ActionEvent)>
<simplejavacalculator.UI: void init()>/phi-assign/0	<simplejavacalculator.UI: void init()>
<simplejavacalculator.Calculator: java.lang.Double calculateBi(simplejavacalculator.Calculator$BiOperatorModes,java.lang.Double)>/assign/1	<simplejavacalculator.Calculator: java.lang.Double calculateBi(simplejavacalculator.Calculator$BiOperatorModes,java.lang.Double)>
<simplejavacalculator.UI: void actionPerformed(java.awt.event.ActionEvent)>/assign/72	<simplejavacalculator.UI: void actionPerformed(java.awt.event.ActionEvent)>
<simplejavacalculator.UI: void actionPerformed(java.awt.event.ActionEvent)>/assign/12	<simplejavacalculator.UI: void actionPerformed(java.awt.event.ActionEvent)>
<simplejavacalculator.UI: void actionPerformed(java.awt.event.ActionEvent)>/phi-assign/0	<simplejavacalculator.UI: void actionPerformed(java.awt.event.ActionEvent)>
<simplejavacalculator.UI: void actionPerformed(java.awt.event.ActionEvent)>/assign/59	<simplejavacalculator.UI: void actionPerformed(java.awt.event.ActionEvent)>
<simplejavacalculator.UI: void actionPerformed(java.awt.event.ActionEvent)>/assign/6	<simplejavacalculator.UI: void actionPerformed(java.awt.event.ActionEvent)>
<simplejavacalculator.UI: void actionPerformed(java.awt.event.ActionEvent)>/assign/48	<simplejavacalculator.UI: void actionPerformed(java.awt.event.ActionEvent)>
<simplejavacalculator.UI: void actionPerformed(java.awt.event.ActionEvent)>/assign/64	<simplejavacalculator.UI: void actionPerformed(java.awt.event.ActionEvent)>
<simplejavacalculator.UI: void init()>/assign/4	<simplejavacalculator.UI: void init()>
<simplejavacalculator.UI: void actionPerformed(java.awt.event.ActionEvent)>/assign/11	<simplejavacalculator.UI: void actionPerformed(java.awt.event.ActionEvent)>
<simplejavacalculator.UI: void actionPerformed(java.awt.event.ActionEvent)>/assign/51	<simplejavacalculator.UI: void actionPerformed(java.awt.event.ActionEvent)>
<simplejavacalculator.UI: void actionPerformed(java.awt.event.ActionEvent)>/assign/35	<simplejavacalculator.UI: void actionPerformed(java.awt.event.ActionEvent)>
<simplejavacalculator.UI: void actionPerformed(java.awt.event.ActionEvent)>/assign/68	<simplejavacalculator.UI: void actionPerformed(java.awt.event.ActionEvent)>
<simplejavacalculator.Calculator: java.lang.Double calculateMono(simplejavacalculator.Calculator$MonoOperatorModes,java.lang.Double)>/assign/2	<simplejavacalculator.Calculator: java.lang.Double calculateMono(simplejavacalculator.Calculator$MonoOperatorModes,java.lang.Double)>
<simplejavacalculator.UI: void actionPerformed(java.awt.event.ActionEvent)>/assign/20	<simplejavacalculator.UI: void actionPerformed(java.awt.event.ActionEvent)>
<simplejavacalculator.UI: void actionPerformed(java.awt.event.ActionEvent)>/phi-assign/1	<simplejavacalculator.UI: void actionPerformed(java.awt.event.ActionEvent)>
<simplejavacalculator.UI: java.lang.Double reader()>/assign/0	<simplejavacalculator.UI: java.lang.Double reader()>
<simplejavacalculator.UI: void actionPerformed(java.awt.event.ActionEvent)>/assign/71	<simplejavacalculator.UI: void actionPerformed(java.awt.event.ActionEvent)>
<simplejavacalculator.UI: void actionPerformed(java.awt.event.ActionEvent)>/assign/70	<simplejavacalculator.UI: void actionPerformed(java.awt.event.ActionEvent)>
<simplejavacalculator.UI: void actionPerformed(java.awt.event.ActionEvent)>/assign/27	<simplejavacalculator.UI: void actionPerformed(java.awt.event.ActionEvent)>
<simplejavacalculator.UI: void actionPerformed(java.awt.event.ActionEvent)>/assign/60	<simplejavacalculator.UI: void actionPerformed(java.awt.event.ActionEvent)>
<simplejavacalculator.UI: void actionPerformed(java.awt.event.ActionEvent)>/assign/44	<simplejavacalculator.UI: void actionPerformed(java.awt.event.ActionEvent)>
<simplejavacalculator.UI: void writer(java.lang.Double)>/assign/0	<simplejavacalculator.UI: void writer(java.lang.Double)>
<simplejavacalculator.UI: void actionPerformed(java.awt.event.ActionEvent)>/assign/63	<simplejavacalculator.UI: void actionPerformed(java.awt.event.ActionEvent)>
<simplejavacalculator.UI: void actionPerformed(java.awt.event.ActionEvent)>/assign/47	<simplejavacalculator.UI: void actionPerformed(java.awt.event.ActionEvent)>
<simplejavacalculator.UI: void actionPerformed(java.awt.event.ActionEvent)>/assign/28	<simplejavacalculator.UI: void actionPerformed(java.awt.event.ActionEvent)>
<simplejavacalculator.UI: void actionPerformed(java.awt.event.ActionEvent)>/assign/23	<simplejavacalculator.UI: void actionPerformed(java.awt.event.ActionEvent)>
<simplejavacalculator.UI: void parsetoBinary()>/assign/0	<simplejavacalculator.UI: void parsetoBinary()>
<simplejavacalculator.Calculator: java.lang.Double calculateMono(simplejavacalculator.Calculator$MonoOperatorModes,java.lang.Double)>/assign/0	<simplejavacalculator.Calculator: java.lang.Double calculateMono(simplejavacalculator.Calculator$MonoOperatorModes,java.lang.Double)>
<simplejavacalculator.Calculator: java.lang.Double calculateBi(simplejavacalculator.Calculator$BiOperatorModes,java.lang.Double)>/assign/2	<simplejavacalculator.Calculator: java.lang.Double calculateBi(simplejavacalculator.Calculator$BiOperatorModes,java.lang.Double)>
<simplejavacalculator.UI: void actionPerformed(java.awt.event.ActionEvent)>/assign/56	<simplejavacalculator.UI: void actionPerformed(java.awt.event.ActionEvent)>
<simplejavacalculator.UI: void actionPerformed(java.awt.event.ActionEvent)>/assign/67	<simplejavacalculator.UI: void actionPerformed(java.awt.event.ActionEvent)>
<simplejavacalculator.UI: void actionPerformed(java.awt.event.ActionEvent)>/assign/16	<simplejavacalculator.UI: void actionPerformed(java.awt.event.ActionEvent)>
<simplejavacalculator.UI: void init()>/assign/0	<simplejavacalculator.UI: void init()>
<simplejavacalculator.UI: void actionPerformed(java.awt.event.ActionEvent)>/assign/19	<simplejavacalculator.UI: void actionPerformed(java.awt.event.ActionEvent)>
<simplejavacalculator.UI: void actionPerformed(java.awt.event.ActionEvent)>/assign/15	<simplejavacalculator.UI: void actionPerformed(java.awt.event.ActionEvent)>
<simplejavacalculator.UI: void actionPerformed(java.awt.event.ActionEvent)>/assign/0	<simplejavacalculator.UI: void actionPerformed(java.awt.event.ActionEvent)>
<simplejavacalculator.UI: void actionPerformed(java.awt.event.ActionEvent)>/assign/52	<simplejavacalculator.UI: void actionPerformed(java.awt.event.ActionEvent)>
<simplejavacalculator.UI: void actionPerformed(java.awt.event.ActionEvent)>/assign/3	<simplejavacalculator.UI: void actionPerformed(java.awt.event.ActionEvent)>
<simplejavacalculator.UI: void writer(java.lang.Double)>/assign/1	<simplejavacalculator.UI: void writer(java.lang.Double)>
<simplejavacalculator.SimpleJavaCalculator: void main(java.lang.String[])>/assign/0	<simplejavacalculator.SimpleJavaCalculator: void main(java.lang.String[])>
<simplejavacalculator.Calculator$BiOperatorModes: simplejavacalculator.Calculator$BiOperatorModes valueOf(java.lang.String)>/assign/0	<simplejavacalculator.Calculator$BiOperatorModes: simplejavacalculator.Calculator$BiOperatorModes valueOf(java.lang.String)>
<simplejavacalculator.Calculator$MonoOperatorModes: void <init>(java.lang.String,int)>/assign/1	<simplejavacalculator.Calculator$MonoOperatorModes: void <init>(java.lang.String,int)>
<simplejavacalculator.Calculator$BiOperatorModes: void <init>(java.lang.String,int)>/assign/0	<simplejavacalculator.Calculator$BiOperatorModes: void <init>(java.lang.String,int)>
<simplejavacalculator.UI: void <init>()>/phi-assign/1	<simplejavacalculator.UI: void <init>()>
<simplejavacalculator.UI: java.lang.Double reader()>/assign/2	<simplejavacalculator.UI: java.lang.Double reader()>
<simplejavacalculator.Calculator: java.lang.Double calculateEqual(java.lang.Double)>/assign/0	<simplejavacalculator.Calculator: java.lang.Double calculateEqual(java.lang.Double)>
<simplejavacalculator.Calculator$MonoOperatorModes: void <init>(java.lang.String,int)>/assign/0	<simplejavacalculator.Calculator$MonoOperatorModes: void <init>(java.lang.String,int)>
<simplejavacalculator.UI: void <init>()>/assign/28	<simplejavacalculator.UI: void <init>()>
<simplejavacalculator.UI: void <init>()>/phi-assign/0	<simplejavacalculator.UI: void <init>()>
<simplejavacalculator.Calculator$BiOperatorModes: void <init>(java.lang.String,int)>/assign/1	<simplejavacalculator.Calculator$BiOperatorModes: void <init>(java.lang.String,int)>
<simplejavacalculator.Calculator: java.lang.Double calculateEqual(java.lang.Double)>/assign/1	<simplejavacalculator.Calculator: java.lang.Double calculateEqual(java.lang.Double)>
<simplejavacalculator.UI: java.lang.Double reader()>/assign/4	<simplejavacalculator.UI: java.lang.Double reader()>
<simplejavacalculator.Calculator$MonoOperatorModes: simplejavacalculator.Calculator$MonoOperatorModes valueOf(java.lang.String)>/assign/0	<simplejavacalculator.Calculator$MonoOperatorModes: simplejavacalculator.Calculator$MonoOperatorModes valueOf(java.lang.String)>
<simplejavacalculator.Calculator$MonoOperatorModes: void <init>(java.lang.String,int)>/assign/2	<simplejavacalculator.Calculator$MonoOperatorModes: void <init>(java.lang.String,int)>
<simplejavacalculator.SimpleJavaCalculator: void main(java.lang.String[])>/assign/2	<simplejavacalculator.SimpleJavaCalculator: void main(java.lang.String[])>
<simplejavacalculator.Calculator: java.lang.Double calculateMono(simplejavacalculator.Calculator$MonoOperatorModes,java.lang.Double)>/assign/34	<simplejavacalculator.Calculator: java.lang.Double calculateMono(simplejavacalculator.Calculator$MonoOperatorModes,java.lang.Double)>
<simplejavacalculator.Calculator$BiOperatorModes: void <init>(java.lang.String,int)>/assign/2	<simplejavacalculator.Calculator$BiOperatorModes: void <init>(java.lang.String,int)>
<simplejavacalculator.UI: void parsetoBinary()>/assign/9	<simplejavacalculator.UI: void parsetoBinary()>
<simplejavacalculator.UI: void actionPerformed(java.awt.event.ActionEvent)>/assign/1	<simplejavacalculator.UI: void actionPerformed(java.awt.event.ActionEvent)>
<simplejavacalculator.SimpleJavaCalculator: void <init>()>/assign/0	<simplejavacalculator.SimpleJavaCalculator: void <init>()>
<simplejavacalculator.Calculator: java.lang.Double calculateMono(simplejavacalculator.Calculator$MonoOperatorModes,java.lang.Double)>/assign/24	<simplejavacalculator.Calculator: java.lang.Double calculateMono(simplejavacalculator.Calculator$MonoOperatorModes,java.lang.Double)>
<simplejavacalculator.Calculator: java.lang.Double calculateBiImpl()>/assign/13	<simplejavacalculator.Calculator: java.lang.Double calculateBiImpl()>
<simplejavacalculator.Calculator: java.lang.Double calculateBiImpl()>/assign/2	<simplejavacalculator.Calculator: java.lang.Double calculateBiImpl()>
<simplejavacalculator.Calculator: java.lang.Double calculateMono(simplejavacalculator.Calculator$MonoOperatorModes,java.lang.Double)>/assign/12	<simplejavacalculator.Calculator: java.lang.Double calculateMono(simplejavacalculator.Calculator$MonoOperatorModes,java.lang.Double)>
<simplejavacalculator.Calculator: java.lang.Double calculateMono(simplejavacalculator.Calculator$MonoOperatorModes,java.lang.Double)>/assign/28	<simplejavacalculator.Calculator: java.lang.Double calculateMono(simplejavacalculator.Calculator$MonoOperatorModes,java.lang.Double)>
<simplejavacalculator.Calculator: java.lang.Double calculateMono(simplejavacalculator.Calculator$MonoOperatorModes,java.lang.Double)>/assign/31	<simplejavacalculator.Calculator: java.lang.Double calculateMono(simplejavacalculator.Calculator$MonoOperatorModes,java.lang.Double)>
<simplejavacalculator.Calculator: java.lang.Double calculateMono(simplejavacalculator.Calculator$MonoOperatorModes,java.lang.Double)>/assign/29	<simplejavacalculator.Calculator: java.lang.Double calculateMono(simplejavacalculator.Calculator$MonoOperatorModes,java.lang.Double)>
<simplejavacalculator.Calculator: java.lang.Double calculateMono(simplejavacalculator.Calculator$MonoOperatorModes,java.lang.Double)>/assign/42	<simplejavacalculator.Calculator: java.lang.Double calculateMono(simplejavacalculator.Calculator$MonoOperatorModes,java.lang.Double)>
<simplejavacalculator.Calculator: java.lang.Double calculateBiImpl()>/assign/5	<simplejavacalculator.Calculator: java.lang.Double calculateBiImpl()>
<simplejavacalculator.Calculator: java.lang.Double calculateMono(simplejavacalculator.Calculator$MonoOperatorModes,java.lang.Double)>/assign/23	<simplejavacalculator.Calculator: java.lang.Double calculateMono(simplejavacalculator.Calculator$MonoOperatorModes,java.lang.Double)>
<simplejavacalculator.Calculator: java.lang.Double calculateMono(simplejavacalculator.Calculator$MonoOperatorModes,java.lang.Double)>/assign/32	<simplejavacalculator.Calculator: java.lang.Double calculateMono(simplejavacalculator.Calculator$MonoOperatorModes,java.lang.Double)>
<simplejavacalculator.UI: void actionPerformed(java.awt.event.ActionEvent)>/assign/8	<simplejavacalculator.UI: void actionPerformed(java.awt.event.ActionEvent)>
<simplejavacalculator.Calculator: java.lang.Double calculateBiImpl()>/assign/17	<simplejavacalculator.Calculator: java.lang.Double calculateBiImpl()>
<simplejavacalculator.UI: void init()>/assign/57	<simplejavacalculator.UI: void init()>
<simplejavacalculator.Calculator: java.lang.Double calculateMono(simplejavacalculator.Calculator$MonoOperatorModes,java.lang.Double)>/assign/21	<simplejavacalculator.Calculator: java.lang.Double calculateMono(simplejavacalculator.Calculator$MonoOperatorModes,java.lang.Double)>
<simplejavacalculator.Calculator: java.lang.Double calculateMono(simplejavacalculator.Calculator$MonoOperatorModes,java.lang.Double)>/assign/5	<simplejavacalculator.Calculator: java.lang.Double calculateMono(simplejavacalculator.Calculator$MonoOperatorModes,java.lang.Double)>
<simplejavacalculator.UI: void init()>/assign/6	<simplejavacalculator.UI: void init()>
<simplejavacalculator.Calculator: java.lang.Double calculateBiImpl()>/assign/9	<simplejavacalculator.Calculator: java.lang.Double calculateBiImpl()>
<simplejavacalculator.UI: void <init>()>/assign/32	<simplejavacalculator.UI: void <init>()>
<simplejavacalculator.Calculator$MonoOperatorModes: simplejavacalculator.Calculator$MonoOperatorModes[] values()>/assign-cast/0	<simplejavacalculator.Calculator$MonoOperatorModes: simplejavacalculator.Calculator$MonoOperatorModes[] values()>
<simplejavacalculator.Calculator$BiOperatorModes: simplejavacalculator.Calculator$BiOperatorModes[] values()>/assign-cast/0	<simplejavacalculator.Calculator$BiOperatorModes: simplejavacalculator.Calculator$BiOperatorModes[] values()>
<simplejavacalculator.Calculator$BiOperatorModes: simplejavacalculator.Calculator$BiOperatorModes valueOf(java.lang.String)>/assign-cast/0	<simplejavacalculator.Calculator$BiOperatorModes: simplejavacalculator.Calculator$BiOperatorModes valueOf(java.lang.String)>
<simplejavacalculator.Calculator$MonoOperatorModes: simplejavacalculator.Calculator$MonoOperatorModes valueOf(java.lang.String)>/assign-cast/0	<simplejavacalculator.Calculator$MonoOperatorModes: simplejavacalculator.Calculator$MonoOperatorModes valueOf(java.lang.String)>
<simplejavacalculator.Calculator$BiOperatorModes: void <clinit>()>/fresh-null-assign/9	<simplejavacalculator.Calculator$BiOperatorModes: void <clinit>()>
<simplejavacalculator.Calculator$BiOperatorModes: void <clinit>()>/fresh-null-assign/1	<simplejavacalculator.Calculator$BiOperatorModes: void <clinit>()>
<simplejavacalculator.Calculator$BiOperatorModes: void <clinit>()>/fresh-null-assign/3	<simplejavacalculator.Calculator$BiOperatorModes: void <clinit>()>
<simplejavacalculator.UI: void init()>/fresh-null-assign/6	<simplejavacalculator.UI: void init()>
<simplejavacalculator.Calculator: java.lang.Double reset()>/fresh-null-assign/2	<simplejavacalculator.Calculator: java.lang.Double reset()>
<simplejavacalculator.UI: void init()>/fresh-null-assign/0	<simplejavacalculator.UI: void init()>
<simplejavacalculator.Calculator: java.lang.Double reset()>/fresh-null-assign/0	<simplejavacalculator.Calculator: java.lang.Double reset()>
<simplejavacalculator.UI: void init()>/fresh-null-assign/5	<simplejavacalculator.UI: void init()>
<simplejavacalculator.Calculator$MonoOperatorModes: void <clinit>()>/fresh-null-assign/9	<simplejavacalculator.Calculator$MonoOperatorModes: void <clinit>()>
<simplejavacalculator.Calculator: java.lang.Double calculateMono(simplejavacalculator.Calculator$MonoOperatorModes,java.lang.Double)>/assign/10	<simplejavacalculator.Calculator: java.lang.Double calculateMono(simplejavacalculator.Calculator$MonoOperatorModes,java.lang.Double)>
<simplejavacalculator.Calculator$BiOperatorModes: void <clinit>()>/fresh-null-assign/7	<simplejavacalculator.Calculator$BiOperatorModes: void <clinit>()>
<simplejavacalculator.UI: void init()>/fresh-null-assign/7	<simplejavacalculator.UI: void init()>
<simplejavacalculator.Calculator: java.lang.Double calculateMono(simplejavacalculator.Calculator$MonoOperatorModes,java.lang.Double)>/fresh-null-assign/0	<simplejavacalculator.Calculator: java.lang.Double calculateMono(simplejavacalculator.Calculator$MonoOperatorModes,java.lang.Double)>
<simplejavacalculator.Calculator: java.lang.Double calculateMono(simplejavacalculator.Calculator$MonoOperatorModes,java.lang.Double)>/assign/25	<simplejavacalculator.Calculator: java.lang.Double calculateMono(simplejavacalculator.Calculator$MonoOperatorModes,java.lang.Double)>
<simplejavacalculator.UI: void init()>/fresh-null-assign/10	<simplejavacalculator.UI: void init()>
<simplejavacalculator.Calculator$BiOperatorModes: void <clinit>()>/fresh-null-assign/5	<simplejavacalculator.Calculator$BiOperatorModes: void <clinit>()>
<simplejavacalculator.UI: void init()>/assign/5	<simplejavacalculator.UI: void init()>
<simplejavacalculator.Calculator: java.lang.Double calculateBi(simplejavacalculator.Calculator$BiOperatorModes,java.lang.Double)>/fresh-null-assign/1	<simplejavacalculator.Calculator: java.lang.Double calculateBi(simplejavacalculator.Calculator$BiOperatorModes,java.lang.Double)>
<simplejavacalculator.UI: void init()>/fresh-null-assign/4	<simplejavacalculator.UI: void init()>
<simplejavacalculator.Calculator$MonoOperatorModes: void <clinit>()>/fresh-null-assign/7	<simplejavacalculator.Calculator$MonoOperatorModes: void <clinit>()>
<simplejavacalculator.Calculator$MonoOperatorModes: void <clinit>()>/fresh-null-assign/3	<simplejavacalculator.Calculator$MonoOperatorModes: void <clinit>()>
<simplejavacalculator.UI: void init()>/assign/56	<simplejavacalculator.UI: void init()>
<simplejavacalculator.UI: void actionPerformed(java.awt.event.ActionEvent)>/assign/4	<simplejavacalculator.UI: void actionPerformed(java.awt.event.ActionEvent)>
<simplejavacalculator.Calculator$MonoOperatorModes: void <clinit>()>/fresh-null-assign/17	<simplejavacalculator.Calculator$MonoOperatorModes: void <clinit>()>
<simplejavacalculator.UI: void init()>/fresh-null-assign/2	<simplejavacalculator.UI: void init()>
<simplejavacalculator.UI: void init()>/assign/2	<simplejavacalculator.UI: void init()>
<simplejavacalculator.Calculator$MonoOperatorModes: void <clinit>()>/fresh-null-assign/1	<simplejavacalculator.Calculator$MonoOperatorModes: void <clinit>()>
<simplejavacalculator.Calculator: java.lang.Double calculateBi(simplejavacalculator.Calculator$BiOperatorModes,java.lang.Double)>/fresh-null-assign/0	<simplejavacalculator.Calculator: java.lang.Double calculateBi(simplejavacalculator.Calculator$BiOperatorModes,java.lang.Double)>
<simplejavacalculator.UI: void init()>/fresh-null-assign/11	<simplejavacalculator.UI: void init()>
<simplejavacalculator.UI: void init()>/assign/53	<simplejavacalculator.UI: void init()>
<simplejavacalculator.UI: void init()>/fresh-null-assign/8	<simplejavacalculator.UI: void init()>
<simplejavacalculator.UI: void init()>/fresh-null-assign/1	<simplejavacalculator.UI: void init()>
<simplejavacalculator.UI: void init()>/fresh-null-assign/9	<simplejavacalculator.UI: void init()>
<simplejavacalculator.Calculator$MonoOperatorModes: void <clinit>()>/fresh-null-assign/5	<simplejavacalculator.Calculator$MonoOperatorModes: void <clinit>()>
<simplejavacalculator.Calculator$MonoOperatorModes: void <clinit>()>/fresh-null-assign/11	<simplejavacalculator.Calculator$MonoOperatorModes: void <clinit>()>
<simplejavacalculator.Calculator$BiOperatorModes: void <clinit>()>/fresh-null-assign/11	<simplejavacalculator.Calculator$BiOperatorModes: void <clinit>()>
<simplejavacalculator.Calculator$MonoOperatorModes: void <clinit>()>/fresh-null-assign/15	<simplejavacalculator.Calculator$MonoOperatorModes: void <clinit>()>
<simplejavacalculator.Calculator$MonoOperatorModes: void <clinit>()>/fresh-null-assign/13	<simplejavacalculator.Calculator$MonoOperatorModes: void <clinit>()>
<simplejavacalculator.UI: void actionPerformed(java.awt.event.ActionEvent)>/assign/7	<simplejavacalculator.UI: void actionPerformed(java.awt.event.ActionEvent)>
<simplejavacalculator.Calculator: java.lang.Double reset()>/fresh-null-assign/1	<simplejavacalculator.Calculator: java.lang.Double reset()>
<simplejavacalculator.UI: void <init>()>/fresh-null-assign/15	<simplejavacalculator.UI: void <init>()>
<simplejavacalculator.UI: void <init>()>/fresh-null-assign/14	<simplejavacalculator.UI: void <init>()>
<simplejavacalculator.UI: void <init>()>/assign/29	<simplejavacalculator.UI: void <init>()>
<simplejavacalculator.UI: void <init>()>/fresh-null-assign/12	<simplejavacalculator.UI: void <init>()>
<simplejavacalculator.UI: void <init>()>/assign/26	<simplejavacalculator.UI: void <init>()>
<simplejavacalculator.UI: void <init>()>/fresh-null-assign/20	<simplejavacalculator.UI: void <init>()>
<simplejavacalculator.UI: void <init>()>/fresh-null-assign/19	<simplejavacalculator.UI: void <init>()>
<simplejavacalculator.UI: void <init>()>/fresh-null-assign/16	<simplejavacalculator.UI: void <init>()>
<simplejavacalculator.UI: void <init>()>/fresh-null-assign/17	<simplejavacalculator.UI: void <init>()>
<simplejavacalculator.UI: void init()>/fresh-null-assign/3	<simplejavacalculator.UI: void init()>
<simplejavacalculator.Calculator: java.lang.Double calculateBiImpl()>/java.lang.Double.valueOf/2	<simplejavacalculator.Calculator: java.lang.Double calculateBiImpl()>
<simplejavacalculator.Calculator: java.lang.Double calculateMono(simplejavacalculator.Calculator$MonoOperatorModes,java.lang.Double)>/java.lang.Math.log10/0	<simplejavacalculator.Calculator: java.lang.Double calculateMono(simplejavacalculator.Calculator$MonoOperatorModes,java.lang.Double)>
<simplejavacalculator.Calculator: java.lang.Double reset()>/java.lang.Double.valueOf/2	<simplejavacalculator.Calculator: java.lang.Double reset()>
<simplejavacalculator.Calculator: java.lang.Double calculateMono(simplejavacalculator.Calculator$MonoOperatorModes,java.lang.Double)>/java.lang.Math.abs/0	<simplejavacalculator.Calculator: java.lang.Double calculateMono(simplejavacalculator.Calculator$MonoOperatorModes,java.lang.Double)>
<simplejavacalculator.Calculator: java.lang.Double calculateMono(simplejavacalculator.Calculator$MonoOperatorModes,java.lang.Double)>/java.lang.Double.valueOf/9	<simplejavacalculator.Calculator: java.lang.Double calculateMono(simplejavacalculator.Calculator$MonoOperatorModes,java.lang.Double)>
<simplejavacalculator.Calculator: java.lang.Double calculateBiImpl()>/java.lang.Double.valueOf/0	<simplejavacalculator.Calculator: java.lang.Double calculateBiImpl()>
<simplejavacalculator.Calculator: java.lang.Double calculateMono(simplejavacalculator.Calculator$MonoOperatorModes,java.lang.Double)>/java.lang.Math.sqrt/0	<simplejavacalculator.Calculator: java.lang.Double calculateMono(simplejavacalculator.Calculator$MonoOperatorModes,java.lang.Double)>
<simplejavacalculator.Calculator: java.lang.Double calculateMono(simplejavacalculator.Calculator$MonoOperatorModes,java.lang.Double)>/java.lang.Double.valueOf/7	<simplejavacalculator.Calculator: java.lang.Double calculateMono(simplejavacalculator.Calculator$MonoOperatorModes,java.lang.Double)>
<simplejavacalculator.Calculator: java.lang.Double calculateMono(simplejavacalculator.Calculator$MonoOperatorModes,java.lang.Double)>/java.lang.Double.valueOf/3	<simplejavacalculator.Calculator: java.lang.Double calculateMono(simplejavacalculator.Calculator$MonoOperatorModes,java.lang.Double)>
<simplejavacalculator.Calculator: java.lang.Double calculateMono(simplejavacalculator.Calculator$MonoOperatorModes,java.lang.Double)>/java.lang.Math.tan/0	<simplejavacalculator.Calculator: java.lang.Double calculateMono(simplejavacalculator.Calculator$MonoOperatorModes,java.lang.Double)>
<simplejavacalculator.Calculator: java.lang.Double calculateBiImpl()>/java.lang.Math.pow/0	<simplejavacalculator.Calculator: java.lang.Double calculateBiImpl()>
<simplejavacalculator.Calculator: java.lang.Double calculateMono(simplejavacalculator.Calculator$MonoOperatorModes,java.lang.Double)>/java.lang.Double.valueOf/5	<simplejavacalculator.Calculator: java.lang.Double calculateMono(simplejavacalculator.Calculator$MonoOperatorModes,java.lang.Double)>
<simplejavacalculator.Calculator: java.lang.Double calculateMono(simplejavacalculator.Calculator$MonoOperatorModes,java.lang.Double)>/java.lang.Double.valueOf/2	<simplejavacalculator.Calculator: java.lang.Double calculateMono(simplejavacalculator.Calculator$MonoOperatorModes,java.lang.Double)>
<simplejavacalculator.Calculator: java.lang.Double calculateMono(simplejavacalculator.Calculator$MonoOperatorModes,java.lang.Double)>/java.lang.Double.valueOf/6	<simplejavacalculator.Calculator: java.lang.Double calculateMono(simplejavacalculator.Calculator$MonoOperatorModes,java.lang.Double)>
<simplejavacalculator.UI: void init()>/javax.swing.Box.createHorizontalStrut/0	<simplejavacalculator.UI: void init()>
<simplejavacalculator.Calculator$BiOperatorModes: simplejavacalculator.Calculator$BiOperatorModes valueOf(java.lang.String)>/java.lang.Enum.valueOf/0	<simplejavacalculator.Calculator$BiOperatorModes: simplejavacalculator.Calculator$BiOperatorModes valueOf(java.lang.String)>
<simplejavacalculator.UI: void init()>/javax.swing.Box.createHorizontalStrut/3	<simplejavacalculator.UI: void init()>
<simplejavacalculator.Calculator: java.lang.Double calculateMono(simplejavacalculator.Calculator$MonoOperatorModes,java.lang.Double)>/java.lang.Math.cos/0	<simplejavacalculator.Calculator: java.lang.Double calculateMono(simplejavacalculator.Calculator$MonoOperatorModes,java.lang.Double)>
<simplejavacalculator.UI: void init()>/javax.swing.Box.createHorizontalStrut/4	<simplejavacalculator.UI: void init()>
<simplejavacalculator.Calculator: java.lang.Double reset()>/java.lang.Double.valueOf/1	<simplejavacalculator.Calculator: java.lang.Double reset()>
<simplejavacalculator.UI: void parsetoBinary()>/java.lang.Long.toBinaryString/0	<simplejavacalculator.UI: void parsetoBinary()>
<simplejavacalculator.Calculator: java.lang.Double calculateBiImpl()>/java.lang.Double.valueOf/4	<simplejavacalculator.Calculator: java.lang.Double calculateBiImpl()>
<simplejavacalculator.Calculator: java.lang.Double reset()>/java.lang.Double.valueOf/0	<simplejavacalculator.Calculator: java.lang.Double reset()>
<simplejavacalculator.UI: void writer(java.lang.Double)>/java.lang.Double.toString/0	<simplejavacalculator.UI: void writer(java.lang.Double)>
<simplejavacalculator.Calculator: java.lang.Double calculateBiImpl()>/java.lang.Double.valueOf/3	<simplejavacalculator.Calculator: java.lang.Double calculateBiImpl()>
<simplejavacalculator.UI: void init()>/javax.swing.Box.createHorizontalStrut/2	<simplejavacalculator.UI: void init()>
<simplejavacalculator.Calculator: java.lang.Double calculateBi(simplejavacalculator.Calculator$BiOperatorModes,java.lang.Double)>/java.lang.Double.valueOf/1	<simplejavacalculator.Calculator: java.lang.Double calculateBi(simplejavacalculator.Calculator$BiOperatorModes,java.lang.Double)>
<simplejavacalculator.Calculator$MonoOperatorModes: simplejavacalculator.Calculator$MonoOperatorModes valueOf(java.lang.String)>/java.lang.Enum.valueOf/0	<simplejavacalculator.Calculator$MonoOperatorModes: simplejavacalculator.Calculator$MonoOperatorModes valueOf(java.lang.String)>
<simplejavacalculator.UI: void writer(java.lang.Double)>/java.lang.Double.isNaN/0	<simplejavacalculator.UI: void writer(java.lang.Double)>
<simplejavacalculator.Calculator: java.lang.Double calculateBiImpl()>/java.lang.Double.valueOf/1	<simplejavacalculator.Calculator: java.lang.Double calculateBiImpl()>
<simplejavacalculator.Calculator: java.lang.Double calculateMono(simplejavacalculator.Calculator$MonoOperatorModes,java.lang.Double)>/java.lang.Double.valueOf/0	<simplejavacalculator.Calculator: java.lang.Double calculateMono(simplejavacalculator.Calculator$MonoOperatorModes,java.lang.Double)>
<simplejavacalculator.Calculator: java.lang.Double calculateMono(simplejavacalculator.Calculator$MonoOperatorModes,java.lang.Double)>/java.lang.Math.sin/0	<simplejavacalculator.Calculator: java.lang.Double calculateMono(simplejavacalculator.Calculator$MonoOperatorModes,java.lang.Double)>
<simplejavacalculator.Calculator: java.lang.Double calculateMono(simplejavacalculator.Calculator$MonoOperatorModes,java.lang.Double)>/java.lang.Double.valueOf/1	<simplejavacalculator.Calculator: java.lang.Double calculateMono(simplejavacalculator.Calculator$MonoOperatorModes,java.lang.Double)>
<simplejavacalculator.Calculator: java.lang.Double calculateMono(simplejavacalculator.Calculator$MonoOperatorModes,java.lang.Double)>/java.lang.Double.valueOf/4	<simplejavacalculator.Calculator: java.lang.Double calculateMono(simplejavacalculator.Calculator$MonoOperatorModes,java.lang.Double)>
<simplejavacalculator.Calculator: java.lang.Double calculateMono(simplejavacalculator.Calculator$MonoOperatorModes,java.lang.Double)>/java.lang.Double.valueOf/8	<simplejavacalculator.Calculator: java.lang.Double calculateMono(simplejavacalculator.Calculator$MonoOperatorModes,java.lang.Double)>
<simplejavacalculator.Calculator: java.lang.Double calculateMono(simplejavacalculator.Calculator$MonoOperatorModes,java.lang.Double)>/java.lang.Double.valueOf/10	<simplejavacalculator.Calculator: java.lang.Double calculateMono(simplejavacalculator.Calculator$MonoOperatorModes,java.lang.Double)>
<simplejavacalculator.UI: void init()>/javax.swing.Box.createHorizontalStrut/1	<simplejavacalculator.UI: void init()>
<simplejavacalculator.Calculator: java.lang.Double calculateBi(simplejavacalculator.Calculator$BiOperatorModes,java.lang.Double)>/java.lang.Double.valueOf/0	<simplejavacalculator.Calculator: java.lang.Double calculateBi(simplejavacalculator.Calculator$BiOperatorModes,java.lang.Double)>
<simplejavacalculator.UI: java.lang.Double reader()>/java.lang.Double.valueOf/0	<simplejavacalculator.UI: java.lang.Double reader()>
<simplejavacalculator.UI: void parsetoBinary()>/java.lang.Long.parseLong/0	<simplejavacalculator.UI: void parsetoBinary()>
<simplejavacalculator.UI: void <init>()>/java.lang.String.valueOf/0	<simplejavacalculator.UI: void <init>()>
<simplejavacalculator.UI: void parsetoBinary()>/java.lang.StringBuilder.<init>/1	<simplejavacalculator.UI: void parsetoBinary()>
<simplejavacalculator.Calculator$BiOperatorModes: void <clinit>()>/simplejavacalculator.Calculator$BiOperatorModes.<init>/5	<simplejavacalculator.Calculator$BiOperatorModes: void <clinit>()>
<simplejavacalculator.UI: void <init>()>/java.lang.Object.<init>/0	<simplejavacalculator.UI: void <init>()>
<simplejavacalculator.UI: void actionPerformed(java.awt.event.ActionEvent)>/simplejavacalculator.UI.parsetoBinary/0	<simplejavacalculator.UI: void actionPerformed(java.awt.event.ActionEvent)>
<simplejavacalculator.Calculator$BiOperatorModes: void <clinit>()>/simplejavacalculator.Calculator$BiOperatorModes.<init>/3	<simplejavacalculator.Calculator$BiOperatorModes: void <clinit>()>
<simplejavacalculator.Calculator$MonoOperatorModes: void <clinit>()>/simplejavacalculator.Calculator$MonoOperatorModes.<init>/7	<simplejavacalculator.Calculator$MonoOperatorModes: void <clinit>()>
<simplejavacalculator.Calculator$BiOperatorModes: void <clinit>()>/simplejavacalculator.Calculator$BiOperatorModes.<init>/4	<simplejavacalculator.Calculator$BiOperatorModes: void <clinit>()>
<simplejavacalculator.Calculator$MonoOperatorModes: void <clinit>()>/simplejavacalculator.Calculator$MonoOperatorModes.<init>/0	<simplejavacalculator.Calculator$MonoOperatorModes: void <clinit>()>
<simplejavacalculator.UI: void parsetoBinary()>/java.lang.StringBuilder.<init>/0	<simplejavacalculator.UI: void parsetoBinary()>
<simplejavacalculator.Calculator$MonoOperatorModes: void <clinit>()>/simplejavacalculator.Calculator$MonoOperatorModes.<init>/4	<simplejavacalculator.Calculator$MonoOperatorModes: void <clinit>()>
<simplejavacalculator.Calculator$BiOperatorModes: void <clinit>()>/simplejavacalculator.Calculator$BiOperatorModes.<init>/0	<simplejavacalculator.Calculator$BiOperatorModes: void <clinit>()>
<simplejavacalculator.Calculator$BiOperatorModes: void <clinit>()>/simplejavacalculator.Calculator$BiOperatorModes.<init>/2	<simplejavacalculator.Calculator$BiOperatorModes: void <clinit>()>
<simplejavacalculator.Calculator$MonoOperatorModes: void <clinit>()>/simplejavacalculator.Calculator$MonoOperatorModes.<init>/6	<simplejavacalculator.Calculator$MonoOperatorModes: void <clinit>()>
<simplejavacalculator.Calculator$BiOperatorModes: void <clinit>()>/simplejavacalculator.Calculator$BiOperatorModes.<init>/1	<simplejavacalculator.Calculator$BiOperatorModes: void <clinit>()>
<simplejavacalculator.Calculator$MonoOperatorModes: void <clinit>()>/simplejavacalculator.Calculator$MonoOperatorModes.<init>/3	<simplejavacalculator.Calculator$MonoOperatorModes: void <clinit>()>
<simplejavacalculator.Calculator: java.lang.Double calculateBiImpl()>/java.lang.Error.<init>/0	<simplejavacalculator.Calculator: java.lang.Double calculateBiImpl()>
<simplejavacalculator.Calculator: java.lang.Double calculateBi(simplejavacalculator.Calculator$BiOperatorModes,java.lang.Double)>/simplejavacalculator.Calculator.calculateBiImpl/0	<simplejavacalculator.Calculator: java.lang.Double calculateBi(simplejavacalculator.Calculator$BiOperatorModes,java.lang.Double)>
<simplejavacalculator.Calculator$MonoOperatorModes: void <clinit>()>/simplejavacalculator.Calculator$MonoOperatorModes.<init>/8	<simplejavacalculator.Calculator$MonoOperatorModes: void <clinit>()>
<simplejavacalculator.Calculator: java.lang.Double calculateMono(simplejavacalculator.Calculator$MonoOperatorModes,java.lang.Double)>/java.lang.Error.<init>/0	<simplejavacalculator.Calculator: java.lang.Double calculateMono(simplejavacalculator.Calculator$MonoOperatorModes,java.lang.Double)>
<simplejavacalculator.Calculator: void <init>()>/java.lang.Object.<init>/0	<simplejavacalculator.Calculator: void <init>()>
<simplejavacalculator.Calculator$MonoOperatorModes: void <clinit>()>/simplejavacalculator.Calculator$MonoOperatorModes.<init>/5	<simplejavacalculator.Calculator$MonoOperatorModes: void <clinit>()>
<simplejavacalculator.Calculator$MonoOperatorModes: void <clinit>()>/simplejavacalculator.Calculator$MonoOperatorModes.<init>/2	<simplejavacalculator.Calculator$MonoOperatorModes: void <clinit>()>
<simplejavacalculator.Calculator$MonoOperatorModes: void <clinit>()>/simplejavacalculator.Calculator$MonoOperatorModes.<init>/1	<simplejavacalculator.Calculator$MonoOperatorModes: void <clinit>()>
<simplejavacalculator.UI: void <init>()>/javax.swing.JButton.<init>/6	<simplejavacalculator.UI: void <init>()>
<simplejavacalculator.UI: void <init>()>/javax.swing.JButton.<init>/15	<simplejavacalculator.UI: void <init>()>
<simplejavacalculator.UI: void <init>()>/javax.swing.ImageIcon.<init>/0	<simplejavacalculator.UI: void <init>()>
<simplejavacalculator.SimpleJavaCalculator: void <init>()>/java.lang.Object.<init>/0	<simplejavacalculator.SimpleJavaCalculator: void <init>()>
<simplejavacalculator.UI: void <init>()>/javax.swing.JPanel.<init>/4	<simplejavacalculator.UI: void <init>()>
<simplejavacalculator.UI: void <init>()>/javax.swing.JPanel.<init>/1	<simplejavacalculator.UI: void <init>()>
<simplejavacalculator.UI: void <init>()>/javax.swing.JButton.<init>/5	<simplejavacalculator.UI: void <init>()>
<simplejavacalculator.UI: void <init>()>/javax.swing.JPanel.<init>/7	<simplejavacalculator.UI: void <init>()>
<simplejavacalculator.UI: void <init>()>/javax.swing.JButton.<init>/13	<simplejavacalculator.UI: void <init>()>
<simplejavacalculator.UI: void <init>()>/javax.swing.JButton.<init>/11	<simplejavacalculator.UI: void <init>()>
<simplejavacalculator.UI: void <init>()>/javax.swing.JPanel.<init>/5	<simplejavacalculator.UI: void <init>()>
<simplejavacalculator.UI: void <init>()>/javax.swing.JButton.<init>/17	<simplejavacalculator.UI: void <init>()>
<simplejavacalculator.UI: void <init>()>/javax.swing.JButton.<init>/7	<simplejavacalculator.UI: void <init>()>
<simplejavacalculator.UI: void <init>()>/javax.swing.JPanel.<init>/6	<simplejavacalculator.UI: void <init>()>
<simplejavacalculator.UI: void <init>()>/java.awt.FlowLayout.<init>/1	<simplejavacalculator.UI: void <init>()>
<simplejavacalculator.UI: void <init>()>/javax.swing.JTextArea.<init>/0	<simplejavacalculator.UI: void <init>()>
<simplejavacalculator.UI: void <init>()>/javax.swing.JPanel.<init>/2	<simplejavacalculator.UI: void <init>()>
<simplejavacalculator.UI: void <init>()>/java.awt.FlowLayout.<init>/7	<simplejavacalculator.UI: void <init>()>
<simplejavacalculator.UI: void <init>()>/javax.swing.JPanel.<init>/3	<simplejavacalculator.UI: void <init>()>
<simplejavacalculator.UI: void <init>()>/javax.swing.JButton.<init>/3	<simplejavacalculator.UI: void <init>()>
<simplejavacalculator.UI: void <init>()>/java.awt.FlowLayout.<init>/2	<simplejavacalculator.UI: void <init>()>
<simplejavacalculator.UI: void <init>()>/javax.swing.JButton.<init>/9	<simplejavacalculator.UI: void <init>()>
<simplejavacalculator.UI: void <init>()>/java.awt.FlowLayout.<init>/6	<simplejavacalculator.UI: void <init>()>
<simplejavacalculator.UI: void <init>()>/javax.swing.JPanel.<init>/0	<simplejavacalculator.UI: void <init>()>
<simplejavacalculator.Calculator$MonoOperatorModes: void <init>(java.lang.String,int)>/java.lang.Enum.<init>/0	<simplejavacalculator.Calculator$MonoOperatorModes: void <init>(java.lang.String,int)>
<simplejavacalculator.UI: void <init>()>/javax.swing.JFrame.<init>/0	<simplejavacalculator.UI: void <init>()>
<simplejavacalculator.UI: void <init>()>/javax.swing.JButton.<init>/0	<simplejavacalculator.UI: void <init>()>
<simplejavacalculator.UI: void <init>()>/javax.swing.JButton.<init>/10	<simplejavacalculator.UI: void <init>()>
<simplejavacalculator.UI: void <init>()>/simplejavacalculator.Calculator.<init>/0	<simplejavacalculator.UI: void <init>()>
<simplejavacalculator.UI: void <init>()>/javax.swing.JButton.<init>/1	<simplejavacalculator.UI: void <init>()>
<simplejavacalculator.UI: void <init>()>/java.awt.Font.<init>/0	<simplejavacalculator.UI: void <init>()>
<simplejavacalculator.UI: void <init>()>/javax.swing.JButton.<init>/14	<simplejavacalculator.UI: void <init>()>
<simplejavacalculator.UI: void <init>()>/java.awt.FlowLayout.<init>/5	<simplejavacalculator.UI: void <init>()>
<simplejavacalculator.SimpleJavaCalculator: void main(java.lang.String[])>/simplejavacalculator.UI.<init>/0	<simplejavacalculator.SimpleJavaCalculator: void main(java.lang.String[])>
<simplejavacalculator.UI: void <init>()>/javax.swing.JButton.<init>/8	<simplejavacalculator.UI: void <init>()>
<simplejavacalculator.UI: void <init>()>/javax.swing.JButton.<init>/4	<simplejavacalculator.UI: void <init>()>
<simplejavacalculator.UI: void <init>()>/java.awt.FlowLayout.<init>/3	<simplejavacalculator.UI: void <init>()>
<simplejavacalculator.UI: void <init>()>/javax.swing.JPanel.<init>/8	<simplejavacalculator.UI: void <init>()>
<simplejavacalculator.Calculator$BiOperatorModes: void <init>(java.lang.String,int)>/java.lang.Enum.<init>/0	<simplejavacalculator.Calculator$BiOperatorModes: void <init>(java.lang.String,int)>
<simplejavacalculator.UI: void <init>()>/java.awt.FlowLayout.<init>/4	<simplejavacalculator.UI: void <init>()>
<simplejavacalculator.UI: void <init>()>/java.awt.Font.<init>/1	<simplejavacalculator.UI: void <init>()>
<simplejavacalculator.UI: void <init>()>/java.awt.FlowLayout.<init>/0	<simplejavacalculator.UI: void <init>()>
<simplejavacalculator.UI: void <init>()>/javax.swing.JButton.<init>/12	<simplejavacalculator.UI: void <init>()>
<simplejavacalculator.UI: void <init>()>/javax.swing.BoxLayout.<init>/0	<simplejavacalculator.UI: void <init>()>
<simplejavacalculator.UI: void <init>()>/javax.swing.JButton.<init>/16	<simplejavacalculator.UI: void <init>()>
<simplejavacalculator.UI: void <init>()>/javax.swing.JButton.<init>/2	<simplejavacalculator.UI: void <init>()>
<simplejavacalculator.Calculator: java.lang.Double calculateMono(simplejavacalculator.Calculator$MonoOperatorModes,java.lang.Double)>/java.lang.Double.doubleValue/11	<simplejavacalculator.Calculator: java.lang.Double calculateMono(simplejavacalculator.Calculator$MonoOperatorModes,java.lang.Double)>
<simplejavacalculator.UI: void init()>/javax.swing.JButton.addActionListener/0	<simplejavacalculator.UI: void init()>
<simplejavacalculator.UI: java.lang.Double reader()>/javax.swing.JTextArea.getText/0	<simplejavacalculator.UI: java.lang.Double reader()>
<simplejavacalculator.Calculator: java.lang.Double calculateBiImpl()>/java.lang.Double.doubleValue/8	<simplejavacalculator.Calculator: java.lang.Double calculateBiImpl()>
<simplejavacalculator.Calculator: java.lang.Double calculateMono(simplejavacalculator.Calculator$MonoOperatorModes,java.lang.Double)>/java.lang.Double.doubleValue/12	<simplejavacalculator.Calculator: java.lang.Double calculateMono(simplejavacalculator.Calculator$MonoOperatorModes,java.lang.Double)>
<simplejavacalculator.Calculator: java.lang.Double calculateBiImpl()>/java.lang.Double.doubleValue/7	<simplejavacalculator.Calculator: java.lang.Double calculateBiImpl()>
<simplejavacalculator.Calculator: java.lang.Double calculateMono(simplejavacalculator.Calculator$MonoOperatorModes,java.lang.Double)>/java.lang.Double.doubleValue/13	<simplejavacalculator.Calculator: java.lang.Double calculateMono(simplejavacalculator.Calculator$MonoOperatorModes,java.lang.Double)>
<simplejavacalculator.UI: void actionPerformed(java.awt.event.ActionEvent)>/simplejavacalculator.UI.reader/14	<simplejavacalculator.UI: void actionPerformed(java.awt.event.ActionEvent)>
<simplejavacalculator.Calculator: java.lang.Double calculateBiImpl()>/java.lang.Double.doubleValue/0	<simplejavacalculator.Calculator: java.lang.Double calculateBiImpl()>
<simplejavacalculator.Calculator: java.lang.Double calculateMono(simplejavacalculator.Calculator$MonoOperatorModes,java.lang.Double)>/java.lang.Double.doubleValue/7	<simplejavacalculator.Calculator: java.lang.Double calculateMono(simplejavacalculator.Calculator$MonoOperatorModes,java.lang.Double)>
<simplejavacalculator.Calculator: java.lang.Double calculateMono(simplejavacalculator.Calculator$MonoOperatorModes,java.lang.Double)>/java.lang.Double.doubleValue/4	<simplejavacalculator.Calculator: java.lang.Double calculateMono(simplejavacalculator.Calculator$MonoOperatorModes,java.lang.Double)>
<simplejavacalculator.Calculator: java.lang.Double calculateMono(simplejavacalculator.Calculator$MonoOperatorModes,java.lang.Double)>/java.lang.Double.doubleValue/6	<simplejavacalculator.Calculator: java.lang.Double calculateMono(simplejavacalculator.Calculator$MonoOperatorModes,java.lang.Double)>
<simplejavacalculator.Calculator: java.lang.Double calculateMono(simplejavacalculator.Calculator$MonoOperatorModes,java.lang.Double)>/java.lang.Double.doubleValue/3	<simplejavacalculator.Calculator: java.lang.Double calculateMono(simplejavacalculator.Calculator$MonoOperatorModes,java.lang.Double)>
<simplejavacalculator.Calculator: java.lang.Double calculateBiImpl()>/java.lang.Double.doubleValue/9	<simplejavacalculator.Calculator: java.lang.Double calculateBiImpl()>
<simplejavacalculator.Calculator: java.lang.Double calculateBiImpl()>/java.lang.Double.doubleValue/2	<simplejavacalculator.Calculator: java.lang.Double calculateBiImpl()>
<simplejavacalculator.UI: void parsetoBinary()>/java.lang.StringBuilder.append/0	<simplejavacalculator.UI: void parsetoBinary()>
<simplejavacalculator.Calculator: java.lang.Double calculateBiImpl()>/java.lang.Double.doubleValue/4	<simplejavacalculator.Calculator: java.lang.Double calculateBiImpl()>
<simplejavacalculator.Calculator: java.lang.Double calculateMono(simplejavacalculator.Calculator$MonoOperatorModes,java.lang.Double)>/java.lang.Double.doubleValue/0	<simplejavacalculator.Calculator: java.lang.Double calculateMono(simplejavacalculator.Calculator$MonoOperatorModes,java.lang.Double)>
<simplejavacalculator.Calculator$MonoOperatorModes: simplejavacalculator.Calculator$MonoOperatorModes[] values()>/java.lang.Object.clone/0	<simplejavacalculator.Calculator$MonoOperatorModes: simplejavacalculator.Calculator$MonoOperatorModes[] values()>
<simplejavacalculator.Calculator: java.lang.Double calculateMono(simplejavacalculator.Calculator$MonoOperatorModes,java.lang.Double)>/java.lang.Double.doubleValue/1	<simplejavacalculator.Calculator: java.lang.Double calculateMono(simplejavacalculator.Calculator$MonoOperatorModes,java.lang.Double)>
<simplejavacalculator.UI: void init()>/javax.swing.JButton.addActionListener/1	<simplejavacalculator.UI: void init()>
<simplejavacalculator.Calculator: java.lang.Double calculateBiImpl()>/java.lang.Double.doubleValue/5	<simplejavacalculator.Calculator: java.lang.Double calculateBiImpl()>
<simplejavacalculator.Calculator: java.lang.Double calculateBiImpl()>/java.lang.Double.doubleValue/1	<simplejavacalculator.Calculator: java.lang.Double calculateBiImpl()>
<simplejavacalculator.Calculator$BiOperatorModes: simplejavacalculator.Calculator$BiOperatorModes[] values()>/java.lang.Object.clone/0	<simplejavacalculator.Calculator$BiOperatorModes: simplejavacalculator.Calculator$BiOperatorModes[] values()>
<simplejavacalculator.Calculator: java.lang.Double calculateMono(simplejavacalculator.Calculator$MonoOperatorModes,java.lang.Double)>/java.lang.Double.doubleValue/9	<simplejavacalculator.Calculator: java.lang.Double calculateMono(simplejavacalculator.Calculator$MonoOperatorModes,java.lang.Double)>
<simplejavacalculator.Calculator: java.lang.Double calculateBiImpl()>/java.lang.Double.doubleValue/6	<simplejavacalculator.Calculator: java.lang.Double calculateBiImpl()>
<simplejavacalculator.Calculator: java.lang.Double calculateMono(simplejavacalculator.Calculator$MonoOperatorModes,java.lang.Double)>/java.lang.Double.doubleValue/5	<simplejavacalculator.Calculator: java.lang.Double calculateMono(simplejavacalculator.Calculator$MonoOperatorModes,java.lang.Double)>
<simplejavacalculator.Calculator: java.lang.Double calculateMono(simplejavacalculator.Calculator$MonoOperatorModes,java.lang.Double)>/java.lang.Double.doubleValue/2	<simplejavacalculator.Calculator: java.lang.Double calculateMono(simplejavacalculator.Calculator$MonoOperatorModes,java.lang.Double)>
<simplejavacalculator.UI: void parsetoBinary()>/java.lang.StringBuilder.append/2	<simplejavacalculator.UI: void parsetoBinary()>
<simplejavacalculator.Calculator: java.lang.Double calculateBiImpl()>/java.lang.Double.doubleValue/3	<simplejavacalculator.Calculator: java.lang.Double calculateBiImpl()>
<simplejavacalculator.Calculator: java.lang.Double calculateBiImpl()>/java.lang.Double.doubleValue/10	<simplejavacalculator.Calculator: java.lang.Double calculateBiImpl()>
<simplejavacalculator.Calculator: java.lang.Double calculateMono(simplejavacalculator.Calculator$MonoOperatorModes,java.lang.Double)>/java.lang.Double.doubleValue/8	<simplejavacalculator.Calculator: java.lang.Double calculateMono(simplejavacalculator.Calculator$MonoOperatorModes,java.lang.Double)>
<simplejavacalculator.UI: void actionPerformed(java.awt.event.ActionEvent)>/simplejavacalculator.Calculator.calculateMono/0	<simplejavacalculator.UI: void actionPerformed(java.awt.event.ActionEvent)>
<simplejavacalculator.UI: void writer(java.lang.Double)>/javax.swing.JTextArea.setText/0	<simplejavacalculator.UI: void writer(java.lang.Double)>
<simplejavacalculator.UI: void actionPerformed(java.awt.event.ActionEvent)>/simplejavacalculator.UI.reader/0	<simplejavacalculator.UI: void actionPerformed(java.awt.event.ActionEvent)>
<simplejavacalculator.UI: void parsetoBinary()>/java.io.PrintStream.println/0	<simplejavacalculator.UI: void parsetoBinary()>
<simplejavacalculator.UI: void actionPerformed(java.awt.event.ActionEvent)>/simplejavacalculator.UI.reader/12	<simplejavacalculator.UI: void actionPerformed(java.awt.event.ActionEvent)>
<simplejavacalculator.UI: void init()>/javax.swing.JPanel.add/40	<simplejavacalculator.UI: void init()>
<simplejavacalculator.UI: void init()>/javax.swing.JPanel.add/19	<simplejavacalculator.UI: void init()>
<simplejavacalculator.UI: void actionPerformed(java.awt.event.ActionEvent)>/simplejavacalculator.UI.writer/15	<simplejavacalculator.UI: void actionPerformed(java.awt.event.ActionEvent)>
<simplejavacalculator.UI: void init()>/javax.swing.JButton.addActionListener/13	<simplejavacalculator.UI: void init()>
<simplejavacalculator.UI: void init()>/javax.swing.JPanel.add/14	<simplejavacalculator.UI: void init()>
<simplejavacalculator.UI: void init()>/javax.swing.JPanel.add/30	<simplejavacalculator.UI: void init()>
<simplejavacalculator.UI: void init()>/javax.swing.JPanel.add/32	<simplejavacalculator.UI: void init()>
<simplejavacalculator.UI: void init()>/javax.swing.JPanel.add/33	<simplejavacalculator.UI: void init()>
<simplejavacalculator.UI: void actionPerformed(java.awt.event.ActionEvent)>/simplejavacalculator.UI.writer/8	<simplejavacalculator.UI: void actionPerformed(java.awt.event.ActionEvent)>
<simplejavacalculator.UI: void init()>/javax.swing.JButton.addActionListener/6	<simplejavacalculator.UI: void init()>
<simplejavacalculator.UI: void init()>/javax.swing.JPanel.add/1	<simplejavacalculator.UI: void init()>
<simplejavacalculator.UI: void init()>/javax.swing.JPanel.add/3	<simplejavacalculator.UI: void init()>
<simplejavacalculator.UI: void actionPerformed(java.awt.event.ActionEvent)>/simplejavacalculator.UI.reader/3	<simplejavacalculator.UI: void actionPerformed(java.awt.event.ActionEvent)>
<simplejavacalculator.UI: void actionPerformed(java.awt.event.ActionEvent)>/simplejavacalculator.UI.reader/5	<simplejavacalculator.UI: void actionPerformed(java.awt.event.ActionEvent)>
<simplejavacalculator.UI: void init()>/javax.swing.JPanel.add/25	<simplejavacalculator.UI: void init()>
<simplejavacalculator.UI: void actionPerformed(java.awt.event.ActionEvent)>/simplejavacalculator.UI.writer/7	<simplejavacalculator.UI: void actionPerformed(java.awt.event.ActionEvent)>
<simplejavacalculator.UI: void actionPerformed(java.awt.event.ActionEvent)>/simplejavacalculator.Calculator.calculateMono/8	<simplejavacalculator.UI: void actionPerformed(java.awt.event.ActionEvent)>
<simplejavacalculator.UI: void init()>/javax.swing.JTextArea.setEditable/0	<simplejavacalculator.UI: void init()>
<simplejavacalculator.UI: void init()>/javax.swing.JButton.setFont/3	<simplejavacalculator.UI: void init()>
<simplejavacalculator.UI: void actionPerformed(java.awt.event.ActionEvent)>/simplejavacalculator.UI.reader/7	<simplejavacalculator.UI: void actionPerformed(java.awt.event.ActionEvent)>
<simplejavacalculator.UI: void actionPerformed(java.awt.event.ActionEvent)>/javax.swing.JTextArea.replaceSelection/0	<simplejavacalculator.UI: void actionPerformed(java.awt.event.ActionEvent)>
<simplejavacalculator.SimpleJavaCalculator: void main(java.lang.String[])>/simplejavacalculator.UI.init/0	<simplejavacalculator.SimpleJavaCalculator: void main(java.lang.String[])>
<simplejavacalculator.UI: void init()>/javax.swing.JFrame.setResizable/0	<simplejavacalculator.UI: void init()>
<simplejavacalculator.UI: void actionPerformed(java.awt.event.ActionEvent)>/simplejavacalculator.Calculator.calculateBi/0	<simplejavacalculator.UI: void actionPerformed(java.awt.event.ActionEvent)>
<simplejavacalculator.UI: void actionPerformed(java.awt.event.ActionEvent)>/simplejavacalculator.UI.writer/14	<simplejavacalculator.UI: void actionPerformed(java.awt.event.ActionEvent)>
<simplejavacalculator.UI: void init()>/javax.swing.JButton.setFont/10	<simplejavacalculator.UI: void init()>
<simplejavacalculator.UI: void init()>/javax.swing.JButton.setFont/1	<simplejavacalculator.UI: void init()>
<simplejavacalculator.UI: void actionPerformed(java.awt.event.ActionEvent)>/simplejavacalculator.UI.writer/9	<simplejavacalculator.UI: void actionPerformed(java.awt.event.ActionEvent)>
<simplejavacalculator.UI: void actionPerformed(java.awt.event.ActionEvent)>/java.awt.event.ActionEvent.getSource/0	<simplejavacalculator.UI: void actionPerformed(java.awt.event.ActionEvent)>
<simplejavacalculator.UI: void init()>/javax.swing.JPanel.add/9	<simplejavacalculator.UI: void init()>
<simplejavacalculator.UI: void actionPerformed(java.awt.event.ActionEvent)>/simplejavacalculator.Calculator.calculateMono/3	<simplejavacalculator.UI: void actionPerformed(java.awt.event.ActionEvent)>
<simplejavacalculator.UI: void parsetoBinary()>/java.lang.StringBuilder.toString/1	<simplejavacalculator.UI: void parsetoBinary()>
<simplejavacalculator.UI: void init()>/javax.swing.JPanel.add/29	<simplejavacalculator.UI: void init()>
<simplejavacalculator.UI: void init()>/javax.swing.JPanel.add/20	<simplejavacalculator.UI: void init()>
<simplejavacalculator.UI: void init()>/javax.swing.JButton.addActionListener/12	<simplejavacalculator.UI: void init()>
<simplejavacalculator.UI: void init()>/javax.swing.JButton.setFont/13	<simplejavacalculator.UI: void init()>
<simplejavacalculator.UI: void actionPerformed(java.awt.event.ActionEvent)>/simplejavacalculator.UI.reader/1	<simplejavacalculator.UI: void actionPerformed(java.awt.event.ActionEvent)>
<simplejavacalculator.UI: void init()>/javax.swing.JButton.addActionListener/3	<simplejavacalculator.UI: void init()>
<simplejavacalculator.UI: void init()>/javax.swing.JPanel.add/13	<simplejavacalculator.UI: void init()>
<simplejavacalculator.UI: void init()>/javax.swing.JPanel.add/27	<simplejavacalculator.UI: void init()>
<simplejavacalculator.UI: void init()>/javax.swing.JButton.addActionListener/14	<simplejavacalculator.UI: void init()>
<simplejavacalculator.UI: void actionPerformed(java.awt.event.ActionEvent)>/simplejavacalculator.Calculator.calculateMono/6	<simplejavacalculator.UI: void actionPerformed(java.awt.event.ActionEvent)>
<simplejavacalculator.Calculator: java.lang.Double calculateMono(simplejavacalculator.Calculator$MonoOperatorModes,java.lang.Double)>/java.lang.Double.doubleValue/10	<simplejavacalculator.Calculator: java.lang.Double calculateMono(simplejavacalculator.Calculator$MonoOperatorModes,java.lang.Double)>
<simplejavacalculator.UI: void actionPerformed(java.awt.event.ActionEvent)>/simplejavacalculator.UI.writer/12	<simplejavacalculator.UI: void actionPerformed(java.awt.event.ActionEvent)>
<simplejavacalculator.UI: void actionPerformed(java.awt.event.ActionEvent)>/simplejavacalculator.Calculator.reset/0	<simplejavacalculator.UI: void actionPerformed(java.awt.event.ActionEvent)>
<simplejavacalculator.UI: void actionPerformed(java.awt.event.ActionEvent)>/simplejavacalculator.Calculator.calculateMono/2	<simplejavacalculator.UI: void actionPerformed(java.awt.event.ActionEvent)>
<simplejavacalculator.UI: void parsetoBinary()>/javax.swing.JTextArea.setText/0	<simplejavacalculator.UI: void parsetoBinary()>
<simplejavacalculator.UI: void init()>/javax.swing.JPanel.add/11	<simplejavacalculator.UI: void init()>
<simplejavacalculator.UI: void init()>/javax.swing.JPanel.add/5	<simplejavacalculator.UI: void init()>
<simplejavacalculator.UI: void init()>/javax.swing.JPanel.add/24	<simplejavacalculator.UI: void init()>
<simplejavacalculator.UI: void init()>/javax.swing.JPanel.add/21	<simplejavacalculator.UI: void init()>
<simplejavacalculator.UI: void init()>/javax.swing.JPanel.add/18	<simplejavacalculator.UI: void init()>
<simplejavacalculator.UI: void <init>()>/javax.swing.JPanel.setLayout/0	<simplejavacalculator.UI: void <init>()>
<simplejavacalculator.UI: void actionPerformed(java.awt.event.ActionEvent)>/simplejavacalculator.UI.reader/2	<simplejavacalculator.UI: void actionPerformed(java.awt.event.ActionEvent)>
<simplejavacalculator.UI: void init()>/javax.swing.JTextArea.setFont/0	<simplejavacalculator.UI: void init()>
<simplejavacalculator.UI: void actionPerformed(java.awt.event.ActionEvent)>/simplejavacalculator.UI.writer/3	<simplejavacalculator.UI: void actionPerformed(java.awt.event.ActionEvent)>
<simplejavacalculator.UI: void init()>/javax.swing.JButton.addActionListener/5	<simplejavacalculator.UI: void init()>
<simplejavacalculator.UI: void init()>/javax.swing.JPanel.add/10	<simplejavacalculator.UI: void init()>
<simplejavacalculator.UI: void init()>/javax.swing.JPanel.add/39	<simplejavacalculator.UI: void init()>
<simplejavacalculator.UI: void init()>/javax.swing.JPanel.add/34	<simplejavacalculator.UI: void init()>
<simplejavacalculator.UI: void init()>/javax.swing.JPanel.add/35	<simplejavacalculator.UI: void init()>
<simplejavacalculator.UI: void init()>/javax.swing.JButton.setFont/5	<simplejavacalculator.UI: void init()>
<simplejavacalculator.UI: void init()>/javax.swing.JButton.setFont/6	<simplejavacalculator.UI: void init()>
<simplejavacalculator.UI: void init()>/javax.swing.JButton.setFont/15	<simplejavacalculator.UI: void init()>
<simplejavacalculator.UI: void init()>/javax.swing.JPanel.add/6	<simplejavacalculator.UI: void init()>
<simplejavacalculator.UI: void actionPerformed(java.awt.event.ActionEvent)>/simplejavacalculator.Calculator.calculateMono/7	<simplejavacalculator.UI: void actionPerformed(java.awt.event.ActionEvent)>
<simplejavacalculator.UI: void init()>/javax.swing.JButton.addActionListener/16	<simplejavacalculator.UI: void init()>
<simplejavacalculator.UI: void actionPerformed(java.awt.event.ActionEvent)>/simplejavacalculator.UI.reader/13	<simplejavacalculator.UI: void actionPerformed(java.awt.event.ActionEvent)>
<simplejavacalculator.UI: void actionPerformed(java.awt.event.ActionEvent)>/simplejavacalculator.UI.reader/8	<simplejavacalculator.UI: void actionPerformed(java.awt.event.ActionEvent)>
<simplejavacalculator.UI: void init()>/javax.swing.JButton.setFont/17	<simplejavacalculator.UI: void init()>
<simplejavacalculator.UI: void init()>/javax.swing.JFrame.setIconImage/0	<simplejavacalculator.UI: void init()>
<simplejavacalculator.UI: void init()>/javax.swing.JPanel.add/2	<simplejavacalculator.UI: void init()>
<simplejavacalculator.UI: void init()>/javax.swing.JButton.addActionListener/15	<simplejavacalculator.UI: void init()>
<simplejavacalculator.UI: void actionPerformed(java.awt.event.ActionEvent)>/simplejavacalculator.UI.writer/1	<simplejavacalculator.UI: void actionPerformed(java.awt.event.ActionEvent)>
<simplejavacalculator.UI: void actionPerformed(java.awt.event.ActionEvent)>/simplejavacalculator.UI.reader/11	<simplejavacalculator.UI: void actionPerformed(java.awt.event.ActionEvent)>
<simplejavacalculator.UI: void init()>/javax.swing.JPanel.add/15	<simplejavacalculator.UI: void init()>
<simplejavacalculator.UI: void init()>/javax.swing.JButton.setFont/2	<simplejavacalculator.UI: void init()>
<simplejavacalculator.UI: void actionPerformed(java.awt.event.ActionEvent)>/simplejavacalculator.UI.writer/10	<simplejavacalculator.UI: void actionPerformed(java.awt.event.ActionEvent)>
<simplejavacalculator.UI: void actionPerformed(java.awt.event.ActionEvent)>/simplejavacalculator.UI.writer/11	<simplejavacalculator.UI: void actionPerformed(java.awt.event.ActionEvent)>
<simplejavacalculator.UI: void init()>/javax.swing.JPanel.add/36	<simplejavacalculator.UI: void init()>
<simplejavacalculator.UI: void init()>/javax.swing.JButton.addActionListener/7	<simplejavacalculator.UI: void init()>
<simplejavacalculator.UI: void init()>/javax.swing.JButton.addActionListener/9	<simplejavacalculator.UI: void init()>
<simplejavacalculator.UI: void actionPerformed(java.awt.event.ActionEvent)>/simplejavacalculator.Calculator.calculateEqual/0	<simplejavacalculator.UI: void actionPerformed(java.awt.event.ActionEvent)>
<simplejavacalculator.UI: void actionPerformed(java.awt.event.ActionEvent)>/simplejavacalculator.UI.writer/6	<simplejavacalculator.UI: void actionPerformed(java.awt.event.ActionEvent)>
<simplejavacalculator.UI: void init()>/javax.swing.JPanel.add/37	<simplejavacalculator.UI: void init()>
<simplejavacalculator.UI: void actionPerformed(java.awt.event.ActionEvent)>/simplejavacalculator.Calculator.calculateBi/2	<simplejavacalculator.UI: void actionPerformed(java.awt.event.ActionEvent)>
<simplejavacalculator.UI: void init()>/javax.swing.JPanel.add/4	<simplejavacalculator.UI: void init()>
<simplejavacalculator.UI: void init()>/javax.swing.JPanel.add/26	<simplejavacalculator.UI: void init()>
<simplejavacalculator.UI: void init()>/javax.swing.JButton.addActionListener/4	<simplejavacalculator.UI: void init()>
<simplejavacalculator.UI: void writer(java.lang.Double)>/java.lang.Double.doubleValue/1	<simplejavacalculator.UI: void writer(java.lang.Double)>
<simplejavacalculator.UI: void init()>/javax.swing.JPanel.add/23	<simplejavacalculator.UI: void init()>
<simplejavacalculator.UI: void init()>/javax.swing.JButton.setFont/8	<simplejavacalculator.UI: void init()>
<simplejavacalculator.UI: void init()>/javax.swing.JPanel.add/16	<simplejavacalculator.UI: void init()>
<simplejavacalculator.UI: void init()>/javax.swing.JPanel.add/8	<simplejavacalculator.UI: void init()>
<simplejavacalculator.UI: void init()>/javax.swing.JPanel.add/38	<simplejavacalculator.UI: void init()>
<simplejavacalculator.UI: void actionPerformed(java.awt.event.ActionEvent)>/simplejavacalculator.UI.writer/5	<simplejavacalculator.UI: void actionPerformed(java.awt.event.ActionEvent)>
<simplejavacalculator.UI: void init()>/javax.swing.ImageIcon.getImage/0	<simplejavacalculator.UI: void init()>
<simplejavacalculator.UI: void actionPerformed(java.awt.event.ActionEvent)>/simplejavacalculator.UI.writer/13	<simplejavacalculator.UI: void actionPerformed(java.awt.event.ActionEvent)>
<simplejavacalculator.UI: void init()>/javax.swing.JButton.addActionListener/11	<simplejavacalculator.UI: void init()>
<simplejavacalculator.UI: void init()>/javax.swing.JPanel.add/17	<simplejavacalculator.UI: void init()>
<simplejavacalculator.UI: void actionPerformed(java.awt.event.ActionEvent)>/simplejavacalculator.Calculator.calculateMono/4	<simplejavacalculator.UI: void actionPerformed(java.awt.event.ActionEvent)>
<simplejavacalculator.UI: void actionPerformed(java.awt.event.ActionEvent)>/simplejavacalculator.Calculator.calculateBi/4	<simplejavacalculator.UI: void actionPerformed(java.awt.event.ActionEvent)>
<simplejavacalculator.UI: void init()>/javax.swing.JPanel.add/0	<simplejavacalculator.UI: void init()>
<simplejavacalculator.UI: void init()>/javax.swing.JFrame.setLocationRelativeTo/0	<simplejavacalculator.UI: void init()>
<simplejavacalculator.UI: void init()>/javax.swing.JButton.setFont/9	<simplejavacalculator.UI: void init()>
<simplejavacalculator.UI: void actionPerformed(java.awt.event.ActionEvent)>/simplejavacalculator.UI.reader/9	<simplejavacalculator.UI: void actionPerformed(java.awt.event.ActionEvent)>
<simplejavacalculator.UI: void init()>/javax.swing.JButton.setFont/12	<simplejavacalculator.UI: void init()>
<simplejavacalculator.UI: void init()>/javax.swing.JFrame.setSize/0	<simplejavacalculator.UI: void init()>
<simplejavacalculator.UI: void init()>/javax.swing.JButton.setFont/16	<simplejavacalculator.UI: void init()>
<simplejavacalculator.UI: void init()>/javax.swing.JButton.setFont/7	<simplejavacalculator.UI: void init()>
<simplejavacalculator.UI: void init()>/javax.swing.JButton.addActionListener/8	<simplejavacalculator.UI: void init()>
<simplejavacalculator.UI: void actionPerformed(java.awt.event.ActionEvent)>/javax.swing.JTextArea.selectAll/0	<simplejavacalculator.UI: void actionPerformed(java.awt.event.ActionEvent)>
<simplejavacalculator.UI: void parsetoBinary()>/javax.swing.JTextArea.getText/0	<simplejavacalculator.UI: void parsetoBinary()>
<simplejavacalculator.UI: void writer(java.lang.Double)>/javax.swing.JTextArea.setText/1	<simplejavacalculator.UI: void writer(java.lang.Double)>
<simplejavacalculator.UI: void actionPerformed(java.awt.event.ActionEvent)>/simplejavacalculator.UI.writer/0	<simplejavacalculator.UI: void actionPerformed(java.awt.event.ActionEvent)>
<simplejavacalculator.UI: void parsetoBinary()>/java.lang.StringBuilder.append/3	<simplejavacalculator.UI: void parsetoBinary()>
<simplejavacalculator.UI: void parsetoBinary()>/java.lang.NumberFormatException.toString/0	<simplejavacalculator.UI: void parsetoBinary()>
<simplejavacalculator.UI: void init()>/javax.swing.JPanel.add/12	<simplejavacalculator.UI: void init()>
<simplejavacalculator.UI: void actionPerformed(java.awt.event.ActionEvent)>/simplejavacalculator.Calculator.calculateMono/1	<simplejavacalculator.UI: void actionPerformed(java.awt.event.ActionEvent)>
<simplejavacalculator.UI: void init()>/javax.swing.JFrame.setDefaultCloseOperation/0	<simplejavacalculator.UI: void init()>
<simplejavacalculator.Calculator: java.lang.Double calculateEqual(java.lang.Double)>/simplejavacalculator.Calculator.calculateBi/0	<simplejavacalculator.Calculator: java.lang.Double calculateEqual(java.lang.Double)>
<simplejavacalculator.UI: void init()>/javax.swing.JPanel.add/22	<simplejavacalculator.UI: void init()>
<simplejavacalculator.UI: void actionPerformed(java.awt.event.ActionEvent)>/simplejavacalculator.UI.reader/6	<simplejavacalculator.UI: void actionPerformed(java.awt.event.ActionEvent)>
<simplejavacalculator.UI: void parsetoBinary()>/java.lang.StringBuilder.append/1	<simplejavacalculator.UI: void parsetoBinary()>
<simplejavacalculator.UI: void init()>/javax.swing.JPanel.add/28	<simplejavacalculator.UI: void init()>
<simplejavacalculator.UI: void actionPerformed(java.awt.event.ActionEvent)>/simplejavacalculator.Calculator.calculateMono/5	<simplejavacalculator.UI: void actionPerformed(java.awt.event.ActionEvent)>
<simplejavacalculator.UI: void init()>/javax.swing.JButton.setFont/11	<simplejavacalculator.UI: void init()>
<simplejavacalculator.UI: void init()>/javax.swing.JButton.setFont/0	<simplejavacalculator.UI: void init()>
<simplejavacalculator.UI: void actionPerformed(java.awt.event.ActionEvent)>/simplejavacalculator.Calculator.calculateBi/1	<simplejavacalculator.UI: void actionPerformed(java.awt.event.ActionEvent)>
<simplejavacalculator.UI: void init()>/javax.swing.JButton.addActionListener/18	<simplejavacalculator.UI: void init()>
<simplejavacalculator.UI: void init()>/javax.swing.JButton.addActionListener/2	<simplejavacalculator.UI: void init()>
<simplejavacalculator.UI: void init()>/javax.swing.JPanel.add/7	<simplejavacalculator.UI: void init()>
<simplejavacalculator.UI: void init()>/javax.swing.JFrame.setVisible/0	<simplejavacalculator.UI: void init()>
<simplejavacalculator.UI: void actionPerformed(java.awt.event.ActionEvent)>/simplejavacalculator.UI.writer/4	<simplejavacalculator.UI: void actionPerformed(java.awt.event.ActionEvent)>
<simplejavacalculator.UI: void init()>/javax.swing.JButton.addActionListener/17	<simplejavacalculator.UI: void init()>
<simplejavacalculator.UI: void parsetoBinary()>/java.lang.StringBuilder.toString/0	<simplejavacalculator.UI: void parsetoBinary()>
<simplejavacalculator.UI: void init()>/javax.swing.JButton.addActionListener/10	<simplejavacalculator.UI: void init()>
<simplejavacalculator.UI: void writer(java.lang.Double)>/java.lang.Double.doubleValue/0	<simplejavacalculator.UI: void writer(java.lang.Double)>
<simplejavacalculator.UI: void actionPerformed(java.awt.event.ActionEvent)>/simplejavacalculator.UI.reader/4	<simplejavacalculator.UI: void actionPerformed(java.awt.event.ActionEvent)>
<simplejavacalculator.UI: void init()>/javax.swing.JFrame.add/0	<simplejavacalculator.UI: void init()>
<simplejavacalculator.UI: void actionPerformed(java.awt.event.ActionEvent)>/simplejavacalculator.Calculator.calculateBi/3	<simplejavacalculator.UI: void actionPerformed(java.awt.event.ActionEvent)>
<simplejavacalculator.UI: void init()>/javax.swing.JButton.setFont/14	<simplejavacalculator.UI: void init()>
<simplejavacalculator.UI: void actionPerformed(java.awt.event.ActionEvent)>/simplejavacalculator.UI.reader/10	<simplejavacalculator.UI: void actionPerformed(java.awt.event.ActionEvent)>
<simplejavacalculator.UI: void init()>/javax.swing.JPanel.add/31	<simplejavacalculator.UI: void init()>
<simplejavacalculator.UI: void actionPerformed(java.awt.event.ActionEvent)>/simplejavacalculator.UI.writer/2	<simplejavacalculator.UI: void actionPerformed(java.awt.event.ActionEvent)>
<simplejavacalculator.UI: void init()>/javax.swing.JButton.setFont/4	<simplejavacalculator.UI: void init()>
<simplejavacalculator.UI: void parsetoBinary()>/catch java.lang.NumberFormatException/0	<simplejavacalculator.UI: void parsetoBinary()>
<simplejavacalculator.Calculator: java.lang.Double reset()>/write-field-num1/0	<simplejavacalculator.Calculator: java.lang.Double reset()>
<simplejavacalculator.Calculator: java.lang.Double calculateBi(simplejavacalculator.Calculator$BiOperatorModes,java.lang.Double)>/write-field-num2/1	<simplejavacalculator.Calculator: java.lang.Double calculateBi(simplejavacalculator.Calculator$BiOperatorModes,java.lang.Double)>
<simplejavacalculator.UI: void <init>()>/write-field-butOneDevidedBy/0	<simplejavacalculator.UI: void <init>()>
<simplejavacalculator.UI: void <init>()>/write-field-butSquare/0	<simplejavacalculator.UI: void <init>()>
<simplejavacalculator.UI: void <init>()>/write-field-butMultiply/0	<simplejavacalculator.UI: void <init>()>
<simplejavacalculator.UI: void <init>()>/write-field-butMinus/0	<simplejavacalculator.UI: void <init>()>
<simplejavacalculator.UI: void <init>()>/write-field-butxpowerofy/0	<simplejavacalculator.UI: void <init>()>
<simplejavacalculator.UI: void <init>()>/write-field-butCos/0	<simplejavacalculator.UI: void <init>()>
<simplejavacalculator.UI: void <init>()>/write-field-buttonValue/0	<simplejavacalculator.UI: void <init>()>
<simplejavacalculator.UI: void <init>()>/write-field-butabs/0	<simplejavacalculator.UI: void <init>()>
<simplejavacalculator.Calculator: java.lang.Double reset()>/write-field-num2/0	<simplejavacalculator.Calculator: java.lang.Double reset()>
<simplejavacalculator.UI: void <init>()>/write-field-butDivide/0	<simplejavacalculator.UI: void <init>()>
<simplejavacalculator.UI: void <init>()>/write-field-butCancel/0	<simplejavacalculator.UI: void <init>()>
<simplejavacalculator.UI: void <init>()>/write-field-butSquareRoot/0	<simplejavacalculator.UI: void <init>()>
<simplejavacalculator.UI: void <init>()>/write-field-butrate/0	<simplejavacalculator.UI: void <init>()>
<simplejavacalculator.UI: void <init>()>/write-field-butEqual/0	<simplejavacalculator.UI: void <init>()>
<simplejavacalculator.Calculator: java.lang.Double calculateBi(simplejavacalculator.Calculator$BiOperatorModes,java.lang.Double)>/write-field-num2/0	<simplejavacalculator.Calculator: java.lang.Double calculateBi(simplejavacalculator.Calculator$BiOperatorModes,java.lang.Double)>
<simplejavacalculator.UI: void <init>()>/write-field-butBinary/0	<simplejavacalculator.UI: void <init>()>
<simplejavacalculator.UI: void <init>()>/write-field-butlog/0	<simplejavacalculator.UI: void <init>()>
<simplejavacalculator.Calculator: java.lang.Double calculateBi(simplejavacalculator.Calculator$BiOperatorModes,java.lang.Double)>/write-field-mode/1	<simplejavacalculator.Calculator: java.lang.Double calculateBi(simplejavacalculator.Calculator$BiOperatorModes,java.lang.Double)>
<simplejavacalculator.Calculator: java.lang.Double reset()>/write-field-mode/0	<simplejavacalculator.Calculator: java.lang.Double reset()>
<simplejavacalculator.Calculator: java.lang.Double calculateBi(simplejavacalculator.Calculator$BiOperatorModes,java.lang.Double)>/write-field-num1/1	<simplejavacalculator.Calculator: java.lang.Double calculateBi(simplejavacalculator.Calculator$BiOperatorModes,java.lang.Double)>
<simplejavacalculator.Calculator: void <init>()>/write-field-mode/0	<simplejavacalculator.Calculator: void <init>()>
<simplejavacalculator.UI: void <init>()>/write-field-panelSub8/0	<simplejavacalculator.UI: void <init>()>
<simplejavacalculator.UI: void <init>()>/write-field-panelSub4/0	<simplejavacalculator.UI: void <init>()>
<simplejavacalculator.UI: void <init>()>/write-field-calc/0	<simplejavacalculator.UI: void <init>()>
<simplejavacalculator.UI: void <init>()>/write-field-panelSub7/0	<simplejavacalculator.UI: void <init>()>
<simplejavacalculator.UI: void <init>()>/write-field-but/0	<simplejavacalculator.UI: void <init>()>
<simplejavacalculator.UI: void <init>()>/write-field-font/0	<simplejavacalculator.UI: void <init>()>
<simplejavacalculator.UI: void <init>()>/write-field-panelSub2/0	<simplejavacalculator.UI: void <init>()>
<simplejavacalculator.Calculator: java.lang.Double calculateBi(simplejavacalculator.Calculator$BiOperatorModes,java.lang.Double)>/write-field-mode/0	<simplejavacalculator.Calculator: java.lang.Double calculateBi(simplejavacalculator.Calculator$BiOperatorModes,java.lang.Double)>
<simplejavacalculator.UI: void <init>()>/write-field-panelSub1/0	<simplejavacalculator.UI: void <init>()>
<simplejavacalculator.UI: void <init>()>/write-field-image/0	<simplejavacalculator.UI: void <init>()>
<simplejavacalculator.UI: void <init>()>/write-field-panelSub6/0	<simplejavacalculator.UI: void <init>()>
<simplejavacalculator.UI: void <init>()>/write-field-textFont/0	<simplejavacalculator.UI: void <init>()>
<simplejavacalculator.UI: void <init>()>/write-field-butSin/0	<simplejavacalculator.UI: void <init>()>
<simplejavacalculator.UI: void <init>()>/write-field-panelSub5/0	<simplejavacalculator.UI: void <init>()>
<simplejavacalculator.UI: void <init>()>/write-field-frame/0	<simplejavacalculator.UI: void <init>()>
<simplejavacalculator.UI: void <init>()>/write-field-butTan/0	<simplejavacalculator.UI: void <init>()>
<simplejavacalculator.UI: void <init>()>/write-field-panel/0	<simplejavacalculator.UI: void <init>()>
<simplejavacalculator.UI: void <init>()>/write-field-text/0	<simplejavacalculator.UI: void <init>()>
<simplejavacalculator.UI: void <init>()>/write-field-panelSub3/0	<simplejavacalculator.UI: void <init>()>
<simplejavacalculator.UI: void <init>()>/write-field-butAdd/0	<simplejavacalculator.UI: void <init>()>
<simplejavacalculator.Calculator: java.lang.Double calculateBi(simplejavacalculator.Calculator$BiOperatorModes,java.lang.Double)>/write-field-num1/0	<simplejavacalculator.Calculator: java.lang.Double calculateBi(simplejavacalculator.Calculator$BiOperatorModes,java.lang.Double)>
<simplejavacalculator.Calculator$BiOperatorModes: void <clinit>()>/write-field-add/0	<simplejavacalculator.Calculator$BiOperatorModes: void <clinit>()>
<simplejavacalculator.Calculator$MonoOperatorModes: void <clinit>()>/write-field-tan/0	<simplejavacalculator.Calculator$MonoOperatorModes: void <clinit>()>
<simplejavacalculator.Calculator$BiOperatorModes: void <clinit>()>/write-field-divide/0	<simplejavacalculator.Calculator$BiOperatorModes: void <clinit>()>
<simplejavacalculator.Calculator$BiOperatorModes: void <clinit>()>/write-field-multiply/0	<simplejavacalculator.Calculator$BiOperatorModes: void <clinit>()>
<simplejavacalculator.Calculator$MonoOperatorModes: void <clinit>()>/write-field-log/0	<simplejavacalculator.Calculator$MonoOperatorModes: void <clinit>()>
<simplejavacalculator.Calculator$MonoOperatorModes: void <clinit>()>/write-field-square/0	<simplejavacalculator.Calculator$MonoOperatorModes: void <clinit>()>
<simplejavacalculator.Calculator$BiOperatorModes: void <clinit>()>/write-field-normal/0	<simplejavacalculator.Calculator$BiOperatorModes: void <clinit>()>
<simplejavacalculator.Calculator$BiOperatorModes: void <clinit>()>/write-field-$VALUES/0	<simplejavacalculator.Calculator$BiOperatorModes: void <clinit>()>
<simplejavacalculator.Calculator$MonoOperatorModes: void <clinit>()>/write-field-oneDevidedBy/0	<simplejavacalculator.Calculator$MonoOperatorModes: void <clinit>()>
<simplejavacalculator.Calculator$MonoOperatorModes: void <clinit>()>/write-field-rate/0	<simplejavacalculator.Calculator$MonoOperatorModes: void <clinit>()>
<simplejavacalculator.Calculator$MonoOperatorModes: void <clinit>()>/write-field-sin/0	<simplejavacalculator.Calculator$MonoOperatorModes: void <clinit>()>
<simplejavacalculator.Calculator$BiOperatorModes: void <clinit>()>/write-field-minus/0	<simplejavacalculator.Calculator$BiOperatorModes: void <clinit>()>
<simplejavacalculator.Calculator$MonoOperatorModes: void <clinit>()>/write-field-squareRoot/0	<simplejavacalculator.Calculator$MonoOperatorModes: void <clinit>()>
<simplejavacalculator.Calculator$MonoOperatorModes: void <clinit>()>/write-field-cos/0	<simplejavacalculator.Calculator$MonoOperatorModes: void <clinit>()>
<simplejavacalculator.Calculator$MonoOperatorModes: void <clinit>()>/write-field-abs/0	<simplejavacalculator.Calculator$MonoOperatorModes: void <clinit>()>
<simplejavacalculator.Calculator$MonoOperatorModes: void <clinit>()>/write-field-$VALUES/0	<simplejavacalculator.Calculator$MonoOperatorModes: void <clinit>()>
<simplejavacalculator.Calculator$BiOperatorModes: void <clinit>()>/write-field-xpowerofy/0	<simplejavacalculator.Calculator$BiOperatorModes: void <clinit>()>
<simplejavacalculator.Calculator$BiOperatorModes: void <clinit>()>/read-field-xpowerofy/0	<simplejavacalculator.Calculator$BiOperatorModes: void <clinit>()>
<simplejavacalculator.UI: void actionPerformed(java.awt.event.ActionEvent)>/read-field-sin/0	<simplejavacalculator.UI: void actionPerformed(java.awt.event.ActionEvent)>
<simplejavacalculator.Calculator: java.lang.Double calculateMono(simplejavacalculator.Calculator$MonoOperatorModes,java.lang.Double)>/read-field-square/0	<simplejavacalculator.Calculator: java.lang.Double calculateMono(simplejavacalculator.Calculator$MonoOperatorModes,java.lang.Double)>
<simplejavacalculator.Calculator: java.lang.Double calculateMono(simplejavacalculator.Calculator$MonoOperatorModes,java.lang.Double)>/read-field-abs/0	<simplejavacalculator.Calculator: java.lang.Double calculateMono(simplejavacalculator.Calculator$MonoOperatorModes,java.lang.Double)>
<simplejavacalculator.Calculator: java.lang.Double calculateBiImpl()>/read-field-add/0	<simplejavacalculator.Calculator: java.lang.Double calculateBiImpl()>
<simplejavacalculator.Calculator: java.lang.Double calculateMono(simplejavacalculator.Calculator$MonoOperatorModes,java.lang.Double)>/read-field-oneDevidedBy/0	<simplejavacalculator.Calculator: java.lang.Double calculateMono(simplejavacalculator.Calculator$MonoOperatorModes,java.lang.Double)>
<simplejavacalculator.Calculator: java.lang.Double calculateBi(simplejavacalculator.Calculator$BiOperatorModes,java.lang.Double)>/read-field-normal/0	<simplejavacalculator.Calculator: java.lang.Double calculateBi(simplejavacalculator.Calculator$BiOperatorModes,java.lang.Double)>
<simplejavacalculator.Calculator: java.lang.Double calculateBiImpl()>/read-field-normal/0	<simplejavacalculator.Calculator: java.lang.Double calculateBiImpl()>
<simplejavacalculator.Calculator: java.lang.Double calculateMono(simplejavacalculator.Calculator$MonoOperatorModes,java.lang.Double)>/read-field-sin/0	<simplejavacalculator.Calculator: java.lang.Double calculateMono(simplejavacalculator.Calculator$MonoOperatorModes,java.lang.Double)>
<simplejavacalculator.Calculator: java.lang.Double reset()>/read-field-normal/0	<simplejavacalculator.Calculator: java.lang.Double reset()>
<simplejavacalculator.Calculator: java.lang.Double calculateBiImpl()>/read-field-divide/0	<simplejavacalculator.Calculator: java.lang.Double calculateBiImpl()>
<simplejavacalculator.Calculator$BiOperatorModes: void <clinit>()>/read-field-minus/0	<simplejavacalculator.Calculator$BiOperatorModes: void <clinit>()>
<simplejavacalculator.Calculator$BiOperatorModes: simplejavacalculator.Calculator$BiOperatorModes[] values()>/read-field-$VALUES/0	<simplejavacalculator.Calculator$BiOperatorModes: simplejavacalculator.Calculator$BiOperatorModes[] values()>
<simplejavacalculator.Calculator$MonoOperatorModes: void <clinit>()>/read-field-oneDevidedBy/0	<simplejavacalculator.Calculator$MonoOperatorModes: void <clinit>()>
<simplejavacalculator.UI: void actionPerformed(java.awt.event.ActionEvent)>/read-field-log/0	<simplejavacalculator.UI: void actionPerformed(java.awt.event.ActionEvent)>
<simplejavacalculator.Calculator: java.lang.Double calculateEqual(java.lang.Double)>/read-field-normal/0	<simplejavacalculator.Calculator: java.lang.Double calculateEqual(java.lang.Double)>
<simplejavacalculator.UI: void actionPerformed(java.awt.event.ActionEvent)>/read-field-squareRoot/0	<simplejavacalculator.UI: void actionPerformed(java.awt.event.ActionEvent)>
<simplejavacalculator.UI: void actionPerformed(java.awt.event.ActionEvent)>/read-field-add/0	<simplejavacalculator.UI: void actionPerformed(java.awt.event.ActionEvent)>
<simplejavacalculator.Calculator$MonoOperatorModes: void <clinit>()>/read-field-tan/0	<simplejavacalculator.Calculator$MonoOperatorModes: void <clinit>()>
<simplejavacalculator.UI: void actionPerformed(java.awt.event.ActionEvent)>/read-field-abs/0	<simplejavacalculator.UI: void actionPerformed(java.awt.event.ActionEvent)>
<simplejavacalculator.Calculator: java.lang.Double calculateMono(simplejavacalculator.Calculator$MonoOperatorModes,java.lang.Double)>/read-field-squareRoot/0	<simplejavacalculator.Calculator: java.lang.Double calculateMono(simplejavacalculator.Calculator$MonoOperatorModes,java.lang.Double)>
<simplejavacalculator.Calculator$MonoOperatorModes: void <clinit>()>/read-field-sin/0	<simplejavacalculator.Calculator$MonoOperatorModes: void <clinit>()>
<simplejavacalculator.UI: void actionPerformed(java.awt.event.ActionEvent)>/read-field-square/0	<simplejavacalculator.UI: void actionPerformed(java.awt.event.ActionEvent)>
<simplejavacalculator.Calculator$MonoOperatorModes: void <clinit>()>/read-field-cos/0	<simplejavacalculator.Calculator$MonoOperatorModes: void <clinit>()>
<simplejavacalculator.Calculator: java.lang.Double calculateBiImpl()>/read-field-minus/0	<simplejavacalculator.Calculator: java.lang.Double calculateBiImpl()>
<simplejavacalculator.UI: void actionPerformed(java.awt.event.ActionEvent)>/read-field-xpowerofy/0	<simplejavacalculator.UI: void actionPerformed(java.awt.event.ActionEvent)>
<simplejavacalculator.Calculator$BiOperatorModes: void <clinit>()>/read-field-multiply/0	<simplejavacalculator.Calculator$BiOperatorModes: void <clinit>()>
<simplejavacalculator.Calculator: void <init>()>/read-field-normal/0	<simplejavacalculator.Calculator: void <init>()>
<simplejavacalculator.Calculator$MonoOperatorModes: void <clinit>()>/read-field-abs/0	<simplejavacalculator.Calculator$MonoOperatorModes: void <clinit>()>
<simplejavacalculator.Calculator$MonoOperatorModes: void <clinit>()>/read-field-squareRoot/0	<simplejavacalculator.Calculator$MonoOperatorModes: void <clinit>()>
<simplejavacalculator.Calculator$MonoOperatorModes: void <clinit>()>/read-field-rate/0	<simplejavacalculator.Calculator$MonoOperatorModes: void <clinit>()>
<simplejavacalculator.Calculator: java.lang.Double calculateMono(simplejavacalculator.Calculator$MonoOperatorModes,java.lang.Double)>/read-field-rate/0	<simplejavacalculator.Calculator: java.lang.Double calculateMono(simplejavacalculator.Calculator$MonoOperatorModes,java.lang.Double)>
<simplejavacalculator.Calculator$MonoOperatorModes: void <clinit>()>/read-field-log/0	<simplejavacalculator.Calculator$MonoOperatorModes: void <clinit>()>
<simplejavacalculator.UI: void actionPerformed(java.awt.event.ActionEvent)>/read-field-multiply/0	<simplejavacalculator.UI: void actionPerformed(java.awt.event.ActionEvent)>
<simplejavacalculator.UI: void actionPerformed(java.awt.event.ActionEvent)>/read-field-divide/0	<simplejavacalculator.UI: void actionPerformed(java.awt.event.ActionEvent)>
<simplejavacalculator.UI: void actionPerformed(java.awt.event.ActionEvent)>/read-field-rate/0	<simplejavacalculator.UI: void actionPerformed(java.awt.event.ActionEvent)>
<simplejavacalculator.UI: void actionPerformed(java.awt.event.ActionEvent)>/read-field-cos/0	<simplejavacalculator.UI: void actionPerformed(java.awt.event.ActionEvent)>
<simplejavacalculator.UI: void actionPerformed(java.awt.event.ActionEvent)>/read-field-oneDevidedBy/0	<simplejavacalculator.UI: void actionPerformed(java.awt.event.ActionEvent)>
<simplejavacalculator.Calculator$MonoOperatorModes: simplejavacalculator.Calculator$MonoOperatorModes[] values()>/read-field-$VALUES/0	<simplejavacalculator.Calculator$MonoOperatorModes: simplejavacalculator.Calculator$MonoOperatorModes[] values()>
<simplejavacalculator.Calculator: java.lang.Double calculateMono(simplejavacalculator.Calculator$MonoOperatorModes,java.lang.Double)>/read-field-cos/0	<simplejavacalculator.Calculator: java.lang.Double calculateMono(simplejavacalculator.Calculator$MonoOperatorModes,java.lang.Double)>
<simplejavacalculator.Calculator: java.lang.Double calculateMono(simplejavacalculator.Calculator$MonoOperatorModes,java.lang.Double)>/read-field-tan/0	<simplejavacalculator.Calculator: java.lang.Double calculateMono(simplejavacalculator.Calculator$MonoOperatorModes,java.lang.Double)>
<simplejavacalculator.Calculator: java.lang.Double calculateBiImpl()>/read-field-xpowerofy/0	<simplejavacalculator.Calculator: java.lang.Double calculateBiImpl()>
<simplejavacalculator.Calculator: java.lang.Double calculateBiImpl()>/read-field-multiply/0	<simplejavacalculator.Calculator: java.lang.Double calculateBiImpl()>
<simplejavacalculator.Calculator$BiOperatorModes: void <clinit>()>/read-field-add/0	<simplejavacalculator.Calculator$BiOperatorModes: void <clinit>()>
<simplejavacalculator.UI: void actionPerformed(java.awt.event.ActionEvent)>/read-field-minus/0	<simplejavacalculator.UI: void actionPerformed(java.awt.event.ActionEvent)>
<simplejavacalculator.UI: void actionPerformed(java.awt.event.ActionEvent)>/read-field-tan/0	<simplejavacalculator.UI: void actionPerformed(java.awt.event.ActionEvent)>
<simplejavacalculator.Calculator$BiOperatorModes: void <clinit>()>/read-field-divide/0	<simplejavacalculator.Calculator$BiOperatorModes: void <clinit>()>
<simplejavacalculator.Calculator$BiOperatorModes: void <clinit>()>/read-field-normal/0	<simplejavacalculator.Calculator$BiOperatorModes: void <clinit>()>
<simplejavacalculator.Calculator: java.lang.Double calculateMono(simplejavacalculator.Calculator$MonoOperatorModes,java.lang.Double)>/read-field-log/0	<simplejavacalculator.Calculator: java.lang.Double calculateMono(simplejavacalculator.Calculator$MonoOperatorModes,java.lang.Double)>
<simplejavacalculator.Calculator$MonoOperatorModes: void <clinit>()>/read-field-square/0	<simplejavacalculator.Calculator$MonoOperatorModes: void <clinit>()>
<simplejavacalculator.UI: void parsetoBinary()>/read-field-err/0	<simplejavacalculator.UI: void parsetoBinary()>
<simplejavacalculator.UI: void <init>()>/write-array-idx/3	<simplejavacalculator.UI: void <init>()>
<simplejavacalculator.UI: void <init>()>/write-array-idx/1	<simplejavacalculator.UI: void <init>()>
<simplejavacalculator.Calculator$MonoOperatorModes: void <clinit>()>/write-array-idx/6	<simplejavacalculator.Calculator$MonoOperatorModes: void <clinit>()>
<simplejavacalculator.Calculator$MonoOperatorModes: void <clinit>()>/write-array-idx/2	<simplejavacalculator.Calculator$MonoOperatorModes: void <clinit>()>
<simplejavacalculator.Calculator$BiOperatorModes: void <clinit>()>/write-array-idx/2	<simplejavacalculator.Calculator$BiOperatorModes: void <clinit>()>
<simplejavacalculator.UI: void <init>()>/write-array-idx/8	<simplejavacalculator.UI: void <init>()>
<simplejavacalculator.Calculator$MonoOperatorModes: void <clinit>()>/write-array-idx/3	<simplejavacalculator.Calculator$MonoOperatorModes: void <clinit>()>
<simplejavacalculator.Calculator$BiOperatorModes: void <clinit>()>/write-array-idx/4	<simplejavacalculator.Calculator$BiOperatorModes: void <clinit>()>
<simplejavacalculator.Calculator$BiOperatorModes: void <clinit>()>/write-array-idx/0	<simplejavacalculator.Calculator$BiOperatorModes: void <clinit>()>
<simplejavacalculator.UI: void <init>()>/write-array-idx/5	<simplejavacalculator.UI: void <init>()>
<simplejavacalculator.UI: void <init>()>/write-array-idx/4	<simplejavacalculator.UI: void <init>()>
<simplejavacalculator.Calculator$BiOperatorModes: void <clinit>()>/write-array-idx/3	<simplejavacalculator.Calculator$BiOperatorModes: void <clinit>()>
<simplejavacalculator.UI: void <init>()>/write-array-idx/0	<simplejavacalculator.UI: void <init>()>
<simplejavacalculator.Calculator$MonoOperatorModes: void <clinit>()>/write-array-idx/7	<simplejavacalculator.Calculator$MonoOperatorModes: void <clinit>()>
<simplejavacalculator.Calculator$MonoOperatorModes: void <clinit>()>/write-array-idx/0	<simplejavacalculator.Calculator$MonoOperatorModes: void <clinit>()>
<simplejavacalculator.Calculator$MonoOperatorModes: void <clinit>()>/write-array-idx/4	<simplejavacalculator.Calculator$MonoOperatorModes: void <clinit>()>
<simplejavacalculator.Calculator$MonoOperatorModes: void <clinit>()>/write-array-idx/1	<simplejavacalculator.Calculator$MonoOperatorModes: void <clinit>()>
<simplejavacalculator.Calculator$BiOperatorModes: void <clinit>()>/write-array-idx/1	<simplejavacalculator.Calculator$BiOperatorModes: void <clinit>()>
<simplejavacalculator.Calculator$BiOperatorModes: void <clinit>()>/write-array-idx/5	<simplejavacalculator.Calculator$BiOperatorModes: void <clinit>()>
<simplejavacalculator.UI: void <init>()>/write-array-idx/6	<simplejavacalculator.UI: void <init>()>
<simplejavacalculator.Calculator$MonoOperatorModes: void <clinit>()>/write-array-idx/5	<simplejavacalculator.Calculator$MonoOperatorModes: void <clinit>()>
<simplejavacalculator.Calculator$MonoOperatorModes: void <clinit>()>/write-array-idx/8	<simplejavacalculator.Calculator$MonoOperatorModes: void <clinit>()>
<simplejavacalculator.UI: void <init>()>/write-array-idx/7	<simplejavacalculator.UI: void <init>()>
<simplejavacalculator.UI: void <init>()>/write-array-idx/2	<simplejavacalculator.UI: void <init>()>
<simplejavacalculator.UI: void <init>()>/write-array-idx/9	<simplejavacalculator.UI: void <init>()>
<simplejavacalculator.UI: void <init>()>/write-array-idx/10	<simplejavacalculator.UI: void <init>()>
<simplejavacalculator.UI: void init()>/read-array-idx/7	<simplejavacalculator.UI: void init()>
<simplejavacalculator.UI: void init()>/read-array-idx/4	<simplejavacalculator.UI: void init()>
<simplejavacalculator.UI: void init()>/read-array-idx/2	<simplejavacalculator.UI: void init()>
<simplejavacalculator.UI: void init()>/read-array-idx/3	<simplejavacalculator.UI: void init()>
<simplejavacalculator.UI: void actionPerformed(java.awt.event.ActionEvent)>/read-array-idx/0	<simplejavacalculator.UI: void actionPerformed(java.awt.event.ActionEvent)>
<simplejavacalculator.UI: void init()>/read-array-idx/6	<simplejavacalculator.UI: void init()>
<simplejavacalculator.UI: void init()>/read-array-idx/11	<simplejavacalculator.UI: void init()>
<simplejavacalculator.UI: void init()>/read-array-idx/9	<simplejavacalculator.UI: void init()>
<simplejavacalculator.UI: void init()>/read-array-idx/10	<simplejavacalculator.UI: void init()>
<simplejavacalculator.UI: void init()>/read-array-idx/12	<simplejavacalculator.UI: void init()>
<simplejavacalculator.UI: void init()>/read-array-idx/8	<simplejavacalculator.UI: void init()>
<simplejavacalculator.UI: void actionPerformed(java.awt.event.ActionEvent)>/read-array-idx/1	<simplejavacalculator.UI: void actionPerformed(java.awt.event.ActionEvent)>
<simplejavacalculator.UI: void init()>/read-array-idx/0	<simplejavacalculator.UI: void init()>
<simplejavacalculator.UI: void init()>/read-array-idx/5	<simplejavacalculator.UI: void init()>
<simplejavacalculator.UI: void init()>/read-array-idx/1	<simplejavacalculator.UI: void init()>
<simplejavacalculator.UI: void init()>/goto/1	<simplejavacalculator.UI: void init()>
<simplejavacalculator.UI: void actionPerformed(java.awt.event.ActionEvent)>/goto/0	<simplejavacalculator.UI: void actionPerformed(java.awt.event.ActionEvent)>
<simplejavacalculator.UI: void parsetoBinary()>/goto/0	<simplejavacalculator.UI: void parsetoBinary()>
<simplejavacalculator.UI: void writer(java.lang.Double)>/goto/0	<simplejavacalculator.UI: void writer(java.lang.Double)>
<simplejavacalculator.UI: void init()>/goto/0	<simplejavacalculator.UI: void init()>
<simplejavacalculator.UI: void <init>()>/goto/0	<simplejavacalculator.UI: void <init>()>
<simplejavacalculator.Calculator: java.lang.Double calculateBiImpl()>/if/0	<simplejavacalculator.Calculator: java.lang.Double calculateBiImpl()>
<simplejavacalculator.Calculator: java.lang.Double calculateMono(simplejavacalculator.Calculator$MonoOperatorModes,java.lang.Double)>/if/9	<simplejavacalculator.Calculator: java.lang.Double calculateMono(simplejavacalculator.Calculator$MonoOperatorModes,java.lang.Double)>
<simplejavacalculator.Calculator: java.lang.Double calculateMono(simplejavacalculator.Calculator$MonoOperatorModes,java.lang.Double)>/if/3	<simplejavacalculator.Calculator: java.lang.Double calculateMono(simplejavacalculator.Calculator$MonoOperatorModes,java.lang.Double)>
<simplejavacalculator.UI: void actionPerformed(java.awt.event.ActionEvent)>/if/4	<simplejavacalculator.UI: void actionPerformed(java.awt.event.ActionEvent)>
<simplejavacalculator.UI: void actionPerformed(java.awt.event.ActionEvent)>/if/11	<simplejavacalculator.UI: void actionPerformed(java.awt.event.ActionEvent)>
<simplejavacalculator.UI: void actionPerformed(java.awt.event.ActionEvent)>/if/17	<simplejavacalculator.UI: void actionPerformed(java.awt.event.ActionEvent)>
<simplejavacalculator.UI: void actionPerformed(java.awt.event.ActionEvent)>/if/2	<simplejavacalculator.UI: void actionPerformed(java.awt.event.ActionEvent)>
<simplejavacalculator.UI: void actionPerformed(java.awt.event.ActionEvent)>/if/0	<simplejavacalculator.UI: void actionPerformed(java.awt.event.ActionEvent)>
<simplejavacalculator.Calculator: java.lang.Double calculateMono(simplejavacalculator.Calculator$MonoOperatorModes,java.lang.Double)>/if/2	<simplejavacalculator.Calculator: java.lang.Double calculateMono(simplejavacalculator.Calculator$MonoOperatorModes,java.lang.Double)>
<simplejavacalculator.Calculator: java.lang.Double calculateMono(simplejavacalculator.Calculator$MonoOperatorModes,java.lang.Double)>/if/5	<simplejavacalculator.Calculator: java.lang.Double calculateMono(simplejavacalculator.Calculator$MonoOperatorModes,java.lang.Double)>
<simplejavacalculator.UI: void actionPerformed(java.awt.event.ActionEvent)>/if/13	<simplejavacalculator.UI: void actionPerformed(java.awt.event.ActionEvent)>
<simplejavacalculator.Calculator: java.lang.Double calculateMono(simplejavacalculator.Calculator$MonoOperatorModes,java.lang.Double)>/if/6	<simplejavacalculator.Calculator: java.lang.Double calculateMono(simplejavacalculator.Calculator$MonoOperatorModes,java.lang.Double)>
<simplejavacalculator.Calculator: java.lang.Double calculateBi(simplejavacalculator.Calculator$BiOperatorModes,java.lang.Double)>/if/0	<simplejavacalculator.Calculator: java.lang.Double calculateBi(simplejavacalculator.Calculator$BiOperatorModes,java.lang.Double)>
<simplejavacalculator.UI: void actionPerformed(java.awt.event.ActionEvent)>/if/15	<simplejavacalculator.UI: void actionPerformed(java.awt.event.ActionEvent)>
<simplejavacalculator.Calculator: java.lang.Double calculateMono(simplejavacalculator.Calculator$MonoOperatorModes,java.lang.Double)>/if/10	<simplejavacalculator.Calculator: java.lang.Double calculateMono(simplejavacalculator.Calculator$MonoOperatorModes,java.lang.Double)>
<simplejavacalculator.UI: void actionPerformed(java.awt.event.ActionEvent)>/if/10	<simplejavacalculator.UI: void actionPerformed(java.awt.event.ActionEvent)>
<simplejavacalculator.UI: void init()>/if/0	<simplejavacalculator.UI: void init()>
<simplejavacalculator.UI: void actionPerformed(java.awt.event.ActionEvent)>/if/8	<simplejavacalculator.UI: void actionPerformed(java.awt.event.ActionEvent)>
<simplejavacalculator.Calculator: java.lang.Double calculateBiImpl()>/if/6	<simplejavacalculator.Calculator: java.lang.Double calculateBiImpl()>
<simplejavacalculator.UI: void actionPerformed(java.awt.event.ActionEvent)>/if/18	<simplejavacalculator.UI: void actionPerformed(java.awt.event.ActionEvent)>
<simplejavacalculator.UI: void actionPerformed(java.awt.event.ActionEvent)>/if/5	<simplejavacalculator.UI: void actionPerformed(java.awt.event.ActionEvent)>
<simplejavacalculator.Calculator: java.lang.Double calculateBiImpl()>/if/2	<simplejavacalculator.Calculator: java.lang.Double calculateBiImpl()>
<simplejavacalculator.UI: void actionPerformed(java.awt.event.ActionEvent)>/if/6	<simplejavacalculator.UI: void actionPerformed(java.awt.event.ActionEvent)>
<simplejavacalculator.Calculator: java.lang.Double calculateBiImpl()>/if/4	<simplejavacalculator.Calculator: java.lang.Double calculateBiImpl()>
<simplejavacalculator.UI: void writer(java.lang.Double)>/if/0	<simplejavacalculator.UI: void writer(java.lang.Double)>
<simplejavacalculator.Calculator: java.lang.Double calculateMono(simplejavacalculator.Calculator$MonoOperatorModes,java.lang.Double)>/if/1	<simplejavacalculator.Calculator: java.lang.Double calculateMono(simplejavacalculator.Calculator$MonoOperatorModes,java.lang.Double)>
<simplejavacalculator.UI: void actionPerformed(java.awt.event.ActionEvent)>/if/3	<simplejavacalculator.UI: void actionPerformed(java.awt.event.ActionEvent)>
<simplejavacalculator.Calculator: java.lang.Double calculateMono(simplejavacalculator.Calculator$MonoOperatorModes,java.lang.Double)>/if/12	<simplejavacalculator.Calculator: java.lang.Double calculateMono(simplejavacalculator.Calculator$MonoOperatorModes,java.lang.Double)>
<simplejavacalculator.Calculator: java.lang.Double calculateMono(simplejavacalculator.Calculator$MonoOperatorModes,java.lang.Double)>/if/7	<simplejavacalculator.Calculator: java.lang.Double calculateMono(simplejavacalculator.Calculator$MonoOperatorModes,java.lang.Double)>
<simplejavacalculator.UI: void actionPerformed(java.awt.event.ActionEvent)>/if/14	<simplejavacalculator.UI: void actionPerformed(java.awt.event.ActionEvent)>
<simplejavacalculator.Calculator: java.lang.Double calculateBiImpl()>/if/5	<simplejavacalculator.Calculator: java.lang.Double calculateBiImpl()>
<simplejavacalculator.UI: void actionPerformed(java.awt.event.ActionEvent)>/if/7	<simplejavacalculator.UI: void actionPerformed(java.awt.event.ActionEvent)>
<simplejavacalculator.Calculator: java.lang.Double calculateMono(simplejavacalculator.Calculator$MonoOperatorModes,java.lang.Double)>/if/8	<simplejavacalculator.Calculator: java.lang.Double calculateMono(simplejavacalculator.Calculator$MonoOperatorModes,java.lang.Double)>
<simplejavacalculator.Calculator: java.lang.Double calculateMono(simplejavacalculator.Calculator$MonoOperatorModes,java.lang.Double)>/if/4	<simplejavacalculator.Calculator: java.lang.Double calculateMono(simplejavacalculator.Calculator$MonoOperatorModes,java.lang.Double)>
<simplejavacalculator.UI: void actionPerformed(java.awt.event.ActionEvent)>/if/1	<simplejavacalculator.UI: void actionPerformed(java.awt.event.ActionEvent)>
<simplejavacalculator.Calculator: java.lang.Double calculateBiImpl()>/if/1	<simplejavacalculator.Calculator: java.lang.Double calculateBiImpl()>
<simplejavacalculator.UI: void actionPerformed(java.awt.event.ActionEvent)>/if/16	<simplejavacalculator.UI: void actionPerformed(java.awt.event.ActionEvent)>
<simplejavacalculator.Calculator: java.lang.Double calculateMono(simplejavacalculator.Calculator$MonoOperatorModes,java.lang.Double)>/if/0	<simplejavacalculator.Calculator: java.lang.Double calculateMono(simplejavacalculator.Calculator$MonoOperatorModes,java.lang.Double)>
<simplejavacalculator.UI: void actionPerformed(java.awt.event.ActionEvent)>/if/12	<simplejavacalculator.UI: void actionPerformed(java.awt.event.ActionEvent)>
<simplejavacalculator.UI: void init()>/if/1	<simplejavacalculator.UI: void init()>
<simplejavacalculator.Calculator: java.lang.Double calculateBiImpl()>/if/3	<simplejavacalculator.Calculator: java.lang.Double calculateBiImpl()>
<simplejavacalculator.Calculator: java.lang.Double calculateMono(simplejavacalculator.Calculator$MonoOperatorModes,java.lang.Double)>/if/11	<simplejavacalculator.Calculator: java.lang.Double calculateMono(simplejavacalculator.Calculator$MonoOperatorModes,java.lang.Double)>
<simplejavacalculator.UI: void actionPerformed(java.awt.event.ActionEvent)>/if/9	<simplejavacalculator.UI: void actionPerformed(java.awt.event.ActionEvent)>
<simplejavacalculator.UI: void <init>()>/if/0	<simplejavacalculator.UI: void <init>()>
<simplejavacalculator.Calculator: java.lang.Double calculateMono(simplejavacalculator.Calculator$MonoOperatorModes,java.lang.Double)>/return/3	<simplejavacalculator.Calculator: java.lang.Double calculateMono(simplejavacalculator.Calculator$MonoOperatorModes,java.lang.Double)>
<simplejavacalculator.Calculator: java.lang.Double calculateBiImpl()>/return/5	<simplejavacalculator.Calculator: java.lang.Double calculateBiImpl()>
<simplejavacalculator.Calculator: java.lang.Double calculateMono(simplejavacalculator.Calculator$MonoOperatorModes,java.lang.Double)>/return/0	<simplejavacalculator.Calculator: java.lang.Double calculateMono(simplejavacalculator.Calculator$MonoOperatorModes,java.lang.Double)>
<simplejavacalculator.Calculator: java.lang.Double calculateBiImpl()>/return/0	<simplejavacalculator.Calculator: java.lang.Double calculateBiImpl()>
<simplejavacalculator.Calculator: java.lang.Double reset()>/return/0	<simplejavacalculator.Calculator: java.lang.Double reset()>
<simplejavacalculator.Calculator: java.lang.Double calculateBiImpl()>/return/4	<simplejavacalculator.Calculator: java.lang.Double calculateBiImpl()>
<simplejavacalculator.Calculator: java.lang.Double calculateMono(simplejavacalculator.Calculator$MonoOperatorModes,java.lang.Double)>/return/7	<simplejavacalculator.Calculator: java.lang.Double calculateMono(simplejavacalculator.Calculator$MonoOperatorModes,java.lang.Double)>
<simplejavacalculator.Calculator: java.lang.Double calculateMono(simplejavacalculator.Calculator$MonoOperatorModes,java.lang.Double)>/return/5	<simplejavacalculator.Calculator: java.lang.Double calculateMono(simplejavacalculator.Calculator$MonoOperatorModes,java.lang.Double)>
<simplejavacalculator.Calculator: java.lang.Double calculateMono(simplejavacalculator.Calculator$MonoOperatorModes,java.lang.Double)>/return/4	<simplejavacalculator.Calculator: java.lang.Double calculateMono(simplejavacalculator.Calculator$MonoOperatorModes,java.lang.Double)>
<simplejavacalculator.Calculator: java.lang.Double calculateBiImpl()>/return/1	<simplejavacalculator.Calculator: java.lang.Double calculateBiImpl()>
<simplejavacalculator.Calculator: java.lang.Double calculateBiImpl()>/return/2	<simplejavacalculator.Calculator: java.lang.Double calculateBiImpl()>
<simplejavacalculator.Calculator: java.lang.Double calculateBi(simplejavacalculator.Calculator$BiOperatorModes,java.lang.Double)>/return/0	<simplejavacalculator.Calculator: java.lang.Double calculateBi(simplejavacalculator.Calculator$BiOperatorModes,java.lang.Double)>
<simplejavacalculator.Calculator: java.lang.Double calculateMono(simplejavacalculator.Calculator$MonoOperatorModes,java.lang.Double)>/return/1	<simplejavacalculator.Calculator: java.lang.Double calculateMono(simplejavacalculator.Calculator$MonoOperatorModes,java.lang.Double)>
<simplejavacalculator.Calculator$BiOperatorModes: simplejavacalculator.Calculator$BiOperatorModes[] values()>/return/0	<simplejavacalculator.Calculator$BiOperatorModes: simplejavacalculator.Calculator$BiOperatorModes[] values()>
<simplejavacalculator.Calculator: java.lang.Double calculateMono(simplejavacalculator.Calculator$MonoOperatorModes,java.lang.Double)>/return/6	<simplejavacalculator.Calculator: java.lang.Double calculateMono(simplejavacalculator.Calculator$MonoOperatorModes,java.lang.Double)>
<simplejavacalculator.Calculator: java.lang.Double calculateBi(simplejavacalculator.Calculator$BiOperatorModes,java.lang.Double)>/return/1	<simplejavacalculator.Calculator: java.lang.Double calculateBi(simplejavacalculator.Calculator$BiOperatorModes,java.lang.Double)>
<simplejavacalculator.Calculator: java.lang.Double calculateEqual(java.lang.Double)>/return/0	<simplejavacalculator.Calculator: java.lang.Double calculateEqual(java.lang.Double)>
<simplejavacalculator.Calculator: java.lang.Double calculateMono(simplejavacalculator.Calculator$MonoOperatorModes,java.lang.Double)>/return/8	<simplejavacalculator.Calculator: java.lang.Double calculateMono(simplejavacalculator.Calculator$MonoOperatorModes,java.lang.Double)>
<simplejavacalculator.Calculator: java.lang.Double calculateBiImpl()>/return/6	<simplejavacalculator.Calculator: java.lang.Double calculateBiImpl()>
<simplejavacalculator.Calculator: java.lang.Double calculateMono(simplejavacalculator.Calculator$MonoOperatorModes,java.lang.Double)>/return/2	<simplejavacalculator.Calculator: java.lang.Double calculateMono(simplejavacalculator.Calculator$MonoOperatorModes,java.lang.Double)>
<simplejavacalculator.Calculator: java.lang.Double calculateMono(simplejavacalculator.Calculator$MonoOperatorModes,java.lang.Double)>/return/9	<simplejavacalculator.Calculator: java.lang.Double calculateMono(simplejavacalculator.Calculator$MonoOperatorModes,java.lang.Double)>
<simplejavacalculator.Calculator: java.lang.Double calculateBiImpl()>/return/3	<simplejavacalculator.Calculator: java.lang.Double calculateBiImpl()>
<simplejavacalculator.Calculator: java.lang.Double calculateMono(simplejavacalculator.Calculator$MonoOperatorModes,java.lang.Double)>/return/10	<simplejavacalculator.Calculator: java.lang.Double calculateMono(simplejavacalculator.Calculator$MonoOperatorModes,java.lang.Double)>
<simplejavacalculator.Calculator$MonoOperatorModes: simplejavacalculator.Calculator$MonoOperatorModes[] values()>/return/0	<simplejavacalculator.Calculator$MonoOperatorModes: simplejavacalculator.Calculator$MonoOperatorModes[] values()>
<simplejavacalculator.Calculator$BiOperatorModes: simplejavacalculator.Calculator$BiOperatorModes valueOf(java.lang.String)>/return/0	<simplejavacalculator.Calculator$BiOperatorModes: simplejavacalculator.Calculator$BiOperatorModes valueOf(java.lang.String)>
<simplejavacalculator.Calculator$MonoOperatorModes: simplejavacalculator.Calculator$MonoOperatorModes valueOf(java.lang.String)>/return/0	<simplejavacalculator.Calculator$MonoOperatorModes: simplejavacalculator.Calculator$MonoOperatorModes valueOf(java.lang.String)>
<simplejavacalculator.UI: java.lang.Double reader()>/return/0	<simplejavacalculator.UI: java.lang.Double reader()>
<simplejavacalculator.Calculator$MonoOperatorModes: void <init>(java.lang.String,int)>/return-void/0	<simplejavacalculator.Calculator$MonoOperatorModes: void <init>(java.lang.String,int)>
<simplejavacalculator.Calculator$BiOperatorModes: void <init>(java.lang.String,int)>/return-void/0	<simplejavacalculator.Calculator$BiOperatorModes: void <init>(java.lang.String,int)>
<simplejavacalculator.UI: void init()>/return-void/0	<simplejavacalculator.UI: void init()>
<simplejavacalculator.SimpleJavaCalculator: void <init>()>/return-void/0	<simplejavacalculator.SimpleJavaCalculator: void <init>()>
<simplejavacalculator.UI: void parsetoBinary()>/return-void/0	<simplejavacalculator.UI: void parsetoBinary()>
<simplejavacalculator.UI: void writer(java.lang.Double)>/return-void/0	<simplejavacalculator.UI: void writer(java.lang.Double)>
<simplejavacalculator.UI: void actionPerformed(java.awt.event.ActionEvent)>/return-void/1	<simplejavacalculator.UI: void actionPerformed(java.awt.event.ActionEvent)>
<simplejavacalculator.Calculator$BiOperatorModes: void <clinit>()>/return-void/0	<simplejavacalculator.Calculator$BiOperatorModes: void <clinit>()>
<simplejavacalculator.Calculator$MonoOperatorModes: void <clinit>()>/return-void/0	<simplejavacalculator.Calculator$MonoOperatorModes: void <clinit>()>
<simplejavacalculator.Calculator: void <init>()>/return-void/0	<simplejavacalculator.Calculator: void <init>()>
<simplejavacalculator.SimpleJavaCalculator: void main(java.lang.String[])>/return-void/0	<simplejavacalculator.SimpleJavaCalculator: void main(java.lang.String[])>
<simplejavacalculator.UI: void <init>()>/return-void/0	<simplejavacalculator.UI: void <init>()>
<simplejavacalculator.UI: void actionPerformed(java.awt.event.ActionEvent)>/return-void/0	<simplejavacalculator.UI: void actionPerformed(java.awt.event.ActionEvent)>
<simplejavacalculator.UI: void parsetoBinary()>/assign/8	<simplejavacalculator.UI: void parsetoBinary()>
