<simplejavacalculator.Calculator: java.lang.Double calculateMono(simplejavacalculator.Calculator$MonoOperatorModes,java.lang.Double)>/$stack12	$stack12
<simplejavacalculator.Calculator: java.lang.Double calculateBiImpl()>/$stack13	$stack13
<simplejavacalculator.UI: void init()>/$stack101	$stack101
<simplejavacalculator.UI: void init()>/this#_0	this#_0
<simplejavacalculator.UI: void init()>/$stack42	$stack42
<simplejavacalculator.UI: void actionPerformed(java.awt.event.ActionEvent)>/$stack11	$stack11
<simplejavacalculator.UI: void actionPerformed(java.awt.event.ActionEvent)>/$stack85	$stack85
<simplejavacalculator.Calculator: java.lang.Double calculateBiImpl()>/$stack38	$stack38
<simplejavacalculator.Calculator: java.lang.Double calculateBiImpl()>/this#_0	this#_0
<simplejavacalculator.UI: void init()>/$stack114	$stack114
<simplejavacalculator.UI: void init()>/$stack106	$stack106
<simplejavacalculator.UI: void init()>/$stack25	$stack25
<simplejavacalculator.UI: void init()>/$stack139	$stack139
<simplejavacalculator.UI: void init()>/$stack207	$stack207
<simplejavacalculator.UI: void init()>/$stack24	$stack24
<simplejavacalculator.UI: void actionPerformed(java.awt.event.ActionEvent)>/$stack20	$stack20
<simplejavacalculator.UI: void actionPerformed(java.awt.event.ActionEvent)>/$stack31	$stack31
<simplejavacalculator.UI: void init()>/$stack174	$stack174
<simplejavacalculator.UI: void init()>/$stack112	$stack112
<simplejavacalculator.UI: void init()>/$stack125	$stack125
<simplejavacalculator.UI: void init()>/$stack4	$stack4
<simplejavacalculator.UI: void init()>/$stack147	$stack147
<simplejavacalculator.UI: void init()>/$stack157	$stack157
<simplejavacalculator.UI: void init()>/$stack11	$stack11
<simplejavacalculator.UI: void actionPerformed(java.awt.event.ActionEvent)>/$stack12	$stack12
<simplejavacalculator.UI: void actionPerformed(java.awt.event.ActionEvent)>/$stack79	$stack79
<simplejavacalculator.Calculator: java.lang.Double calculateBiImpl()>/$stack2	$stack2
<simplejavacalculator.UI: void init()>/$stack148	$stack148
<simplejavacalculator.Calculator: java.lang.Double calculateBiImpl()>/$stack12	$stack12
<simplejavacalculator.UI: void init()>/$stack15	$stack15
<simplejavacalculator.UI: void init()>/$stack99	$stack99
<simplejavacalculator.UI: void init()>/$stack188	$stack188
<simplejavacalculator.UI: void actionPerformed(java.awt.event.ActionEvent)>/$stack45	$stack45
<simplejavacalculator.UI: void actionPerformed(java.awt.event.ActionEvent)>/this#_0	this#_0
<simplejavacalculator.Calculator: java.lang.Double calculateBiImpl()>/$stack10	$stack10
<simplejavacalculator.UI: void init()>/$stack169	$stack169
<simplejavacalculator.UI: void actionPerformed(java.awt.event.ActionEvent)>/$stack5	$stack5
<simplejavacalculator.UI: void init()>/$stack62	$stack62
<simplejavacalculator.UI: void init()>/$stack189	$stack189
<simplejavacalculator.UI: void init()>/$stack28	$stack28
<simplejavacalculator.UI: void init()>/$stack34	$stack34
<simplejavacalculator.Calculator: java.lang.Double calculateBiImpl()>/$stack22	$stack22
<simplejavacalculator.UI: void init()>/$stack102	$stack102
<simplejavacalculator.UI: void actionPerformed(java.awt.event.ActionEvent)>/$stack63	$stack63
<simplejavacalculator.UI: void init()>/$stack37	$stack37
<simplejavacalculator.UI: void init()>/$stack185	$stack185
<simplejavacalculator.UI: void init()>/$stack186	$stack186
<simplejavacalculator.UI: void actionPerformed(java.awt.event.ActionEvent)>/$stack22	$stack22
<simplejavacalculator.UI: void actionPerformed(java.awt.event.ActionEvent)>/$stack23	$stack23
<simplejavacalculator.UI: void init()>/$stack92	$stack92
<simplejavacalculator.UI: void actionPerformed(java.awt.event.ActionEvent)>/$stack7	$stack7
<simplejavacalculator.UI: void actionPerformed(java.awt.event.ActionEvent)>/$stack109	$stack109
<simplejavacalculator.UI: void init()>/$stack108	$stack108
<simplejavacalculator.UI: void init()>/$stack29	$stack29
<simplejavacalculator.UI: void init()>/$stack142	$stack142
<simplejavacalculator.UI: void init()>/$stack187	$stack187
<simplejavacalculator.UI: void actionPerformed(java.awt.event.ActionEvent)>/$stack93	$stack93
<simplejavacalculator.UI: void init()>/$stack64	$stack64
<simplejavacalculator.Calculator: java.lang.Double calculateBiImpl()>/$stack32	$stack32
<simplejavacalculator.UI: void init()>/$stack22	$stack22
<simplejavacalculator.UI: void init()>/$stack38	$stack38
<simplejavacalculator.UI: void init()>/$stack160	$stack160
<simplejavacalculator.Calculator: java.lang.Double calculateBiImpl()>/$stack42	$stack42
<simplejavacalculator.UI: void actionPerformed(java.awt.event.ActionEvent)>/$stack17	$stack17
<simplejavacalculator.UI: void actionPerformed(java.awt.event.ActionEvent)>/$stack49	$stack49
<simplejavacalculator.UI: void init()>/$stack104	$stack104
<simplejavacalculator.UI: void actionPerformed(java.awt.event.ActionEvent)>/$stack8	$stack8
<simplejavacalculator.UI: void actionPerformed(java.awt.event.ActionEvent)>/$stack103	$stack103
<simplejavacalculator.UI: void init()>/$stack43	$stack43
<simplejavacalculator.UI: void init()>/$stack95	$stack95
<simplejavacalculator.Calculator: java.lang.Double calculateBiImpl()>/$stack6	$stack6
<simplejavacalculator.UI: void init()>/$stack144	$stack144
<simplejavacalculator.UI: void init()>/$stack84	$stack84
<simplejavacalculator.UI: void init()>/$stack123	$stack123
<simplejavacalculator.UI: void init()>/$stack46	$stack46
<simplejavacalculator.UI: void init()>/$stack54	$stack54
<simplejavacalculator.UI: void actionPerformed(java.awt.event.ActionEvent)>/$stack75	$stack75
<simplejavacalculator.UI: void init()>/$stack60	$stack60
<simplejavacalculator.UI: void actionPerformed(java.awt.event.ActionEvent)>/$stack121	$stack121
<simplejavacalculator.UI: void init()>/$stack178	$stack178
<simplejavacalculator.UI: void init()>/$stack191	$stack191
<simplejavacalculator.UI: void init()>/$stack53	$stack53
<simplejavacalculator.UI: void init()>/$stack66	$stack66
<simplejavacalculator.UI: void init()>/$stack10	$stack10
<simplejavacalculator.UI: void actionPerformed(java.awt.event.ActionEvent)>/$stack15	$stack15
<simplejavacalculator.UI: void actionPerformed(java.awt.event.ActionEvent)>/$stack61	$stack61
<simplejavacalculator.UI: void init()>/$stack98	$stack98
<simplejavacalculator.UI: void actionPerformed(java.awt.event.ActionEvent)>/$stack39	$stack39
<simplejavacalculator.UI: void actionPerformed(java.awt.event.ActionEvent)>/$stack10	$stack10
<simplejavacalculator.UI: void actionPerformed(java.awt.event.ActionEvent)>/$stack91	$stack91
<simplejavacalculator.UI: void init()>/$stack172	$stack172
<simplejavacalculator.UI: void init()>/$stack126	$stack126
<simplejavacalculator.UI: void init()>/$stack180	$stack180
<simplejavacalculator.UI: void actionPerformed(java.awt.event.ActionEvent)>/$stack14	$stack14
<simplejavacalculator.UI: void actionPerformed(java.awt.event.ActionEvent)>/$stack67	$stack67
<simplejavacalculator.UI: void init()>/$stack39	$stack39
<simplejavacalculator.Calculator: java.lang.Double calculateBiImpl()>/$stack48	$stack48
<simplejavacalculator.UI: void init()>/$stack116	$stack116
<simplejavacalculator.UI: void init()>/$stack18	$stack18
<simplejavacalculator.UI: void init()>/$stack132	$stack132
<simplejavacalculator.UI: void actionPerformed(java.awt.event.ActionEvent)>/$stack123	$stack123
<simplejavacalculator.UI: void init()>/$stack145	$stack145
<simplejavacalculator.UI: void init()>/$stack175	$stack175
<simplejavacalculator.UI: void init()>/$stack51	$stack51
<simplejavacalculator.UI: void init()>/$stack128	$stack128
<simplejavacalculator.UI: void init()>/$stack30	$stack30
<simplejavacalculator.UI: void init()>/$stack35	$stack35
<simplejavacalculator.UI: void init()>/$stack82	$stack82
<simplejavacalculator.UI: void init()>/$stack197	$stack197
<simplejavacalculator.Calculator: java.lang.Double calculateBiImpl()>/$stack8	$stack8
<simplejavacalculator.UI: void init()>/$stack41	$stack41
<simplejavacalculator.UI: void init()>/$stack26	$stack26
<simplejavacalculator.UI: void init()>/$stack40	$stack40
<simplejavacalculator.UI: void parsetoBinary()>/$stack3	$stack3
<simplejavacalculator.UI: void parsetoBinary()>/this#_0	this#_0
<simplejavacalculator.UI: void init()>/$stack32	$stack32
<simplejavacalculator.UI: void init()>/$stack77	$stack77
<simplejavacalculator.UI: void init()>/$stack166	$stack166
<simplejavacalculator.UI: void actionPerformed(java.awt.event.ActionEvent)>/$stack51	$stack51
<simplejavacalculator.UI: void actionPerformed(java.awt.event.ActionEvent)>/$stack81	$stack81
<simplejavacalculator.Calculator: java.lang.Double calculateBiImpl()>/$stack44	$stack44
<simplejavacalculator.UI: void actionPerformed(java.awt.event.ActionEvent)>/$stack87	$stack87
<simplejavacalculator.UI: void init()>/$stack74	$stack74
<simplejavacalculator.UI: void init()>/$stack195	$stack195
<simplejavacalculator.UI: void init()>/$stack151	$stack151
<simplejavacalculator.UI: void init()>/$stack150	$stack150
<simplejavacalculator.UI: void init()>/$stack90	$stack90
<simplejavacalculator.Calculator: java.lang.Double calculateBiImpl()>/$stack14	$stack14
<simplejavacalculator.UI: void init()>/$stack7	$stack7
<simplejavacalculator.UI: void init()>/$stack20	$stack20
<simplejavacalculator.UI: void init()>/$stack96	$stack96
<simplejavacalculator.Calculator: java.lang.Double calculateBiImpl()>/$stack41	$stack41
<simplejavacalculator.UI: void init()>/$stack2	$stack2
<simplejavacalculator.UI: void init()>/$stack138	$stack138
<simplejavacalculator.UI: void actionPerformed(java.awt.event.ActionEvent)>/$stack24	$stack24
<simplejavacalculator.UI: java.lang.Double reader()>/$stack3	$stack3
<simplejavacalculator.UI: java.lang.Double reader()>/this#_0	this#_0
<simplejavacalculator.UI: void init()>/$stack202	$stack202
<simplejavacalculator.UI: void init()>/$stack163	$stack163
<simplejavacalculator.UI: void init()>/$stack159	$stack159
<simplejavacalculator.UI: void actionPerformed(java.awt.event.ActionEvent)>/$stack6	$stack6
<simplejavacalculator.UI: void actionPerformed(java.awt.event.ActionEvent)>/$stack115	$stack115
<simplejavacalculator.Calculator: java.lang.Double calculateBi(simplejavacalculator.Calculator$BiOperatorModes,java.lang.Double)>/$stack6	$stack6
<simplejavacalculator.Calculator: java.lang.Double calculateBi(simplejavacalculator.Calculator$BiOperatorModes,java.lang.Double)>/this#_0	this#_0
<simplejavacalculator.UI: void init()>/$stack19	$stack19
<simplejavacalculator.UI: void init()>/$stack17	$stack17
<simplejavacalculator.UI: void init()>/$stack27	$stack27
<simplejavacalculator.UI: void init()>/$stack200	$stack200
<simplejavacalculator.UI: void init()>/$stack23	$stack23
<simplejavacalculator.UI: void init()>/$stack33	$stack33
<simplejavacalculator.UI: void init()>/$stack120	$stack120
<simplejavacalculator.UI: void init()>/$stack44	$stack44
<simplejavacalculator.UI: void init()>/$stack162	$stack162
<simplejavacalculator.UI: void init()>/$stack183	$stack183
<simplejavacalculator.UI: void init()>/$stack21	$stack21
<simplejavacalculator.UI: void init()>/$stack68	$stack68
<simplejavacalculator.UI: void init()>/$stack78	$stack78
<simplejavacalculator.UI: void init()>/$stack31	$stack31
<simplejavacalculator.UI: void actionPerformed(java.awt.event.ActionEvent)>/$stack19	$stack19
<simplejavacalculator.UI: void actionPerformed(java.awt.event.ActionEvent)>/$stack37	$stack37
<simplejavacalculator.Calculator: java.lang.Double calculateBiImpl()>/$stack34	$stack34
<simplejavacalculator.UI: void init()>/$stack72	$stack72
<simplejavacalculator.UI: void init()>/$stack193	$stack193
<simplejavacalculator.Calculator: java.lang.Double calculateBi(simplejavacalculator.Calculator$BiOperatorModes,java.lang.Double)>/$stack4	$stack4
<simplejavacalculator.UI: void init()>/$stack168	$stack168
<simplejavacalculator.UI: void init()>/$stack184	$stack184
<simplejavacalculator.UI: void actionPerformed(java.awt.event.ActionEvent)>/$stack57	$stack57
<simplejavacalculator.Calculator: java.lang.Double calculateBiImpl()>/$stack4	$stack4
<simplejavacalculator.UI: void actionPerformed(java.awt.event.ActionEvent)>/$stack111	$stack111
<simplejavacalculator.UI: void init()>/$stack8	$stack8
<simplejavacalculator.UI: void init()>/$stack110	$stack110
<simplejavacalculator.UI: void init()>/$stack192	$stack192
<simplejavacalculator.Calculator: java.lang.Double calculateBiImpl()>/$stack26	$stack26
<simplejavacalculator.UI: void init()>/$stack122	$stack122
<simplejavacalculator.UI: void init()>/$stack182	$stack182
<simplejavacalculator.UI: void init()>/$stack3	$stack3
<simplejavacalculator.UI: void init()>/$stack13	$stack13
<simplejavacalculator.UI: void actionPerformed(java.awt.event.ActionEvent)>/$stack69	$stack69
<simplejavacalculator.UI: void init()>/$stack194	$stack194
<simplejavacalculator.UI: void init()>/$stack135	$stack135
<simplejavacalculator.UI: void parsetoBinary()>/$stack5	$stack5
<simplejavacalculator.UI: void init()>/$stack5	$stack5
<simplejavacalculator.UI: void init()>/$stack198	$stack198
<simplejavacalculator.UI: void init()>/$stack171	$stack171
<simplejavacalculator.UI: void init()>/$stack47	$stack47
<simplejavacalculator.UI: void init()>/$stack58	$stack58
<simplejavacalculator.UI: void init()>/$stack75	$stack75
<simplejavacalculator.UI: void init()>/$stack16	$stack16
<simplejavacalculator.UI: void init()>/$stack154	$stack154
<simplejavacalculator.UI: void actionPerformed(java.awt.event.ActionEvent)>/$stack117	$stack117
<simplejavacalculator.Calculator: java.lang.Double calculateBiImpl()>/$stack16	$stack16
<simplejavacalculator.UI: void init()>/$stack14	$stack14
<simplejavacalculator.UI: void init()>/$stack130	$stack130
<simplejavacalculator.UI: void init()>/$stack153	$stack153
<simplejavacalculator.UI: void init()>/$stack156	$stack156
<simplejavacalculator.UI: void init()>/$stack177	$stack177
<simplejavacalculator.UI: void init()>/$stack6	$stack6
<simplejavacalculator.UI: void actionPerformed(java.awt.event.ActionEvent)>/$stack13	$stack13
<simplejavacalculator.UI: void actionPerformed(java.awt.event.ActionEvent)>/$stack73	$stack73
<simplejavacalculator.UI: void writer(java.lang.Double)>/$stack4	$stack4
<simplejavacalculator.UI: void writer(java.lang.Double)>/this#_0	this#_0
<simplejavacalculator.Calculator: java.lang.Double calculateBiImpl()>/$stack20	$stack20
<simplejavacalculator.UI: void init()>/$stack56	$stack56
<simplejavacalculator.UI: void init()>/$stack190	$stack190
<simplejavacalculator.Calculator: java.lang.Double calculateBiImpl()>/$stack28	$stack28
<simplejavacalculator.UI: void writer(java.lang.Double)>/$stack7	$stack7
<simplejavacalculator.UI: void init()>/$stack119	$stack119
<simplejavacalculator.UI: void actionPerformed(java.awt.event.ActionEvent)>/$stack28	$stack28
<simplejavacalculator.UI: void init()>/$stack50	$stack50
<simplejavacalculator.UI: void actionPerformed(java.awt.event.ActionEvent)>/$stack21	$stack21
<simplejavacalculator.UI: void actionPerformed(java.awt.event.ActionEvent)>/$stack26	$stack26
<simplejavacalculator.UI: void init()>/$stack86	$stack86
<simplejavacalculator.UI: void init()>/$stack165	$stack165
<simplejavacalculator.UI: void actionPerformed(java.awt.event.ActionEvent)>/$stack99	$stack99
<simplejavacalculator.UI: void actionPerformed(java.awt.event.ActionEvent)>/$stack16	$stack16
<simplejavacalculator.UI: void actionPerformed(java.awt.event.ActionEvent)>/$stack55	$stack55
<simplejavacalculator.UI: void init()>/$stack80	$stack80
<simplejavacalculator.UI: void actionPerformed(java.awt.event.ActionEvent)>/$stack105	$stack105
<simplejavacalculator.UI: void init()>/$stack12	$stack12
<simplejavacalculator.UI: void init()>/$stack36	$stack36
<simplejavacalculator.UI: void init()>/$stack141	$stack141
<simplejavacalculator.UI: void actionPerformed(java.awt.event.ActionEvent)>/$stack33	$stack33
<simplejavacalculator.UI: void init()>/$stack196	$stack196
<simplejavacalculator.UI: void actionPerformed(java.awt.event.ActionEvent)>/$stack9	$stack9
<simplejavacalculator.UI: void actionPerformed(java.awt.event.ActionEvent)>/$stack97	$stack97
<simplejavacalculator.UI: void init()>/$stack71	$stack71
<simplejavacalculator.UI: void init()>/$stack206	$stack206
<simplejavacalculator.UI: void init()>/$stack88	$stack88
<simplejavacalculator.UI: void init()>/$stack45	$stack45
<simplejavacalculator.UI: void actionPerformed(java.awt.event.ActionEvent)>/$stack18	$stack18
<simplejavacalculator.UI: void actionPerformed(java.awt.event.ActionEvent)>/$stack43	$stack43
<simplejavacalculator.UI: void init()>/$stack199	$stack199
<simplejavacalculator.UI: void init()>/$stack136	$stack136
<simplejavacalculator.UI: void <init>()>/$stack8	$stack8
<simplejavacalculator.UI: void <init>()>/this#_0	this#_0
<simplejavacalculator.UI: void <init>()>/$stack48	$stack48
<simplejavacalculator.UI: void <init>()>/$stack7	$stack7
<simplejavacalculator.Calculator: java.lang.Double calculateBi(simplejavacalculator.Calculator$BiOperatorModes,java.lang.Double)>/$stack5	$stack5
<simplejavacalculator.Calculator: java.lang.Double calculateBi(simplejavacalculator.Calculator$BiOperatorModes,java.lang.Double)>/num#_0	num#_0
<simplejavacalculator.Calculator: java.lang.Double calculateBi(simplejavacalculator.Calculator$BiOperatorModes,java.lang.Double)>/newMode#_0	newMode#_0
<simplejavacalculator.UI: void <init>()>/$stack2	$stack2
<simplejavacalculator.Calculator: java.lang.Double reset()>/$stack1	$stack1
<simplejavacalculator.Calculator: java.lang.Double reset()>/this#_0	this#_0
<simplejavacalculator.UI: void <init>()>/$stack3	$stack3
<simplejavacalculator.Calculator: void <init>()>/$stack1	$stack1
<simplejavacalculator.Calculator: void <init>()>/this#_0	this#_0
<simplejavacalculator.Calculator: java.lang.Double reset()>/$stack2	$stack2
<simplejavacalculator.Calculator: java.lang.Double reset()>/$stack3	$stack3
<simplejavacalculator.Calculator: java.lang.Double calculateBi(simplejavacalculator.Calculator$BiOperatorModes,java.lang.Double)>/$stack7	$stack7
<simplejavacalculator.UI: void <init>()>/$stack5	$stack5
<simplejavacalculator.UI: void <init>()>/$stack15	$stack15
<simplejavacalculator.UI: void <init>()>/$stack36	$stack36
<simplejavacalculator.UI: void <init>()>/$stack39	$stack39
<simplejavacalculator.UI: void <init>()>/$stack11	$stack11
<simplejavacalculator.UI: void <init>()>/$stack44	$stack44
<simplejavacalculator.UI: void <init>()>/$stack32	$stack32
<simplejavacalculator.UI: void <init>()>/$stack9	$stack9
<simplejavacalculator.UI: void <init>()>/$stack37	$stack37
<simplejavacalculator.UI: void <init>()>/$stack13	$stack13
<simplejavacalculator.UI: void <init>()>/$stack30	$stack30
<simplejavacalculator.UI: void <init>()>/$stack17	$stack17
<simplejavacalculator.UI: void <init>()>/$stack38	$stack38
<simplejavacalculator.UI: void <init>()>/$stack40	$stack40
<simplejavacalculator.UI: void <init>()>/$stack41	$stack41
<simplejavacalculator.UI: void <init>()>/$stack21	$stack21
<simplejavacalculator.UI: void <init>()>/$stack19	$stack19
<simplejavacalculator.UI: void <init>()>/$stack23	$stack23
<simplejavacalculator.UI: void <init>()>/$stack27	$stack27
<simplejavacalculator.UI: void <init>()>/$stack29	$stack29
<simplejavacalculator.UI: void <init>()>/$stack42	$stack42
<simplejavacalculator.UI: void <init>()>/$stack25	$stack25
<simplejavacalculator.UI: void <init>()>/$stack43	$stack43
<simplejavacalculator.UI: void <init>()>/$stack46	$stack46
<simplejavacalculator.UI: void <init>()>/$stack34	$stack34
<simplejavacalculator.UI: void <init>()>/$stack4	$stack4
<simplejavacalculator.UI: void <init>()>/$stack33	$stack33
<simplejavacalculator.UI: void <init>()>/$stack28	$stack28
<simplejavacalculator.UI: void <init>()>/$stack31	$stack31
<simplejavacalculator.UI: void <init>()>/$stack26	$stack26
<simplejavacalculator.UI: void <init>()>/$stack45	$stack45
<simplejavacalculator.UI: void <init>()>/$stack35	$stack35
<simplejavacalculator.Calculator$BiOperatorModes: void <clinit>()>/$stack4	$stack4
<simplejavacalculator.Calculator$BiOperatorModes: void <clinit>()>/$stack5	$stack5
<simplejavacalculator.Calculator$MonoOperatorModes: void <clinit>()>/$stack4	$stack4
<simplejavacalculator.Calculator$MonoOperatorModes: void <clinit>()>/$stack6	$stack6
<simplejavacalculator.Calculator$BiOperatorModes: void <clinit>()>/$stack1	$stack1
<simplejavacalculator.Calculator$BiOperatorModes: void <clinit>()>/$stack3	$stack3
<simplejavacalculator.Calculator$MonoOperatorModes: void <clinit>()>/$stack3	$stack3
<simplejavacalculator.Calculator$BiOperatorModes: void <clinit>()>/$stack0	$stack0
<simplejavacalculator.Calculator$MonoOperatorModes: void <clinit>()>/$stack0	$stack0
<simplejavacalculator.Calculator$BiOperatorModes: void <clinit>()>/$stack2	$stack2
<simplejavacalculator.Calculator$BiOperatorModes: void <clinit>()>/$stack6	$stack6
<simplejavacalculator.Calculator$MonoOperatorModes: void <clinit>()>/$stack5	$stack5
<simplejavacalculator.Calculator$MonoOperatorModes: void <clinit>()>/$stack1	$stack1
<simplejavacalculator.Calculator$MonoOperatorModes: void <clinit>()>/$stack9	$stack9
<simplejavacalculator.Calculator$MonoOperatorModes: void <clinit>()>/$stack7	$stack7
<simplejavacalculator.Calculator$MonoOperatorModes: void <clinit>()>/$stack8	$stack8
<simplejavacalculator.Calculator$MonoOperatorModes: void <clinit>()>/$stack2	$stack2
<simplejavacalculator.Calculator$MonoOperatorModes: simplejavacalculator.Calculator$MonoOperatorModes[] values()>/$stack0	$stack0
<simplejavacalculator.Calculator$MonoOperatorModes: void <clinit>()>/$stack17	$stack17
<simplejavacalculator.UI: void actionPerformed(java.awt.event.ActionEvent)>/$stack76	$stack76
<simplejavacalculator.Calculator: java.lang.Double calculateEqual(java.lang.Double)>/$stack2	$stack2
<simplejavacalculator.Calculator: java.lang.Double calculateBiImpl()>/$stack1	$stack1
<simplejavacalculator.Calculator: java.lang.Double calculateMono(simplejavacalculator.Calculator$MonoOperatorModes,java.lang.Double)>/$stack8	$stack8
<simplejavacalculator.UI: void actionPerformed(java.awt.event.ActionEvent)>/$stack70	$stack70
<simplejavacalculator.Calculator$BiOperatorModes: void <clinit>()>/$stack12	$stack12
<simplejavacalculator.Calculator: java.lang.Double calculateMono(simplejavacalculator.Calculator$MonoOperatorModes,java.lang.Double)>/$stack4	$stack4
<simplejavacalculator.Calculator$MonoOperatorModes: void <clinit>()>/$stack10	$stack10
<simplejavacalculator.Calculator$MonoOperatorModes: void <clinit>()>/$stack16	$stack16
<simplejavacalculator.Calculator: java.lang.Double calculateMono(simplejavacalculator.Calculator$MonoOperatorModes,java.lang.Double)>/$stack7	$stack7
<simplejavacalculator.Calculator: java.lang.Double calculateMono(simplejavacalculator.Calculator$MonoOperatorModes,java.lang.Double)>/$stack11	$stack11
<simplejavacalculator.UI: void actionPerformed(java.awt.event.ActionEvent)>/$stack112	$stack112
<simplejavacalculator.Calculator: java.lang.Double calculateMono(simplejavacalculator.Calculator$MonoOperatorModes,java.lang.Double)>/$stack5	$stack5
<simplejavacalculator.Calculator$MonoOperatorModes: void <clinit>()>/$stack15	$stack15
<simplejavacalculator.UI: void parsetoBinary()>/$stack13	$stack13
<simplejavacalculator.Calculator$BiOperatorModes: void <clinit>()>/$stack11	$stack11
<simplejavacalculator.Calculator$BiOperatorModes: void <clinit>()>/$stack7	$stack7
<simplejavacalculator.UI: void actionPerformed(java.awt.event.ActionEvent)>/$stack58	$stack58
<simplejavacalculator.Calculator$MonoOperatorModes: void <clinit>()>/$stack13	$stack13
<simplejavacalculator.UI: void actionPerformed(java.awt.event.ActionEvent)>/$stack106	$stack106
<simplejavacalculator.Calculator: java.lang.Double calculateBiImpl()>/$stack7	$stack7
<simplejavacalculator.UI: void actionPerformed(java.awt.event.ActionEvent)>/$stack40	$stack40
<simplejavacalculator.Calculator: java.lang.Double calculateBiImpl()>/$stack5	$stack5
<simplejavacalculator.Calculator$MonoOperatorModes: void <clinit>()>/$stack12	$stack12
<simplejavacalculator.Calculator$MonoOperatorModes: void <clinit>()>/$stack18	$stack18
<simplejavacalculator.UI: void actionPerformed(java.awt.event.ActionEvent)>/$stack100	$stack100
<simplejavacalculator.Calculator: java.lang.Double calculateMono(simplejavacalculator.Calculator$MonoOperatorModes,java.lang.Double)>/$stack10	$stack10
<simplejavacalculator.Calculator: java.lang.Double calculateBi(simplejavacalculator.Calculator$BiOperatorModes,java.lang.Double)>/$stack3	$stack3
<simplejavacalculator.Calculator: java.lang.Double calculateBiImpl()>/$stack3	$stack3
<simplejavacalculator.Calculator$BiOperatorModes: void <clinit>()>/$stack9	$stack9
<simplejavacalculator.UI: void actionPerformed(java.awt.event.ActionEvent)>/$stack52	$stack52
<simplejavacalculator.UI: void actionPerformed(java.awt.event.ActionEvent)>/$stack82	$stack82
<simplejavacalculator.UI: void actionPerformed(java.awt.event.ActionEvent)>/$stack88	$stack88
<simplejavacalculator.Calculator: java.lang.Double calculateBiImpl()>/$stack11	$stack11
<simplejavacalculator.Calculator: java.lang.Double calculateBiImpl()>/$stack9	$stack9
<simplejavacalculator.Calculator: java.lang.Double calculateMono(simplejavacalculator.Calculator$MonoOperatorModes,java.lang.Double)>/$stack3	$stack3
<simplejavacalculator.Calculator$BiOperatorModes: void <clinit>()>/$stack8	$stack8
<simplejavacalculator.Calculator: java.lang.Double calculateMono(simplejavacalculator.Calculator$MonoOperatorModes,java.lang.Double)>/$stack6	$stack6
<simplejavacalculator.Calculator$BiOperatorModes: simplejavacalculator.Calculator$BiOperatorModes[] values()>/$stack0	$stack0
<simplejavacalculator.UI: void actionPerformed(java.awt.event.ActionEvent)>/$stack64	$stack64
<simplejavacalculator.UI: void actionPerformed(java.awt.event.ActionEvent)>/$stack46	$stack46
<simplejavacalculator.Calculator$MonoOperatorModes: void <clinit>()>/$stack14	$stack14
<simplejavacalculator.Calculator$MonoOperatorModes: void <clinit>()>/$stack11	$stack11
<simplejavacalculator.UI: void actionPerformed(java.awt.event.ActionEvent)>/$stack94	$stack94
<simplejavacalculator.UI: void actionPerformed(java.awt.event.ActionEvent)>/$stack34	$stack34
<simplejavacalculator.Calculator$BiOperatorModes: void <clinit>()>/$stack10	$stack10
<simplejavacalculator.Calculator: java.lang.Double calculateMono(simplejavacalculator.Calculator$MonoOperatorModes,java.lang.Double)>/$stack9	$stack9
<simplejavacalculator.Calculator$MonoOperatorModes: void <clinit>()>/$stringconstant5	$stringconstant5
<simplejavacalculator.Calculator$BiOperatorModes: void <clinit>()>/$stringconstant0	$stringconstant0
<simplejavacalculator.Calculator$MonoOperatorModes: simplejavacalculator.Calculator$MonoOperatorModes valueOf(java.lang.String)>/$classconstant0	$classconstant0
<simplejavacalculator.Calculator$MonoOperatorModes: void <clinit>()>/$stringconstant7	$stringconstant7
<simplejavacalculator.Calculator$MonoOperatorModes: void <clinit>()>/$stringconstant1	$stringconstant1
<simplejavacalculator.Calculator$BiOperatorModes: void <clinit>()>/$stringconstant5	$stringconstant5
<simplejavacalculator.Calculator$MonoOperatorModes: void <clinit>()>/$stringconstant8	$stringconstant8
<simplejavacalculator.Calculator$BiOperatorModes: void <clinit>()>/$stringconstant1	$stringconstant1
<simplejavacalculator.Calculator$MonoOperatorModes: void <clinit>()>/$stringconstant2	$stringconstant2
<simplejavacalculator.Calculator$BiOperatorModes: void <clinit>()>/$stringconstant3	$stringconstant3
<simplejavacalculator.Calculator$MonoOperatorModes: void <clinit>()>/$stringconstant6	$stringconstant6
<simplejavacalculator.Calculator$MonoOperatorModes: void <clinit>()>/$stringconstant4	$stringconstant4
<simplejavacalculator.Calculator$BiOperatorModes: void <clinit>()>/$stringconstant4	$stringconstant4
<simplejavacalculator.Calculator$MonoOperatorModes: void <clinit>()>/$stringconstant0	$stringconstant0
<simplejavacalculator.Calculator$BiOperatorModes: void <clinit>()>/$stringconstant2	$stringconstant2
<simplejavacalculator.Calculator$MonoOperatorModes: void <clinit>()>/$stringconstant3	$stringconstant3
<simplejavacalculator.UI: void <init>()>/$stringconstant24	$stringconstant24
<simplejavacalculator.UI: void <init>()>/$stringconstant8	$stringconstant8
<simplejavacalculator.UI: void <init>()>/$stringconstant15	$stringconstant15
<simplejavacalculator.UI: void <init>()>/$stringconstant13	$stringconstant13
<simplejavacalculator.UI: void <init>()>/$stringconstant10	$stringconstant10
<simplejavacalculator.UI: void <init>()>/$stack18	$stack18
<simplejavacalculator.UI: void <init>()>/$stringconstant26	$stringconstant26
<simplejavacalculator.UI: void <init>()>/$stringconstant2	$stringconstant2
<simplejavacalculator.UI: void <init>()>/$stringconstant16	$stringconstant16
<simplejavacalculator.UI: void <init>()>/$stringconstant3	$stringconstant3
<simplejavacalculator.UI: void <init>()>/$stack24	$stack24
<simplejavacalculator.UI: void <init>()>/$stack14	$stack14
<simplejavacalculator.UI: void <init>()>/$stack6	$stack6
<simplejavacalculator.UI: void parsetoBinary()>/$stack12	$stack12
<simplejavacalculator.UI: void <init>()>/$stringconstant11	$stringconstant11
<simplejavacalculator.UI: void writer(java.lang.Double)>/$stringconstant0	$stringconstant0
<simplejavacalculator.UI: void <init>()>/$stringconstant0	$stringconstant0
<simplejavacalculator.UI: void <init>()>/$stringconstant18	$stringconstant18
<simplejavacalculator.UI: void <init>()>/$stringconstant29	$stringconstant29
<simplejavacalculator.UI: void parsetoBinary()>/$stringconstant1	$stringconstant1
<simplejavacalculator.UI: void parsetoBinary()>/$stringconstant0	$stringconstant0
<simplejavacalculator.UI: void <init>()>/$stringconstant28	$stringconstant28
<simplejavacalculator.UI: void <init>()>/$stack10	$stack10
<simplejavacalculator.UI: void <init>()>/$stack47	$stack47
<simplejavacalculator.UI: void <init>()>/$stringconstant27	$stringconstant27
<simplejavacalculator.UI: void <init>()>/$stringconstant12	$stringconstant12
<simplejavacalculator.UI: void <init>()>/$stringconstant17	$stringconstant17
<simplejavacalculator.UI: void <init>()>/$stringconstant23	$stringconstant23
<simplejavacalculator.SimpleJavaCalculator: void main(java.lang.String[])>/$stack2	$stack2
<simplejavacalculator.UI: void parsetoBinary()>/$stack2	$stack2
<simplejavacalculator.Calculator$BiOperatorModes: simplejavacalculator.Calculator$BiOperatorModes valueOf(java.lang.String)>/$classconstant0	$classconstant0
<simplejavacalculator.UI: void <init>()>/$stringconstant22	$stringconstant22
<simplejavacalculator.UI: void <init>()>/$stringconstant14	$stringconstant14
<simplejavacalculator.UI: void <init>()>/$stringconstant20	$stringconstant20
<simplejavacalculator.UI: void <init>()>/$stringconstant19	$stringconstant19
<simplejavacalculator.UI: void <init>()>/$stack22	$stack22
<simplejavacalculator.UI: void <init>()>/$stack12	$stack12
<simplejavacalculator.UI: void <init>()>/$stringconstant21	$stringconstant21
<simplejavacalculator.UI: void <init>()>/$stack20	$stack20
<simplejavacalculator.UI: void <init>()>/$stringconstant4	$stringconstant4
<simplejavacalculator.UI: void <init>()>/$stringconstant25	$stringconstant25
<simplejavacalculator.UI: void <init>()>/$stringconstant30	$stringconstant30
<simplejavacalculator.UI: void <init>()>/$stringconstant5	$stringconstant5
<simplejavacalculator.UI: void <init>()>/$stringconstant9	$stringconstant9
<simplejavacalculator.UI: void <init>()>/$stringconstant6	$stringconstant6
<simplejavacalculator.UI: void <init>()>/$stringconstant1	$stringconstant1
<simplejavacalculator.UI: void <init>()>/$stack16	$stack16
<simplejavacalculator.UI: void <init>()>/$stringconstant7	$stringconstant7
<simplejavacalculator.UI: void actionPerformed(java.awt.event.ActionEvent)>/source#_220	source#_220
<simplejavacalculator.UI: void actionPerformed(java.awt.event.ActionEvent)>/$stack116	$stack116
<simplejavacalculator.UI: void actionPerformed(java.awt.event.ActionEvent)>/$stack110	$stack110
<simplejavacalculator.SimpleJavaCalculator: void <init>()>/this#_0	this#_0
<simplejavacalculator.Calculator$MonoOperatorModes: void <init>(java.lang.String,int)>/l2#_0	l2#_0
<simplejavacalculator.Calculator$BiOperatorModes: simplejavacalculator.Calculator$BiOperatorModes valueOf(java.lang.String)>/name#_0	name#_0
<simplejavacalculator.UI: void parsetoBinary()>/$stack11	$stack11
<simplejavacalculator.UI: void parsetoBinary()>/ex#_310	ex#_310
<simplejavacalculator.UI: void init()>/i_$$A_1_$$A_1#_123	i_$$A_1_$$A_1#_123
<simplejavacalculator.UI: void init()>/$stack210	$stack210
<simplejavacalculator.UI: void actionPerformed(java.awt.event.ActionEvent)>/$stack50	$stack50
<simplejavacalculator.Calculator: java.lang.Double calculateMono(simplejavacalculator.Calculator$MonoOperatorModes,java.lang.Double)>/this#_0	this#_0
<simplejavacalculator.UI: void actionPerformed(java.awt.event.ActionEvent)>/i_$$A_1#_222	i_$$A_1#_222
<simplejavacalculator.UI: void actionPerformed(java.awt.event.ActionEvent)>/i_$$A_1_$$A_1#_223	i_$$A_1_$$A_1#_223
<simplejavacalculator.UI: void actionPerformed(java.awt.event.ActionEvent)>/$stack104	$stack104
<simplejavacalculator.Calculator$BiOperatorModes: void <init>(java.lang.String,int)>/this#_0	this#_0
<simplejavacalculator.Calculator$BiOperatorModes: void <init>(java.lang.String,int)>/l2#_0	l2#_0
<simplejavacalculator.UI: void init()>/i_$$A_1_$$A_5#_193	i_$$A_1_$$A_5#_193
<simplejavacalculator.UI: void init()>/i_$$A_1_$$A_4#_194	i_$$A_1_$$A_4#_194
<simplejavacalculator.UI: java.lang.Double reader()>/$stack4	$stack4
<simplejavacalculator.UI: java.lang.Double reader()>/str#_318	str#_318
<simplejavacalculator.Calculator$MonoOperatorModes: simplejavacalculator.Calculator$MonoOperatorModes valueOf(java.lang.String)>/name#_0	name#_0
<simplejavacalculator.UI: void actionPerformed(java.awt.event.ActionEvent)>/$stack38	$stack38
<simplejavacalculator.Calculator: java.lang.Double calculateMono(simplejavacalculator.Calculator$MonoOperatorModes,java.lang.Double)>/newMode#_0	newMode#_0
<simplejavacalculator.UI: void actionPerformed(java.awt.event.ActionEvent)>/$stack86	$stack86
<simplejavacalculator.UI: void writer(java.lang.Double)>/num#_0	num#_0
<simplejavacalculator.UI: void init()>/i_$$A_1#_122	i_$$A_1#_122
<simplejavacalculator.UI: void actionPerformed(java.awt.event.ActionEvent)>/$stack98	$stack98
<simplejavacalculator.Calculator: java.lang.Double calculateEqual(java.lang.Double)>/this#_0	this#_0
<simplejavacalculator.UI: void actionPerformed(java.awt.event.ActionEvent)>/$stack80	$stack80
<simplejavacalculator.UI: void init()>/i_$$A_1_$$A_2#_122	i_$$A_1_$$A_2#_122
<simplejavacalculator.Calculator$BiOperatorModes: void <init>(java.lang.String,int)>/l1#_0	l1#_0
<simplejavacalculator.Calculator$MonoOperatorModes: void <init>(java.lang.String,int)>/this#_0	this#_0
<simplejavacalculator.UI: void actionPerformed(java.awt.event.ActionEvent)>/e#_0	e#_0
<simplejavacalculator.UI: void actionPerformed(java.awt.event.ActionEvent)>/$stack44	$stack44
<simplejavacalculator.UI: void init()>/i_$$A_1_$$A_3#_193	i_$$A_1_$$A_3#_193
<simplejavacalculator.UI: void actionPerformed(java.awt.event.ActionEvent)>/i_$$A_1_$$A_2#_222	i_$$A_1_$$A_2#_222
<simplejavacalculator.UI: void actionPerformed(java.awt.event.ActionEvent)>/$stack56	$stack56
<simplejavacalculator.SimpleJavaCalculator: void main(java.lang.String[])>/args#_0	args#_0
<simplejavacalculator.UI: void actionPerformed(java.awt.event.ActionEvent)>/$stack27	$stack27
<simplejavacalculator.Calculator: java.lang.Double calculateMono(simplejavacalculator.Calculator$MonoOperatorModes,java.lang.Double)>/num#_0	num#_0
<simplejavacalculator.Calculator: java.lang.Double calculateMono(simplejavacalculator.Calculator$MonoOperatorModes,java.lang.Double)>/$stack37	$stack37
<simplejavacalculator.UI: void actionPerformed(java.awt.event.ActionEvent)>/$stack32	$stack32
<simplejavacalculator.UI: void init()>/$stack205	$stack205
<simplejavacalculator.UI: void actionPerformed(java.awt.event.ActionEvent)>/$stack120	$stack120
<simplejavacalculator.Calculator: java.lang.Double calculateEqual(java.lang.Double)>/num#_0	num#_0
<simplejavacalculator.UI: void actionPerformed(java.awt.event.ActionEvent)>/$stack74	$stack74
<simplejavacalculator.UI: void actionPerformed(java.awt.event.ActionEvent)>/$stack62	$stack62
<simplejavacalculator.UI: void actionPerformed(java.awt.event.ActionEvent)>/$stack92	$stack92
<simplejavacalculator.UI: void actionPerformed(java.awt.event.ActionEvent)>/$stack4	$stack4
<simplejavacalculator.UI: java.lang.Double reader()>/$stack5	$stack5
<simplejavacalculator.UI: java.lang.Double reader()>/num#_319	num#_319
<simplejavacalculator.UI: void actionPerformed(java.awt.event.ActionEvent)>/$stack68	$stack68
<simplejavacalculator.Calculator$MonoOperatorModes: void <init>(java.lang.String,int)>/l1#_0	l1#_0
<simplejavacalculator.UI: void <init>()>/i_$$A_1_$$A_1#_87	i_$$A_1_$$A_1#_87
<simplejavacalculator.UI: void <init>()>/$stack51	$stack51
<simplejavacalculator.UI: void <init>()>/i_$$A_1_$$A_2#_86	i_$$A_1_$$A_2#_86
<simplejavacalculator.SimpleJavaCalculator: void main(java.lang.String[])>/uiCal#_22	uiCal#_22
<simplejavacalculator.UI: void <init>()>/i_$$A_1#_86	i_$$A_1#_86
<simplejavacalculator.Calculator: java.lang.Double calculateMono(simplejavacalculator.Calculator$MonoOperatorModes,java.lang.Double)>/$stack26	$stack26
<simplejavacalculator.Calculator: java.lang.Double calculateMono(simplejavacalculator.Calculator$MonoOperatorModes,java.lang.Double)>/$stack48	$stack48
<simplejavacalculator.Calculator: java.lang.Double calculateBiImpl()>/$stack40	$stack40
<simplejavacalculator.Calculator: java.lang.Double calculateBiImpl()>/$stack36	$stack36
<simplejavacalculator.Calculator: java.lang.Double calculateBiImpl()>/$stack30	$stack30
<simplejavacalculator.Calculator: java.lang.Double calculateMono(simplejavacalculator.Calculator$MonoOperatorModes,java.lang.Double)>/$stack17	$stack17
<simplejavacalculator.Calculator: java.lang.Double calculateBiImpl()>/$stack24	$stack24
<simplejavacalculator.Calculator: java.lang.Double calculateMono(simplejavacalculator.Calculator$MonoOperatorModes,java.lang.Double)>/$stack23	$stack23
<simplejavacalculator.Calculator: java.lang.Double calculateBiImpl()>/$stack46	$stack46
<simplejavacalculator.Calculator: java.lang.Double calculateMono(simplejavacalculator.Calculator$MonoOperatorModes,java.lang.Double)>/$stack29	$stack29
<simplejavacalculator.Calculator: java.lang.Double calculateMono(simplejavacalculator.Calculator$MonoOperatorModes,java.lang.Double)>/$stack36	$stack36
<simplejavacalculator.Calculator: java.lang.Double calculateMono(simplejavacalculator.Calculator$MonoOperatorModes,java.lang.Double)>/$stack30	$stack30
<simplejavacalculator.Calculator: java.lang.Double calculateMono(simplejavacalculator.Calculator$MonoOperatorModes,java.lang.Double)>/$stack27	$stack27
<simplejavacalculator.Calculator: java.lang.Double calculateMono(simplejavacalculator.Calculator$MonoOperatorModes,java.lang.Double)>/$stack35	$stack35
<simplejavacalculator.Calculator: java.lang.Double calculateMono(simplejavacalculator.Calculator$MonoOperatorModes,java.lang.Double)>/$stack55	$stack55
<simplejavacalculator.Calculator$MonoOperatorModes: simplejavacalculator.Calculator$MonoOperatorModes[] values()>/$stack1	$stack1
<simplejavacalculator.Calculator$MonoOperatorModes: simplejavacalculator.Calculator$MonoOperatorModes[] values()>/$stack2	$stack2
<simplejavacalculator.Calculator$BiOperatorModes: simplejavacalculator.Calculator$BiOperatorModes[] values()>/$stack1	$stack1
<simplejavacalculator.Calculator$BiOperatorModes: simplejavacalculator.Calculator$BiOperatorModes[] values()>/$stack2	$stack2
<simplejavacalculator.Calculator$MonoOperatorModes: simplejavacalculator.Calculator$MonoOperatorModes valueOf(java.lang.String)>/$stack1	$stack1
<simplejavacalculator.Calculator$MonoOperatorModes: simplejavacalculator.Calculator$MonoOperatorModes valueOf(java.lang.String)>/$stack2	$stack2
<simplejavacalculator.Calculator$BiOperatorModes: simplejavacalculator.Calculator$BiOperatorModes valueOf(java.lang.String)>/$stack1	$stack1
<simplejavacalculator.Calculator$BiOperatorModes: simplejavacalculator.Calculator$BiOperatorModes valueOf(java.lang.String)>/$stack2	$stack2
<simplejavacalculator.UI: void init()>/$numconstant10	$numconstant10
<simplejavacalculator.Calculator$MonoOperatorModes: void <clinit>()>/$numconstant0	$numconstant0
<simplejavacalculator.UI: void init()>/$numconstant8	$numconstant8
<simplejavacalculator.UI: void init()>/$numconstant7	$numconstant7
<simplejavacalculator.Calculator$MonoOperatorModes: void <clinit>()>/$numconstant5	$numconstant5
<simplejavacalculator.Calculator$BiOperatorModes: void <clinit>()>/$numconstant5	$numconstant5
<simplejavacalculator.Calculator$MonoOperatorModes: void <clinit>()>/$numconstant6	$numconstant6
<simplejavacalculator.Calculator: java.lang.Double calculateMono(simplejavacalculator.Calculator$MonoOperatorModes,java.lang.Double)>/$numconstant0	$numconstant0
<simplejavacalculator.Calculator: java.lang.Double reset()>/$numconstant0	$numconstant0
<simplejavacalculator.Calculator: java.lang.Double reset()>/$numconstant2	$numconstant2
<simplejavacalculator.Calculator$BiOperatorModes: void <clinit>()>/$numconstant4	$numconstant4
<simplejavacalculator.Calculator$BiOperatorModes: void <clinit>()>/$numconstant3	$numconstant3
<simplejavacalculator.Calculator$BiOperatorModes: void <clinit>()>/$numconstant0	$numconstant0
<simplejavacalculator.UI: void init()>/$numconstant2	$numconstant2
<simplejavacalculator.UI: void init()>/$stack204	$stack204
<simplejavacalculator.UI: void init()>/$numconstant5	$numconstant5
<simplejavacalculator.UI: void init()>/$numconstant3	$numconstant3
<simplejavacalculator.Calculator$MonoOperatorModes: void <clinit>()>/$numconstant7	$numconstant7
<simplejavacalculator.Calculator$BiOperatorModes: void <clinit>()>/$numconstant1	$numconstant1
<simplejavacalculator.Calculator$MonoOperatorModes: void <clinit>()>/$numconstant2	$numconstant2
<simplejavacalculator.UI: void init()>/$numconstant9	$numconstant9
<simplejavacalculator.Calculator: java.lang.Double reset()>/$numconstant1	$numconstant1
<simplejavacalculator.Calculator: java.lang.Double calculateMono(simplejavacalculator.Calculator$MonoOperatorModes,java.lang.Double)>/$stack39	$stack39
<simplejavacalculator.UI: void init()>/$numconstant6	$numconstant6
<simplejavacalculator.UI: void init()>/$stack209	$stack209
<simplejavacalculator.Calculator: java.lang.Double calculateBi(simplejavacalculator.Calculator$BiOperatorModes,java.lang.Double)>/$numconstant1	$numconstant1
<simplejavacalculator.Calculator: java.lang.Double calculateBi(simplejavacalculator.Calculator$BiOperatorModes,java.lang.Double)>/$numconstant0	$numconstant0
<simplejavacalculator.Calculator$BiOperatorModes: void <clinit>()>/$numconstant2	$numconstant2
<simplejavacalculator.Calculator$MonoOperatorModes: void <clinit>()>/$numconstant4	$numconstant4
<simplejavacalculator.Calculator$MonoOperatorModes: void <clinit>()>/$numconstant1	$numconstant1
<simplejavacalculator.Calculator$MonoOperatorModes: void <clinit>()>/$numconstant3	$numconstant3
<simplejavacalculator.Calculator: java.lang.Double calculateMono(simplejavacalculator.Calculator$MonoOperatorModes,java.lang.Double)>/$stack46	$stack46
<simplejavacalculator.UI: void init()>/$numconstant1	$numconstant1
<simplejavacalculator.UI: void init()>/$numconstant4	$numconstant4
<simplejavacalculator.UI: void init()>/$numconstant0	$numconstant0
<simplejavacalculator.Calculator$MonoOperatorModes: void <clinit>()>/$numconstant8	$numconstant8
<simplejavacalculator.UI: void actionPerformed(java.awt.event.ActionEvent)>/$stack119	$stack119
<simplejavacalculator.UI: void <init>()>/$numconstant0	$numconstant0
<simplejavacalculator.UI: void <init>()>/$numconstant1	$numconstant1
<simplejavacalculator.UI: void <init>()>/$numconstant6	$numconstant6
<simplejavacalculator.UI: void <init>()>/$numconstant2	$numconstant2
<simplejavacalculator.UI: void <init>()>/$numconstant4	$numconstant4
<simplejavacalculator.UI: void <init>()>/$numconstant3	$numconstant3
<simplejavacalculator.UI: void <init>()>/$stack50	$stack50
<simplejavacalculator.UI: void <init>()>/$numconstant5	$numconstant5
<simplejavacalculator.UI: void init()>/$null0	$null0
<simplejavacalculator.UI: void parsetoBinary()>/$stack16	$stack16
<simplejavacalculator.UI: void parsetoBinary()>/$stack9	$stack9
<simplejavacalculator.UI: void init()>/$stack203	$stack203
<simplejavacalculator.UI: void init()>/$stack181	$stack181
<simplejavacalculator.UI: void parsetoBinary()>/$stack4	$stack4
<simplejavacalculator.UI: void init()>/$stack208	$stack208
<simplejavacalculator.UI: void parsetoBinary()>/$stack14	$stack14
<simplejavacalculator.UI: void init()>/$stack109	$stack109
<simplejavacalculator.UI: void init()>/$stack105	$stack105
<simplejavacalculator.UI: void init()>/$stack65	$stack65
<simplejavacalculator.UI: void init()>/$stack61	$stack61
<simplejavacalculator.UI: void init()>/$stack57	$stack57
<simplejavacalculator.UI: void actionPerformed(java.awt.event.ActionEvent)>/$stack122	$stack122
<simplejavacalculator.UI: void init()>/$stack81	$stack81
<simplejavacalculator.UI: void init()>/$stack89	$stack89
<simplejavacalculator.UI: void init()>/$stack85	$stack85
<simplejavacalculator.UI: void init()>/$stack129	$stack129
<simplejavacalculator.UI: void init()>/$stack113	$stack113
<simplejavacalculator.UI: void actionPerformed(java.awt.event.ActionEvent)>/$stack118	$stack118
<simplejavacalculator.Calculator: java.lang.Double calculateBiImpl()>/$stack31	$stack31
<simplejavacalculator.Calculator: java.lang.Double calculateMono(simplejavacalculator.Calculator$MonoOperatorModes,java.lang.Double)>/$stack24	$stack24
<simplejavacalculator.Calculator: java.lang.Double calculateMono(simplejavacalculator.Calculator$MonoOperatorModes,java.lang.Double)>/$stack42	$stack42
<simplejavacalculator.Calculator: java.lang.Double calculateBiImpl()>/$stack37	$stack37
<simplejavacalculator.Calculator: java.lang.Double calculateEqual(java.lang.Double)>/$stack3	$stack3
<simplejavacalculator.Calculator: java.lang.Double calculateMono(simplejavacalculator.Calculator$MonoOperatorModes,java.lang.Double)>/$stack33	$stack33
<simplejavacalculator.Calculator: java.lang.Double calculateBiImpl()>/$stack19	$stack19
<simplejavacalculator.Calculator: java.lang.Double calculateMono(simplejavacalculator.Calculator$MonoOperatorModes,java.lang.Double)>/$stack38	$stack38
<simplejavacalculator.Calculator: java.lang.Double calculateMono(simplejavacalculator.Calculator$MonoOperatorModes,java.lang.Double)>/$stack56	$stack56
<simplejavacalculator.Calculator: java.lang.Double calculateMono(simplejavacalculator.Calculator$MonoOperatorModes,java.lang.Double)>/$stack18	$stack18
<simplejavacalculator.Calculator: java.lang.Double calculateBiImpl()>/$stack47	$stack47
<simplejavacalculator.Calculator: java.lang.Double calculateBiImpl()>/$stack25	$stack25
<simplejavacalculator.Calculator: java.lang.Double calculateBi(simplejavacalculator.Calculator$BiOperatorModes,java.lang.Double)>/$stack8	$stack8
<simplejavacalculator.Calculator: java.lang.Double calculateMono(simplejavacalculator.Calculator$MonoOperatorModes,java.lang.Double)>/$stack52	$stack52
<simplejavacalculator.Calculator: java.lang.Double reset()>/$stack4	$stack4
<simplejavacalculator.Calculator: java.lang.Double calculateMono(simplejavacalculator.Calculator$MonoOperatorModes,java.lang.Double)>/$stack15	$stack15
<simplejavacalculator.Calculator: java.lang.Double calculateMono(simplejavacalculator.Calculator$MonoOperatorModes,java.lang.Double)>/$stack45	$stack45
<simplejavacalculator.Calculator: java.lang.Double calculateMono(simplejavacalculator.Calculator$MonoOperatorModes,java.lang.Double)>/$stack49	$stack49
<simplejavacalculator.Calculator: java.lang.Double calculateMono(simplejavacalculator.Calculator$MonoOperatorModes,java.lang.Double)>/$stack21	$stack21
<simplejavacalculator.UI: void actionPerformed(java.awt.event.ActionEvent)>/$stack95	$stack95
<simplejavacalculator.UI: void actionPerformed(java.awt.event.ActionEvent)>/$stack42	$stack42
<simplejavacalculator.UI: void writer(java.lang.Double)>/$stack2	$stack2
<simplejavacalculator.UI: void init()>/$stack87	$stack87
<simplejavacalculator.UI: void init()>/$stack137	$stack137
<simplejavacalculator.Calculator: java.lang.Double calculateBiImpl()>/$stack27	$stack27
<simplejavacalculator.UI: void init()>/$stack100	$stack100
<simplejavacalculator.UI: void init()>/$stack167	$stack167
<simplejavacalculator.UI: void writer(java.lang.Double)>/$stack3	$stack3
<simplejavacalculator.UI: void init()>/$stack134	$stack134
<simplejavacalculator.UI: void actionPerformed(java.awt.event.ActionEvent)>/$stack47	$stack47
<simplejavacalculator.UI: void actionPerformed(java.awt.event.ActionEvent)>/$stack108	$stack108
<simplejavacalculator.UI: void init()>/$stack103	$stack103
<simplejavacalculator.Calculator: java.lang.Double calculateBiImpl()>/$stack18	$stack18
<simplejavacalculator.Calculator: java.lang.Double calculateBiImpl()>/$stack39	$stack39
<simplejavacalculator.Calculator: java.lang.Double calculateMono(simplejavacalculator.Calculator$MonoOperatorModes,java.lang.Double)>/$stack51	$stack51
<simplejavacalculator.UI: void actionPerformed(java.awt.event.ActionEvent)>/$stack71	$stack71
<simplejavacalculator.Calculator: java.lang.Double calculateBiImpl()>/$stack17	$stack17
<simplejavacalculator.UI: void init()>/$stack118	$stack118
<simplejavacalculator.Calculator: java.lang.Double calculateBiImpl()>/$stack21	$stack21
<simplejavacalculator.UI: void actionPerformed(java.awt.event.ActionEvent)>/$stack65	$stack65
<simplejavacalculator.UI: void actionPerformed(java.awt.event.ActionEvent)>/$stack25	$stack25
<simplejavacalculator.UI: void actionPerformed(java.awt.event.ActionEvent)>/$stack59	$stack59
<simplejavacalculator.UI: void init()>/$stack93	$stack93
<simplejavacalculator.UI: void init()>/$stack94	$stack94
<simplejavacalculator.UI: void actionPerformed(java.awt.event.ActionEvent)>/$stack48	$stack48
<simplejavacalculator.UI: void init()>/$stack59	$stack59
<simplejavacalculator.UI: void actionPerformed(java.awt.event.ActionEvent)>/$stack66	$stack66
<simplejavacalculator.Calculator: java.lang.Double calculateMono(simplejavacalculator.Calculator$MonoOperatorModes,java.lang.Double)>/$stack40	$stack40
<simplejavacalculator.UI: void parsetoBinary()>/$stack10	$stack10
<simplejavacalculator.UI: void init()>/$stack164	$stack164
<simplejavacalculator.UI: void actionPerformed(java.awt.event.ActionEvent)>/i	i
<simplejavacalculator.UI: void init()>/$stack73	$stack73
<simplejavacalculator.UI: void init()>/$stack121	$stack121
<simplejavacalculator.UI: void init()>/$stack152	$stack152
<simplejavacalculator.UI: void actionPerformed(java.awt.event.ActionEvent)>/$stack54	$stack54
<simplejavacalculator.UI: void init()>/$stack97	$stack97
<simplejavacalculator.UI: void actionPerformed(java.awt.event.ActionEvent)>/$stack107	$stack107
<simplejavacalculator.Calculator: java.lang.Double calculateMono(simplejavacalculator.Calculator$MonoOperatorModes,java.lang.Double)>/$stack50	$stack50
<simplejavacalculator.Calculator: java.lang.Double calculateBiImpl()>/$stack23	$stack23
<simplejavacalculator.UI: void init()>/$stack69	$stack69
<simplejavacalculator.Calculator: java.lang.Double calculateMono(simplejavacalculator.Calculator$MonoOperatorModes,java.lang.Double)>/$stack34	$stack34
<simplejavacalculator.UI: void init()>/$stack143	$stack143
<simplejavacalculator.Calculator: java.lang.Double calculateMono(simplejavacalculator.Calculator$MonoOperatorModes,java.lang.Double)>/$stack16	$stack16
<simplejavacalculator.UI: void actionPerformed(java.awt.event.ActionEvent)>/$stack101	$stack101
<simplejavacalculator.Calculator: java.lang.Double calculateMono(simplejavacalculator.Calculator$MonoOperatorModes,java.lang.Double)>/$stack22	$stack22
<simplejavacalculator.UI: void <init>()>/i	i
<simplejavacalculator.UI: void init()>/$stack146	$stack146
<simplejavacalculator.Calculator: java.lang.Double calculateMono(simplejavacalculator.Calculator$MonoOperatorModes,java.lang.Double)>/$stack13	$stack13
<simplejavacalculator.Calculator: java.lang.Double calculateMono(simplejavacalculator.Calculator$MonoOperatorModes,java.lang.Double)>/$stack25	$stack25
<simplejavacalculator.UI: void init()>/$stack49	$stack49
<simplejavacalculator.Calculator: java.lang.Double calculateMono(simplejavacalculator.Calculator$MonoOperatorModes,java.lang.Double)>/$stack47	$stack47
<simplejavacalculator.Calculator: java.lang.Double calculateMono(simplejavacalculator.Calculator$MonoOperatorModes,java.lang.Double)>/$stack19	$stack19
<simplejavacalculator.UI: void actionPerformed(java.awt.event.ActionEvent)>/$stack72	$stack72
<simplejavacalculator.UI: void init()>/$stack107	$stack107
<simplejavacalculator.UI: void init()>/$stack176	$stack176
<simplejavacalculator.UI: void init()>/$stack179	$stack179
<simplejavacalculator.UI: void init()>/$stack161	$stack161
<simplejavacalculator.UI: void init()>/$stack124	$stack124
<simplejavacalculator.UI: void parsetoBinary()>/$stack6	$stack6
<simplejavacalculator.Calculator: java.lang.Double calculateMono(simplejavacalculator.Calculator$MonoOperatorModes,java.lang.Double)>/$stack43	$stack43
<simplejavacalculator.Calculator: java.lang.Double calculateBiImpl()>/$stack33	$stack33
<simplejavacalculator.UI: void init()>/$stack133	$stack133
<simplejavacalculator.UI: void init()>/$stack111	$stack111
<simplejavacalculator.UI: void writer(java.lang.Double)>/$stack5	$stack5
<simplejavacalculator.UI: void actionPerformed(java.awt.event.ActionEvent)>/$stack102	$stack102
<simplejavacalculator.UI: void init()>/$stack117	$stack117
<simplejavacalculator.UI: void init()>/$stack201	$stack201
<simplejavacalculator.UI: void actionPerformed(java.awt.event.ActionEvent)>/$stack114	$stack114
<simplejavacalculator.UI: void writer(java.lang.Double)>/$stack6	$stack6
<simplejavacalculator.UI: void init()>/$stack131	$stack131
<simplejavacalculator.UI: void init()>/$stack91	$stack91
<simplejavacalculator.Calculator: java.lang.Double calculateBiImpl()>/$stack45	$stack45
<simplejavacalculator.Calculator: java.lang.Double calculateMono(simplejavacalculator.Calculator$MonoOperatorModes,java.lang.Double)>/$stack32	$stack32
<simplejavacalculator.UI: void actionPerformed(java.awt.event.ActionEvent)>/$stack60	$stack60
<simplejavacalculator.UI: void init()>/$stack158	$stack158
<simplejavacalculator.Calculator: java.lang.Double calculateMono(simplejavacalculator.Calculator$MonoOperatorModes,java.lang.Double)>/$stack53	$stack53
<simplejavacalculator.Calculator: java.lang.Double calculateMono(simplejavacalculator.Calculator$MonoOperatorModes,java.lang.Double)>/$stack44	$stack44
<simplejavacalculator.Calculator: java.lang.Double calculateMono(simplejavacalculator.Calculator$MonoOperatorModes,java.lang.Double)>/$stack14	$stack14
<simplejavacalculator.UI: void init()>/$stack115	$stack115
<simplejavacalculator.UI: void init()>/$stack67	$stack67
<simplejavacalculator.UI: void parsetoBinary()>/$stack15	$stack15
<simplejavacalculator.UI: void init()>/$stack79	$stack79
<simplejavacalculator.UI: void actionPerformed(java.awt.event.ActionEvent)>/$stack83	$stack83
<simplejavacalculator.Calculator: java.lang.Double calculateMono(simplejavacalculator.Calculator$MonoOperatorModes,java.lang.Double)>/$stack28	$stack28
<simplejavacalculator.UI: void actionPerformed(java.awt.event.ActionEvent)>/$stack29	$stack29
<simplejavacalculator.UI: void init()>/$stack140	$stack140
<simplejavacalculator.UI: void <init>()>/$stack49	$stack49
<simplejavacalculator.UI: void actionPerformed(java.awt.event.ActionEvent)>/$stack89	$stack89
<simplejavacalculator.UI: void parsetoBinary()>/$stack7	$stack7
<simplejavacalculator.Calculator: java.lang.Double calculateMono(simplejavacalculator.Calculator$MonoOperatorModes,java.lang.Double)>/$stack31	$stack31
<simplejavacalculator.UI: void init()>/$stack70	$stack70
<simplejavacalculator.UI: void actionPerformed(java.awt.event.ActionEvent)>/$stack84	$stack84
<simplejavacalculator.Calculator: java.lang.Double calculateMono(simplejavacalculator.Calculator$MonoOperatorModes,java.lang.Double)>/$stack54	$stack54
<simplejavacalculator.Calculator: java.lang.Double calculateMono(simplejavacalculator.Calculator$MonoOperatorModes,java.lang.Double)>/$stack20	$stack20
<simplejavacalculator.Calculator: java.lang.Double calculateBiImpl()>/$stack43	$stack43
<simplejavacalculator.UI: void init()>/i	i
<simplejavacalculator.UI: void actionPerformed(java.awt.event.ActionEvent)>/$stack35	$stack35
<simplejavacalculator.UI: void actionPerformed(java.awt.event.ActionEvent)>/$stack77	$stack77
<simplejavacalculator.Calculator: java.lang.Double calculateBiImpl()>/$stack15	$stack15
<simplejavacalculator.UI: void actionPerformed(java.awt.event.ActionEvent)>/$stack90	$stack90
<simplejavacalculator.UI: void actionPerformed(java.awt.event.ActionEvent)>/$stack41	$stack41
<simplejavacalculator.UI: void actionPerformed(java.awt.event.ActionEvent)>/$stack78	$stack78
<simplejavacalculator.UI: void parsetoBinary()>/$stack8	$stack8
<simplejavacalculator.UI: void init()>/$stack83	$stack83
<simplejavacalculator.Calculator: java.lang.Double calculateBiImpl()>/$stack35	$stack35
<simplejavacalculator.UI: void init()>/$stack170	$stack170
<simplejavacalculator.UI: void init()>/$stack149	$stack149
<simplejavacalculator.UI: void init()>/$stack52	$stack52
<simplejavacalculator.UI: void init()>/$stack63	$stack63
<simplejavacalculator.UI: void init()>/$stack48	$stack48
<simplejavacalculator.UI: void init()>/$stack76	$stack76
<simplejavacalculator.UI: void parsetoBinary()>/$stack17	$stack17
<simplejavacalculator.UI: void init()>/$stack9	$stack9
<simplejavacalculator.Calculator: java.lang.Double calculateBiImpl()>/$stack29	$stack29
<simplejavacalculator.Calculator: java.lang.Double calculateMono(simplejavacalculator.Calculator$MonoOperatorModes,java.lang.Double)>/$stack41	$stack41
<simplejavacalculator.UI: void actionPerformed(java.awt.event.ActionEvent)>/$stack53	$stack53
<simplejavacalculator.UI: void init()>/$stack173	$stack173
<simplejavacalculator.UI: void init()>/$stack127	$stack127
<simplejavacalculator.UI: void init()>/$stack55	$stack55
<simplejavacalculator.UI: void init()>/$stack155	$stack155
<simplejavacalculator.UI: void actionPerformed(java.awt.event.ActionEvent)>/$stack30	$stack30
<simplejavacalculator.UI: void actionPerformed(java.awt.event.ActionEvent)>/$stack96	$stack96
<simplejavacalculator.UI: void actionPerformed(java.awt.event.ActionEvent)>/$stack36	$stack36
<simplejavacalculator.UI: void actionPerformed(java.awt.event.ActionEvent)>/$stack113	$stack113
