<simplejavacalculator.UI: void init()>/read-field-font/2	<simplejavacalculator.UI: void init()>/$stack15	0
<simplejavacalculator.UI: void init()>/read-field-butEqual/1	<simplejavacalculator.UI: void init()>/$stack119	0
<simplejavacalculator.UI: void init()>/read-field-panelSub3/2	<simplejavacalculator.UI: void init()>/$stack90	0
<simplejavacalculator.UI: void init()>/read-field-butabs/1	<simplejavacalculator.UI: void init()>/$stack171	0
<simplejavacalculator.UI: void init()>/read-field-panelSub3/4	<simplejavacalculator.UI: void init()>/$stack96	0
<simplejavacalculator.UI: void init()>/read-field-panelSub4/4	<simplejavacalculator.UI: void init()>/$stack120	0
<simplejavacalculator.UI: void init()>/read-field-butDivide/0	<simplejavacalculator.UI: void init()>/$stack20	0
<simplejavacalculator.UI: void init()>/read-field-font/9	<simplejavacalculator.UI: void init()>/$stack29	0
<simplejavacalculator.UI: void actionPerformed(java.awt.event.ActionEvent)>/read-field-butMinus/0	<simplejavacalculator.UI: void actionPerformed(java.awt.event.ActionEvent)>/$stack6	0
<simplejavacalculator.UI: void init()>/read-field-frame/6	<simplejavacalculator.UI: void init()>/$stack200	0
<simplejavacalculator.UI: void actionPerformed(java.awt.event.ActionEvent)>/read-field-butCancel/0	<simplejavacalculator.UI: void actionPerformed(java.awt.event.ActionEvent)>/$stack20	0
<simplejavacalculator.UI: void init()>/read-field-butTan/0	<simplejavacalculator.UI: void init()>/$stack34	0
<simplejavacalculator.UI: void actionPerformed(java.awt.event.ActionEvent)>/read-field-calc/3	<simplejavacalculator.UI: void actionPerformed(java.awt.event.ActionEvent)>/$stack93	0
<simplejavacalculator.UI: void init()>/read-field-butAdd/0	<simplejavacalculator.UI: void init()>/$stack14	0
<simplejavacalculator.UI: void init()>/read-field-font/12	<simplejavacalculator.UI: void init()>/$stack35	0
<simplejavacalculator.UI: void init()>/read-field-panelSub2/1	<simplejavacalculator.UI: void init()>/$stack62	0
<simplejavacalculator.UI: void init()>/read-field-frame/3	<simplejavacalculator.UI: void init()>/$stack5	0
<simplejavacalculator.UI: void init()>/read-field-panel/7	<simplejavacalculator.UI: void init()>/$stack163	0
<simplejavacalculator.UI: void init()>/read-field-panelSub3/6	<simplejavacalculator.UI: void init()>/$stack101	0
<simplejavacalculator.UI: void init()>/read-field-frame/5	<simplejavacalculator.UI: void init()>/$stack8	0
<simplejavacalculator.UI: void init()>/read-field-frame/2	<simplejavacalculator.UI: void init()>/$stack4	0
<simplejavacalculator.UI: void init()>/read-field-panel/4	<simplejavacalculator.UI: void init()>/$stack126	0
<simplejavacalculator.UI: void init()>/read-field-panelSub4/5	<simplejavacalculator.UI: void init()>/$stack123	0
<simplejavacalculator.UI: void init()>/read-field-butrate/1	<simplejavacalculator.UI: void init()>/$stack168	0
<simplejavacalculator.UI: void init()>/read-field-frame/4	<simplejavacalculator.UI: void init()>/$stack6	0
<simplejavacalculator.UI: void init()>/read-field-panelSub1/1	<simplejavacalculator.UI: void init()>/$stack53	0
<simplejavacalculator.UI: void actionPerformed(java.awt.event.ActionEvent)>/read-field-but/0	<simplejavacalculator.UI: void actionPerformed(java.awt.event.ActionEvent)>/$stack117	0
<simplejavacalculator.UI: void init()>/read-field-font/4	<simplejavacalculator.UI: void init()>/$stack19	0
<simplejavacalculator.Calculator: java.lang.Double calculateBi(simplejavacalculator.Calculator$BiOperatorModes,java.lang.Double)>/read-field-num1/0	<simplejavacalculator.Calculator: java.lang.Double calculateBi(simplejavacalculator.Calculator$BiOperatorModes,java.lang.Double)>/$stack6	0
<simplejavacalculator.UI: void init()>/read-field-font/15	<simplejavacalculator.UI: void init()>/$stack41	0
<simplejavacalculator.UI: void init()>/read-field-panel/8	<simplejavacalculator.UI: void init()>/$stack178	0
<simplejavacalculator.UI: void init()>/read-field-but/10	<simplejavacalculator.UI: void init()>/$stack128	0
<simplejavacalculator.UI: void init()>/read-field-but/11	<simplejavacalculator.UI: void init()>/$stack180	0
<simplejavacalculator.UI: void init()>/read-field-panelSub4/0	<simplejavacalculator.UI: void init()>/$stack106	0
<simplejavacalculator.UI: void init()>/read-field-panelSub5/0	<simplejavacalculator.UI: void init()>/$stack130	0
<simplejavacalculator.UI: void init()>/read-field-panel/6	<simplejavacalculator.UI: void init()>/$stack151	0
<simplejavacalculator.UI: void init()>/read-field-panelSub2/4	<simplejavacalculator.UI: void init()>/$stack72	0
<simplejavacalculator.UI: void init()>/read-field-panelSub8/1	<simplejavacalculator.UI: void init()>/$stack169	0
<simplejavacalculator.UI: void actionPerformed(java.awt.event.ActionEvent)>/read-field-buttonValue/0	<simplejavacalculator.UI: void actionPerformed(java.awt.event.ActionEvent)>/$stack121	0
<simplejavacalculator.UI: void init()>/read-field-panelSub4/6	<simplejavacalculator.UI: void init()>/$stack125	0
<simplejavacalculator.UI: void actionPerformed(java.awt.event.ActionEvent)>/read-field-calc/13	<simplejavacalculator.UI: void actionPerformed(java.awt.event.ActionEvent)>/$stack33	0
<simplejavacalculator.UI: void actionPerformed(java.awt.event.ActionEvent)>/read-field-butxpowerofy/0	<simplejavacalculator.UI: void actionPerformed(java.awt.event.ActionEvent)>/$stack9	0
<simplejavacalculator.UI: void init()>/read-field-panel/3	<simplejavacalculator.UI: void init()>/$stack102	0
<simplejavacalculator.UI: void init()>/read-field-panelSub6/3	<simplejavacalculator.UI: void init()>/$stack148	0
<simplejavacalculator.UI: void init()>/read-field-butAdd/2	<simplejavacalculator.UI: void init()>/$stack182	0
<simplejavacalculator.UI: void actionPerformed(java.awt.event.ActionEvent)>/read-field-butabs/0	<simplejavacalculator.UI: void actionPerformed(java.awt.event.ActionEvent)>/$stack18	0
<simplejavacalculator.UI: void init()>/read-field-panelSub3/3	<simplejavacalculator.UI: void init()>/$stack92	0
<simplejavacalculator.UI: void init()>/read-field-but/4	<simplejavacalculator.UI: void init()>/$stack80	0
<simplejavacalculator.UI: void init()>/read-field-butCancel/1	<simplejavacalculator.UI: void init()>/$stack122	0
<simplejavacalculator.UI: void init()>/read-field-butMinus/1	<simplejavacalculator.UI: void init()>/$stack74	0
<simplejavacalculator.UI: void init()>/read-field-but/8	<simplejavacalculator.UI: void init()>/$stack108	0
<simplejavacalculator.UI: void init()>/read-field-font/1	<simplejavacalculator.UI: void init()>/$stack13	0
<simplejavacalculator.UI: void init()>/read-field-panelSub3/1	<simplejavacalculator.UI: void init()>/$stack86	0
<simplejavacalculator.UI: void init()>/read-field-butSquareRoot/1	<simplejavacalculator.UI: void init()>/$stack141	0
<simplejavacalculator.UI: void actionPerformed(java.awt.event.ActionEvent)>/read-field-calc/15	<simplejavacalculator.UI: void actionPerformed(java.awt.event.ActionEvent)>/$stack24	0
<simplejavacalculator.UI: void init()>/read-field-panelSub3/5	<simplejavacalculator.UI: void init()>/$stack99	0
<simplejavacalculator.UI: void init()>/read-field-font/8	<simplejavacalculator.UI: void init()>/$stack27	0
<simplejavacalculator.UI: void init()>/read-field-butMultiply/1	<simplejavacalculator.UI: void init()>/$stack95	0
<simplejavacalculator.UI: void init()>/read-field-but/0	<simplejavacalculator.UI: void init()>/$stack206	0
<simplejavacalculator.UI: void actionPerformed(java.awt.event.ActionEvent)>/read-field-butMultiply/0	<simplejavacalculator.UI: void actionPerformed(java.awt.event.ActionEvent)>/$stack7	0
<simplejavacalculator.UI: void init()>/read-field-but/12	<simplejavacalculator.UI: void init()>/$stack202	0
<simplejavacalculator.UI: void init()>/read-field-butDivide/1	<simplejavacalculator.UI: void init()>/$stack98	0
<simplejavacalculator.UI: void init()>/read-field-font/10	<simplejavacalculator.UI: void init()>/$stack31	0
<simplejavacalculator.UI: void init()>/read-field-butlog/0	<simplejavacalculator.UI: void init()>/$stack38	0
<simplejavacalculator.UI: void actionPerformed(java.awt.event.ActionEvent)>/read-field-calc/12	<simplejavacalculator.UI: void actionPerformed(java.awt.event.ActionEvent)>/$stack39	0
<simplejavacalculator.UI: void actionPerformed(java.awt.event.ActionEvent)>/read-field-calc/4	<simplejavacalculator.UI: void actionPerformed(java.awt.event.ActionEvent)>/$stack87	0
<simplejavacalculator.UI: void actionPerformed(java.awt.event.ActionEvent)>/read-field-calc/14	<simplejavacalculator.UI: void actionPerformed(java.awt.event.ActionEvent)>/$stack28	0
<simplejavacalculator.UI: void init()>/read-field-panel/9	<simplejavacalculator.UI: void init()>/$stack199	0
<simplejavacalculator.UI: void actionPerformed(java.awt.event.ActionEvent)>/read-field-calc/7	<simplejavacalculator.UI: void actionPerformed(java.awt.event.ActionEvent)>/$stack69	0
<simplejavacalculator.UI: void <init>()>/read-field-but/0	<simplejavacalculator.UI: void <init>()>/$stack51	0
<simplejavacalculator.UI: void actionPerformed(java.awt.event.ActionEvent)>/read-field-calc/11	<simplejavacalculator.UI: void actionPerformed(java.awt.event.ActionEvent)>/$stack45	0
<simplejavacalculator.UI: void init()>/read-field-but/9	<simplejavacalculator.UI: void init()>/$stack112	0
<simplejavacalculator.UI: void init()>/read-field-butAdd/1	<simplejavacalculator.UI: void init()>/$stack71	0
<simplejavacalculator.UI: void init()>/read-field-butTan/1	<simplejavacalculator.UI: void init()>/$stack159	0
<simplejavacalculator.UI: void init()>/read-field-panelSub8/0	<simplejavacalculator.UI: void init()>/$stack166	0
<simplejavacalculator.UI: void init()>/read-field-but/6	<simplejavacalculator.UI: void init()>/$stack88	0
<simplejavacalculator.UI: void init()>/read-field-panelSub2/6	<simplejavacalculator.UI: void init()>/$stack77	0
<simplejavacalculator.UI: void init()>/read-field-panelSub6/4	<simplejavacalculator.UI: void init()>/$stack150	0
<simplejavacalculator.UI: void init()>/read-field-butCancel/0	<simplejavacalculator.UI: void init()>/$stack44	0
<simplejavacalculator.UI: void actionPerformed(java.awt.event.ActionEvent)>/read-field-butrate/0	<simplejavacalculator.UI: void actionPerformed(java.awt.event.ActionEvent)>/$stack17	0
<simplejavacalculator.UI: void init()>/read-field-font/3	<simplejavacalculator.UI: void init()>/$stack17	0
<simplejavacalculator.UI: void init()>/read-field-panelSub8/4	<simplejavacalculator.UI: void init()>/$stack177	0
<simplejavacalculator.UI: void init()>/read-field-frame/0	<simplejavacalculator.UI: void init()>/$stack2	0
<simplejavacalculator.UI: void init()>/read-field-panelSub2/0	<simplejavacalculator.UI: void init()>/$stack58	0
<simplejavacalculator.UI: void init()>/read-field-panelSub4/2	<simplejavacalculator.UI: void init()>/$stack114	0
<simplejavacalculator.UI: void actionPerformed(java.awt.event.ActionEvent)>/read-field-calc/2	<simplejavacalculator.UI: void actionPerformed(java.awt.event.ActionEvent)>/$stack99	0
<simplejavacalculator.UI: void init()>/read-field-panelSub4/3	<simplejavacalculator.UI: void init()>/$stack116	0
<simplejavacalculator.UI: void init()>/read-field-but/5	<simplejavacalculator.UI: void init()>/$stack84	0
<simplejavacalculator.UI: void init()>/read-field-butEqual/0	<simplejavacalculator.UI: void init()>/$stack22	0
<simplejavacalculator.UI: void init()>/read-field-butlog/1	<simplejavacalculator.UI: void init()>/$stack165	0
<simplejavacalculator.UI: void actionPerformed(java.awt.event.ActionEvent)>/read-field-calc/6	<simplejavacalculator.UI: void actionPerformed(java.awt.event.ActionEvent)>/$stack75	0
<simplejavacalculator.UI: void init()>/read-field-panel/2	<simplejavacalculator.UI: void init()>/$stack78	0
<simplejavacalculator.UI: void actionPerformed(java.awt.event.ActionEvent)>/read-field-butEqual/0	<simplejavacalculator.UI: void actionPerformed(java.awt.event.ActionEvent)>/$stack19	0
<simplejavacalculator.UI: void actionPerformed(java.awt.event.ActionEvent)>/read-field-calc/1	<simplejavacalculator.UI: void actionPerformed(java.awt.event.ActionEvent)>/$stack105	0
<simplejavacalculator.UI: void init()>/read-field-butxpowerofy/1	<simplejavacalculator.UI: void init()>/$stack147	0
<simplejavacalculator.UI: void init()>/read-field-butCancel/2	<simplejavacalculator.UI: void init()>/$stack198	0
<simplejavacalculator.UI: void init()>/read-field-butlog/2	<simplejavacalculator.UI: void init()>/$stack193	1
<simplejavacalculator.UI: void init()>/read-field-butlog/2	<simplejavacalculator.UI: void init()>/$stack193	10
<simplejavacalculator.UI: void init()>/read-field-font/13	<simplejavacalculator.UI: void init()>/$stack37	1
<simplejavacalculator.UI: void init()>/read-field-font/13	<simplejavacalculator.UI: void init()>/$stack37	10
<simplejavacalculator.UI: void init()>/read-field-butrate/0	<simplejavacalculator.UI: void init()>/$stack40	1
<simplejavacalculator.UI: void init()>/read-field-butrate/0	<simplejavacalculator.UI: void init()>/$stack40	10
<simplejavacalculator.UI: void init()>/read-field-panelSub7/2	<simplejavacalculator.UI: void init()>/$stack160	1
<simplejavacalculator.UI: void init()>/read-field-panelSub7/2	<simplejavacalculator.UI: void init()>/$stack160	10
<simplejavacalculator.UI: void init()>/read-field-butSin/1	<simplejavacalculator.UI: void init()>/$stack156	1
<simplejavacalculator.UI: void init()>/read-field-butSin/1	<simplejavacalculator.UI: void init()>/$stack156	10
new_var_12	<simplejavacalculator.UI: void init()>/$stack45	1
<simplejavacalculator.UI: void init()>/read-field-butSquare/2	<simplejavacalculator.UI: void init()>/$stack186	1
<simplejavacalculator.UI: void init()>/read-field-butSquare/2	<simplejavacalculator.UI: void init()>/$stack186	10
<simplejavacalculator.UI: void actionPerformed(java.awt.event.ActionEvent)>/read-field-butBinary/0	<simplejavacalculator.UI: void actionPerformed(java.awt.event.ActionEvent)>/$stack21	1
<simplejavacalculator.UI: void actionPerformed(java.awt.event.ActionEvent)>/read-field-butBinary/0	<simplejavacalculator.UI: void actionPerformed(java.awt.event.ActionEvent)>/$stack21	10
new_var_10	<simplejavacalculator.Calculator: java.lang.Double calculateBiImpl()>/$stack4	1
<simplejavacalculator.Calculator: java.lang.Double calculateBiImpl()>/read-field-num2/6	<simplejavacalculator.Calculator: java.lang.Double calculateBiImpl()>/$stack16	1
<simplejavacalculator.Calculator: java.lang.Double calculateBiImpl()>/read-field-num2/6	<simplejavacalculator.Calculator: java.lang.Double calculateBiImpl()>/$stack16	10
<simplejavacalculator.UI: void init()>/read-field-panel/5	<simplejavacalculator.UI: void init()>/$stack136	10
<simplejavacalculator.UI: void init()>/read-field-panel/5	<simplejavacalculator.UI: void actionPerformed(java.awt.event.ActionEvent)>/$stack16	1
<simplejavacalculator.UI: void init()>/read-field-but/2	<simplejavacalculator.UI: void init()>/$stack60	1
<simplejavacalculator.UI: void init()>/read-field-but/2	<simplejavacalculator.UI: void init()>/$stack60	10
<simplejavacalculator.UI: void init()>/read-field-butBinary/2	<simplejavacalculator.UI: void init()>/$stack196	1
<simplejavacalculator.UI: void init()>/read-field-butBinary/2	<simplejavacalculator.UI: void init()>/$stack196	10
<simplejavacalculator.UI: void actionPerformed(java.awt.event.ActionEvent)>/read-field-text/0	<simplejavacalculator.UI: void actionPerformed(java.awt.event.ActionEvent)>/$stack123	1
<simplejavacalculator.UI: void actionPerformed(java.awt.event.ActionEvent)>/read-field-text/0	<simplejavacalculator.UI: void actionPerformed(java.awt.event.ActionEvent)>/$stack123	10
<simplejavacalculator.Calculator: java.lang.Double calculateBiImpl()>/read-field-mode/5	<simplejavacalculator.Calculator: java.lang.Double calculateBiImpl()>/$stack12	1
<simplejavacalculator.Calculator: java.lang.Double calculateBiImpl()>/read-field-mode/5	<simplejavacalculator.Calculator: java.lang.Double calculateBiImpl()>/$stack12	10
<simplejavacalculator.UI: void init()>/read-field-panel/0	<simplejavacalculator.UI: void init()>/$stack47	1
<simplejavacalculator.UI: void init()>/read-field-panel/0	<simplejavacalculator.UI: void init()>/$stack47	10
new_var_9	<simplejavacalculator.Calculator: java.lang.Double calculateBiImpl()>/$stack22	1
<simplejavacalculator.Calculator: java.lang.Double calculateBiImpl()>/read-field-num1/0	<simplejavacalculator.Calculator: java.lang.Double calculateBiImpl()>/$stack42	1
<simplejavacalculator.Calculator: java.lang.Double calculateBiImpl()>/read-field-num1/0	<simplejavacalculator.Calculator: java.lang.Double calculateBiImpl()>/$stack42	10
<simplejavacalculator.UI: void <init>()>/read-field-imageReturn/0	<simplejavacalculator.UI: void <init>()>/$stack6	1
<simplejavacalculator.UI: void <init>()>/read-field-imageReturn/0	<simplejavacalculator.UI: void <init>()>/$stack6	10
<simplejavacalculator.UI: void init()>/read-field-panelSub6/0	<simplejavacalculator.UI: void init()>/$stack139	1
<simplejavacalculator.UI: void init()>/read-field-panelSub6/0	<simplejavacalculator.UI: void init()>/$stack139	10
<simplejavacalculator.UI: void actionPerformed(java.awt.event.ActionEvent)>/read-field-butSin/0	<simplejavacalculator.UI: void actionPerformed(java.awt.event.ActionEvent)>/$stack14	1
<simplejavacalculator.UI: void actionPerformed(java.awt.event.ActionEvent)>/read-field-butSin/0	<simplejavacalculator.UI: void actionPerformed(java.awt.event.ActionEvent)>/$stack14	10
<simplejavacalculator.UI: void init()>/read-field-panel/1	<simplejavacalculator.UI: void actionPerformed(java.awt.event.ActionEvent)>/$stack11	1
<simplejavacalculator.UI: void init()>/read-field-panel/1	<simplejavacalculator.UI: void init()>/$stack54	10
<simplejavacalculator.UI: void init()>/read-field-butBinary/1	<simplejavacalculator.UI: void init()>/$stack174	1
<simplejavacalculator.UI: void init()>/read-field-butBinary/1	<simplejavacalculator.UI: void init()>/$stack174	10
<simplejavacalculator.UI: void actionPerformed(java.awt.event.ActionEvent)>/read-field-butSquare/0	<simplejavacalculator.UI: void actionPerformed(java.awt.event.ActionEvent)>/$stack10	1
<simplejavacalculator.UI: void actionPerformed(java.awt.event.ActionEvent)>/read-field-butSquare/0	<simplejavacalculator.UI: void actionPerformed(java.awt.event.ActionEvent)>/$stack10	10
<simplejavacalculator.UI: void init()>/read-field-butOneDevidedBy/1	<simplejavacalculator.UI: void init()>/$stack144	1
<simplejavacalculator.UI: void init()>/read-field-butOneDevidedBy/1	<simplejavacalculator.UI: void init()>/$stack144	10
<simplejavacalculator.UI: void init()>/read-field-panelSub7/1	<simplejavacalculator.UI: void init()>/$stack157	1
<simplejavacalculator.UI: void init()>/read-field-panelSub7/1	<simplejavacalculator.UI: void init()>/$stack157	10
<simplejavacalculator.UI: void actionPerformed(java.awt.event.ActionEvent)>/read-field-calc/10	<simplejavacalculator.UI: void actionPerformed(java.awt.event.ActionEvent)>/$stack51	1
<simplejavacalculator.UI: void actionPerformed(java.awt.event.ActionEvent)>/read-field-calc/10	<simplejavacalculator.UI: void actionPerformed(java.awt.event.ActionEvent)>/$stack51	10
<simplejavacalculator.UI: void init()>/read-field-but/3	<simplejavacalculator.UI: void init()>/$stack7	1
<simplejavacalculator.UI: void init()>/read-field-but/3	<simplejavacalculator.UI: void init()>/$stack64	10
<simplejavacalculator.UI: void actionPerformed(java.awt.event.ActionEvent)>/read-field-butTan/0	<simplejavacalculator.UI: void actionPerformed(java.awt.event.ActionEvent)>/$stack15	1
<simplejavacalculator.UI: void actionPerformed(java.awt.event.ActionEvent)>/read-field-butTan/0	<simplejavacalculator.UI: void actionPerformed(java.awt.event.ActionEvent)>/$stack15	10
<simplejavacalculator.Calculator: java.lang.Double calculateBiImpl()>/read-field-num1/2	<simplejavacalculator.Calculator: java.lang.Double calculateBiImpl()>/$stack32	1
<simplejavacalculator.Calculator: java.lang.Double calculateBiImpl()>/read-field-num1/2	<simplejavacalculator.Calculator: java.lang.Double calculateBiImpl()>/$stack32	10
<simplejavacalculator.UI: void init()>/read-field-butOneDevidedBy/0	<simplejavacalculator.UI: void init()>/$stack28	1
<simplejavacalculator.UI: void init()>/read-field-butOneDevidedBy/0	<simplejavacalculator.UI: void init()>/$stack28	10
<simplejavacalculator.UI: void init()>/read-field-butabs/2	<simplejavacalculator.UI: void init()>/$stack195	1
<simplejavacalculator.UI: void init()>/read-field-butabs/2	<simplejavacalculator.UI: void init()>/$stack195	10
<simplejavacalculator.UI: void actionPerformed(java.awt.event.ActionEvent)>/read-field-calc/0	<simplejavacalculator.UI: void actionPerformed(java.awt.event.ActionEvent)>/$stack111	1
<simplejavacalculator.UI: void actionPerformed(java.awt.event.ActionEvent)>/read-field-calc/0	<simplejavacalculator.UI: void actionPerformed(java.awt.event.ActionEvent)>/$stack111	10
<simplejavacalculator.Calculator: java.lang.Double calculateBiImpl()>/read-field-num2/3	<simplejavacalculator.Calculator: java.lang.Double calculateBiImpl()>/$stack34	1
<simplejavacalculator.Calculator: java.lang.Double calculateBiImpl()>/read-field-num2/3	<simplejavacalculator.Calculator: java.lang.Double calculateBiImpl()>/$stack34	10
<simplejavacalculator.Calculator: java.lang.Double calculateBiImpl()>/read-field-mode/1	<simplejavacalculator.UI: void parsetoBinary()>/$stack5	1
<simplejavacalculator.Calculator: java.lang.Double calculateBiImpl()>/read-field-mode/1	<simplejavacalculator.Calculator: java.lang.Double calculateBiImpl()>/$stack4	10
<simplejavacalculator.UI: void init()>/read-field-butBinary/0	<simplejavacalculator.UI: void init()>/$stack46	1
<simplejavacalculator.UI: void init()>/read-field-butBinary/0	<simplejavacalculator.UI: void init()>/$stack46	10
<simplejavacalculator.UI: void init()>/read-field-panelSub1/0	<simplejavacalculator.UI: void init()>/$stack51	1
<simplejavacalculator.UI: void init()>/read-field-panelSub1/0	<simplejavacalculator.UI: void init()>/$stack51	10
<simplejavacalculator.UI: void init()>/read-field-butMultiply/0	<simplejavacalculator.UI: void init()>/$stack18	1
<simplejavacalculator.UI: void init()>/read-field-butMultiply/0	<simplejavacalculator.UI: void init()>/$stack18	10
<simplejavacalculator.UI: void actionPerformed(java.awt.event.ActionEvent)>/read-field-butlog/0	<simplejavacalculator.UI: void init()>/$stack16	1
<simplejavacalculator.UI: void actionPerformed(java.awt.event.ActionEvent)>/read-field-butlog/0	<simplejavacalculator.UI: void actionPerformed(java.awt.event.ActionEvent)>/$stack16	10
<simplejavacalculator.UI: void init()>/read-field-butEqual/2	<simplejavacalculator.UI: void init()>/$stack197	1
<simplejavacalculator.UI: void init()>/read-field-butEqual/2	<simplejavacalculator.UI: void init()>/$stack197	10
<simplejavacalculator.UI: void init()>/read-field-text/0	<simplejavacalculator.UI: void init()>/$stack11	1
<simplejavacalculator.UI: void init()>/read-field-text/0	<simplejavacalculator.UI: void init()>/$stack11	10
<simplejavacalculator.UI: void actionPerformed(java.awt.event.ActionEvent)>/read-field-calc/9	<simplejavacalculator.UI: void init()>/$stack64	1
<simplejavacalculator.UI: void actionPerformed(java.awt.event.ActionEvent)>/read-field-calc/9	<simplejavacalculator.UI: void actionPerformed(java.awt.event.ActionEvent)>/$stack57	10
<simplejavacalculator.Calculator: java.lang.Double calculateBiImpl()>/read-field-num2/1	<simplejavacalculator.Calculator: java.lang.Double calculateBiImpl()>/$stack38	1
<simplejavacalculator.Calculator: java.lang.Double calculateBiImpl()>/read-field-num2/1	<simplejavacalculator.Calculator: java.lang.Double calculateBiImpl()>/$stack38	10
<simplejavacalculator.UI: void init()>/read-field-butCos/1	<simplejavacalculator.UI: void init()>/$stack153	1
<simplejavacalculator.UI: void init()>/read-field-butCos/1	<simplejavacalculator.UI: void init()>/$stack153	10
<simplejavacalculator.Calculator: java.lang.Double calculateBiImpl()>/read-field-num1/5	<simplejavacalculator.UI: void init()>/$stack21	1
<simplejavacalculator.Calculator: java.lang.Double calculateBiImpl()>/read-field-num1/5	<simplejavacalculator.Calculator: java.lang.Double calculateBiImpl()>/$stack14	10
new_var_6	<simplejavacalculator.Calculator: java.lang.Double calculateBiImpl()>/$stack28	1
<simplejavacalculator.UI: void init()>/read-field-panelSub6/2	<simplejavacalculator.UI: void init()>/$stack145	1
<simplejavacalculator.UI: void init()>/read-field-panelSub6/2	<simplejavacalculator.UI: void init()>/$stack145	10
<simplejavacalculator.UI: void init()>/read-field-panelSub2/5	<simplejavacalculator.UI: void init()>/$stack75	1
<simplejavacalculator.UI: void init()>/read-field-panelSub2/5	<simplejavacalculator.UI: void init()>/$stack75	10
<simplejavacalculator.UI: void init()>/read-field-panelSub7/0	<simplejavacalculator.UI: void init()>/$stack154	1
<simplejavacalculator.UI: void init()>/read-field-panelSub7/0	<simplejavacalculator.UI: void init()>/$stack154	10
new_var_11	<simplejavacalculator.UI: void init()>/$stack33	1
<simplejavacalculator.Calculator: java.lang.Double calculateBiImpl()>/read-field-num1/1	<simplejavacalculator.UI: void actionPerformed(java.awt.event.ActionEvent)>/$stack5	1
<simplejavacalculator.Calculator: java.lang.Double calculateBiImpl()>/read-field-num1/1	<simplejavacalculator.Calculator: java.lang.Double calculateBiImpl()>/$stack41	10
<simplejavacalculator.Calculator: java.lang.Double calculateBiImpl()>/read-field-num2/0	<simplejavacalculator.Calculator: java.lang.Double calculateBiImpl()>/$stack48	1
<simplejavacalculator.Calculator: java.lang.Double calculateBiImpl()>/read-field-num2/0	<simplejavacalculator.Calculator: java.lang.Double calculateBiImpl()>/$stack48	10
<simplejavacalculator.UI: void init()>/read-field-butSquareRoot/0	<simplejavacalculator.UI: void init()>/$stack24	10
<simplejavacalculator.UI: void init()>/read-field-butSquareRoot/0	<simplejavacalculator.Calculator: java.lang.Double calculateBiImpl()>/$stack14	1
<simplejavacalculator.Calculator: java.lang.Double calculateBi(simplejavacalculator.Calculator$BiOperatorModes,java.lang.Double)>/read-field-mode/0	<simplejavacalculator.Calculator: java.lang.Double calculateBi(simplejavacalculator.Calculator$BiOperatorModes,java.lang.Double)>/$stack4	1
<simplejavacalculator.Calculator: java.lang.Double calculateBi(simplejavacalculator.Calculator$BiOperatorModes,java.lang.Double)>/read-field-mode/0	<simplejavacalculator.Calculator: java.lang.Double calculateBi(simplejavacalculator.Calculator$BiOperatorModes,java.lang.Double)>/$stack4	10
<simplejavacalculator.UI: void init()>/read-field-font/0	<simplejavacalculator.UI: void init()>/$stack207	1
<simplejavacalculator.UI: void init()>/read-field-font/0	<simplejavacalculator.UI: void init()>/$stack207	10
<simplejavacalculator.UI: void init()>/read-field-butDivide/2	<simplejavacalculator.UI: void init()>/$stack185	1
<simplejavacalculator.UI: void init()>/read-field-butDivide/2	<simplejavacalculator.UI: void init()>/$stack185	10
new_var_7	<simplejavacalculator.Calculator: java.lang.Double calculateBiImpl()>/$stack2	1
<simplejavacalculator.Calculator: java.lang.Double calculateBiImpl()>/read-field-mode/3	<simplejavacalculator.Calculator: java.lang.Double calculateBiImpl()>/$stack8	1
<simplejavacalculator.Calculator: java.lang.Double calculateBiImpl()>/read-field-mode/3	<simplejavacalculator.Calculator: java.lang.Double calculateBiImpl()>/$stack8	10
<simplejavacalculator.UI: void init()>/read-field-butxpowerofy/2	<simplejavacalculator.UI: void init()>/$stack192	1
<simplejavacalculator.UI: void init()>/read-field-butxpowerofy/2	<simplejavacalculator.UI: void init()>/$stack192	10
<simplejavacalculator.Calculator: java.lang.Double calculateBiImpl()>/read-field-mode/4	<simplejavacalculator.Calculator: java.lang.Double calculateBiImpl()>/$stack10	1
<simplejavacalculator.Calculator: java.lang.Double calculateBiImpl()>/read-field-mode/4	<simplejavacalculator.Calculator: java.lang.Double calculateBiImpl()>/$stack10	10
new_var_14	<simplejavacalculator.UI: void init()>/$stack24	1
<simplejavacalculator.UI: void actionPerformed(java.awt.event.ActionEvent)>/read-field-butCos/0	<simplejavacalculator.UI: void actionPerformed(java.awt.event.ActionEvent)>/$stack13	10
<simplejavacalculator.UI: void actionPerformed(java.awt.event.ActionEvent)>/read-field-butCos/0	<simplejavacalculator.UI: void init()>/$stack43	1
<simplejavacalculator.UI: void init()>/read-field-but/7	<simplejavacalculator.UI: void init()>/$stack82	1
<simplejavacalculator.UI: void init()>/read-field-but/7	<simplejavacalculator.UI: void init()>/$stack104	10
<simplejavacalculator.UI: void actionPerformed(java.awt.event.ActionEvent)>/read-field-butSquareRoot/0	<simplejavacalculator.UI: void actionPerformed(java.awt.event.ActionEvent)>/$stack11	10
<simplejavacalculator.UI: void actionPerformed(java.awt.event.ActionEvent)>/read-field-butSquareRoot/0	<simplejavacalculator.UI: void init()>/$stack25	1
<simplejavacalculator.UI: void init()>/read-field-panelSub8/3	<simplejavacalculator.UI: void init()>/$stack175	1
<simplejavacalculator.UI: void init()>/read-field-panelSub8/3	<simplejavacalculator.UI: void init()>/$stack175	10
<simplejavacalculator.UI: void init()>/read-field-butabs/0	<simplejavacalculator.UI: void init()>/$stack42	1
<simplejavacalculator.UI: void init()>/read-field-butabs/0	<simplejavacalculator.UI: void init()>/$stack42	10
<simplejavacalculator.UI: void init()>/read-field-but/1	<simplejavacalculator.UI: void init()>/$stack56	1
<simplejavacalculator.UI: void init()>/read-field-but/1	<simplejavacalculator.UI: void init()>/$stack56	10
new_var_2	<simplejavacalculator.UI: void init()>/$stack54	1
<simplejavacalculator.UI: void init()>/read-field-font/11	<simplejavacalculator.UI: void init()>/$stack33	10
<simplejavacalculator.UI: void init()>/read-field-font/11	<simplejavacalculator.UI: void init()>/$stack104	1
<simplejavacalculator.UI: void init()>/read-field-text/1	<simplejavacalculator.UI: void init()>/$stack12	1
<simplejavacalculator.UI: void init()>/read-field-text/1	<simplejavacalculator.UI: void init()>/$stack12	10
<simplejavacalculator.UI: void writer(java.lang.Double)>/read-field-text/0	<simplejavacalculator.UI: void writer(java.lang.Double)>/$stack7	1
<simplejavacalculator.UI: void writer(java.lang.Double)>/read-field-text/0	<simplejavacalculator.UI: void writer(java.lang.Double)>/$stack7	10
<simplejavacalculator.UI: void init()>/read-field-panelSub6/1	<simplejavacalculator.UI: void init()>/$stack142	1
<simplejavacalculator.UI: void init()>/read-field-panelSub6/1	<simplejavacalculator.UI: void init()>/$stack142	10
<simplejavacalculator.UI: void init()>/read-field-butrate/2	<simplejavacalculator.UI: void init()>/$stack194	1
<simplejavacalculator.UI: void init()>/read-field-butrate/2	<simplejavacalculator.UI: void init()>/$stack194	10
<simplejavacalculator.UI: void init()>/read-field-frame/1	<simplejavacalculator.UI: void init()>/$stack3	1
<simplejavacalculator.UI: void init()>/read-field-frame/1	<simplejavacalculator.UI: void init()>/$stack3	10
new_var_8	<simplejavacalculator.Calculator: java.lang.Double calculateBiImpl()>/$stack20	1
<simplejavacalculator.UI: void init()>/read-field-panelSub2/2	<simplejavacalculator.UI: void init()>/$stack66	1
<simplejavacalculator.UI: void init()>/read-field-panelSub2/2	<simplejavacalculator.UI: void init()>/$stack66	10
<simplejavacalculator.UI: void init()>/read-field-butSquare/1	<simplejavacalculator.UI: void init()>/$stack138	1
<simplejavacalculator.UI: void init()>/read-field-butSquare/1	<simplejavacalculator.UI: void init()>/$stack138	10
<simplejavacalculator.UI: void init()>/read-field-font/14	<simplejavacalculator.UI: void init()>/$stack39	1
<simplejavacalculator.UI: void init()>/read-field-font/14	<simplejavacalculator.UI: void init()>/$stack39	10
<simplejavacalculator.UI: void init()>/read-field-butOneDevidedBy/2	<simplejavacalculator.UI: void init()>/$stack188	1
<simplejavacalculator.UI: void init()>/read-field-butOneDevidedBy/2	<simplejavacalculator.UI: void init()>/$stack188	10
<simplejavacalculator.UI: void init()>/read-field-panelSub4/1	<simplejavacalculator.UI: void init()>/$stack110	1
<simplejavacalculator.UI: void init()>/read-field-panelSub4/1	<simplejavacalculator.UI: void init()>/$stack110	10
new_var_4	<simplejavacalculator.UI: void actionPerformed(java.awt.event.ActionEvent)>/$stack81	1
<simplejavacalculator.UI: void init()>/read-field-textFont/0	<simplejavacalculator.UI: void init()>/$stack10	1
<simplejavacalculator.UI: void init()>/read-field-textFont/0	<simplejavacalculator.UI: void init()>/$stack10	10
<simplejavacalculator.UI: void actionPerformed(java.awt.event.ActionEvent)>/read-field-text/1	<simplejavacalculator.UI: void actionPerformed(java.awt.event.ActionEvent)>/$stack22	1
<simplejavacalculator.UI: void actionPerformed(java.awt.event.ActionEvent)>/read-field-text/1	<simplejavacalculator.UI: void actionPerformed(java.awt.event.ActionEvent)>/$stack22	10
<simplejavacalculator.UI: void init()>/read-field-panelSub7/3	<simplejavacalculator.UI: void init()>/$stack162	1
<simplejavacalculator.UI: void init()>/read-field-panelSub7/3	<simplejavacalculator.UI: void init()>/$stack162	10
<simplejavacalculator.Calculator: java.lang.Double calculateBiImpl()>/read-field-num2/4	<simplejavacalculator.UI: void <init>()>/$stack10	1
<simplejavacalculator.Calculator: java.lang.Double calculateBiImpl()>/read-field-num2/4	<simplejavacalculator.Calculator: java.lang.Double calculateBiImpl()>/$stack28	10
<simplejavacalculator.UI: void init()>/read-field-butSquare/0	<simplejavacalculator.UI: void init()>/$stack26	1
<simplejavacalculator.UI: void init()>/read-field-butSquare/0	<simplejavacalculator.UI: void init()>/$stack26	10
new_var_13	<simplejavacalculator.UI: void init()>/$stack136	1
<simplejavacalculator.UI: void init()>/read-field-panelSub5/1	<simplejavacalculator.UI: void init()>/$stack132	1
<simplejavacalculator.UI: void init()>/read-field-panelSub5/1	<simplejavacalculator.UI: void init()>/$stack132	10
<simplejavacalculator.UI: void init()>/read-field-panelSub8/2	<simplejavacalculator.UI: void init()>/$stack172	1
<simplejavacalculator.UI: void init()>/read-field-panelSub8/2	<simplejavacalculator.UI: void init()>/$stack172	10
<simplejavacalculator.Calculator: java.lang.Double calculateBiImpl()>/read-field-mode/0	<simplejavacalculator.UI: java.lang.Double reader()>/$stack3	1
<simplejavacalculator.Calculator: java.lang.Double calculateBiImpl()>/read-field-mode/0	<simplejavacalculator.Calculator: java.lang.Double calculateBiImpl()>/$stack2	10
<simplejavacalculator.UI: void init()>/read-field-butCos/0	<simplejavacalculator.UI: void init()>/$stack30	1
<simplejavacalculator.UI: void init()>/read-field-butCos/0	<simplejavacalculator.UI: void init()>/$stack30	10
new_var_3	<simplejavacalculator.UI: void actionPerformed(java.awt.event.ActionEvent)>/$stack57	1
<simplejavacalculator.UI: void init()>/read-field-butCos/2	<simplejavacalculator.UI: void init()>/$stack189	1
<simplejavacalculator.UI: void init()>/read-field-butCos/2	<simplejavacalculator.UI: void init()>/$stack189	10
<simplejavacalculator.Calculator: java.lang.Double calculateBiImpl()>/read-field-num2/5	<simplejavacalculator.Calculator: java.lang.Double calculateBiImpl()>/$stack22	10
<simplejavacalculator.Calculator: java.lang.Double calculateBiImpl()>/read-field-num2/5	<simplejavacalculator.UI: void actionPerformed(java.awt.event.ActionEvent)>/$stack8	1
<simplejavacalculator.UI: void init()>/read-field-butSin/0	<simplejavacalculator.UI: void init()>/$stack32	1
<simplejavacalculator.UI: void init()>/read-field-butSin/0	<simplejavacalculator.UI: void init()>/$stack32	10
<simplejavacalculator.UI: void init()>/read-field-font/17	<simplejavacalculator.UI: void actionPerformed(java.awt.event.ActionEvent)>/$stack13	1
<simplejavacalculator.UI: void init()>/read-field-font/17	<simplejavacalculator.UI: void init()>/$stack45	10
<simplejavacalculator.UI: void init()>/read-field-text/2	<simplejavacalculator.UI: void init()>/$stack50	1
<simplejavacalculator.UI: void init()>/read-field-text/2	<simplejavacalculator.UI: void init()>/$stack50	10
<simplejavacalculator.UI: void init()>/read-field-butSin/2	<simplejavacalculator.UI: void init()>/$stack190	1
<simplejavacalculator.UI: void init()>/read-field-butSin/2	<simplejavacalculator.UI: void init()>/$stack190	10
<simplejavacalculator.Calculator: java.lang.Double calculateBiImpl()>/read-field-num1/3	<simplejavacalculator.Calculator: java.lang.Double calculateBiImpl()>/$stack26	1
<simplejavacalculator.Calculator: java.lang.Double calculateBiImpl()>/read-field-num1/3	<simplejavacalculator.Calculator: java.lang.Double calculateBiImpl()>/$stack26	10
<simplejavacalculator.Calculator: java.lang.Double calculateBiImpl()>/read-field-num1/4	<simplejavacalculator.UI: void init()>/$stack183	1
<simplejavacalculator.Calculator: java.lang.Double calculateBiImpl()>/read-field-num1/4	<simplejavacalculator.Calculator: java.lang.Double calculateBiImpl()>/$stack20	10
new_var_5	<simplejavacalculator.Calculator: java.lang.Double calculateBiImpl()>/$stack41	1
<simplejavacalculator.UI: void init()>/read-field-panelSub2/3	<simplejavacalculator.UI: void init()>/$stack68	1
<simplejavacalculator.UI: void init()>/read-field-panelSub2/3	<simplejavacalculator.UI: void init()>/$stack68	10
<simplejavacalculator.UI: void init()>/read-field-font/6	<simplejavacalculator.UI: void init()>/$stack23	1
<simplejavacalculator.UI: void init()>/read-field-font/6	<simplejavacalculator.UI: void init()>/$stack23	10
<simplejavacalculator.Calculator: java.lang.Double calculateBiImpl()>/read-field-num2/2	<simplejavacalculator.Calculator: java.lang.Double calculateBiImpl()>/$stack44	1
<simplejavacalculator.Calculator: java.lang.Double calculateBiImpl()>/read-field-num2/2	<simplejavacalculator.Calculator: java.lang.Double calculateBiImpl()>/$stack44	10
<simplejavacalculator.UI: void init()>/read-field-butSquareRoot/2	<simplejavacalculator.UI: void init()>/$stack187	1
<simplejavacalculator.UI: void init()>/read-field-butSquareRoot/2	<simplejavacalculator.UI: void init()>/$stack187	10
<simplejavacalculator.UI: void actionPerformed(java.awt.event.ActionEvent)>/read-field-butOneDevidedBy/0	<simplejavacalculator.UI: void actionPerformed(java.awt.event.ActionEvent)>/$stack12	1
<simplejavacalculator.UI: void actionPerformed(java.awt.event.ActionEvent)>/read-field-butOneDevidedBy/0	<simplejavacalculator.UI: void actionPerformed(java.awt.event.ActionEvent)>/$stack12	10
<simplejavacalculator.UI: void init()>/read-field-butMultiply/2	<simplejavacalculator.UI: void init()>/$stack184	1
<simplejavacalculator.UI: void init()>/read-field-butMultiply/2	<simplejavacalculator.UI: void init()>/$stack184	10
<simplejavacalculator.Calculator: java.lang.Double calculateBiImpl()>/read-field-mode/2	<simplejavacalculator.Calculator: java.lang.Double calculateBiImpl()>/$stack6	1
<simplejavacalculator.Calculator: java.lang.Double calculateBiImpl()>/read-field-mode/2	<simplejavacalculator.Calculator: java.lang.Double calculateBiImpl()>/$stack6	10
<simplejavacalculator.UI: void actionPerformed(java.awt.event.ActionEvent)>/read-field-calc/5	<simplejavacalculator.UI: void init()>/$stack36	1
<simplejavacalculator.UI: void actionPerformed(java.awt.event.ActionEvent)>/read-field-calc/5	<simplejavacalculator.UI: void actionPerformed(java.awt.event.ActionEvent)>/$stack81	10
<simplejavacalculator.UI: void <init>()>/read-field-panel/0	<simplejavacalculator.UI: void <init>()>/$stack11	1
<simplejavacalculator.UI: void <init>()>/read-field-panel/0	<simplejavacalculator.UI: void <init>()>/$stack11	10
<simplejavacalculator.UI: void init()>/read-field-butTan/2	<simplejavacalculator.UI: void init()>/$stack191	1
<simplejavacalculator.UI: void init()>/read-field-butTan/2	<simplejavacalculator.UI: void init()>/$stack191	10
<simplejavacalculator.UI: void parsetoBinary()>/read-field-text/0	<simplejavacalculator.UI: void parsetoBinary()>/$stack3	1
<simplejavacalculator.UI: void parsetoBinary()>/read-field-text/0	<simplejavacalculator.UI: void parsetoBinary()>/$stack3	10
<simplejavacalculator.UI: void init()>/read-field-panelSub5/2	<simplejavacalculator.UI: void init()>/$stack135	1
<simplejavacalculator.UI: void init()>/read-field-panelSub5/2	<simplejavacalculator.UI: void init()>/$stack135	10
<simplejavacalculator.UI: void init()>/read-field-butxpowerofy/0	<simplejavacalculator.UI: void init()>/$stack36	10
<simplejavacalculator.UI: void init()>/read-field-butxpowerofy/0	<simplejavacalculator.UI: void actionPerformed(java.awt.event.ActionEvent)>/$stack63	1
<simplejavacalculator.UI: void init()>/read-field-butMinus/0	<simplejavacalculator.UI: void init()>/$stack16	10
<simplejavacalculator.UI: void <init>()>/read-field-panel/1	<simplejavacalculator.UI: void <init>()>/$stack10	10
<simplejavacalculator.UI: java.lang.Double reader()>/read-field-text/0	<simplejavacalculator.UI: java.lang.Double reader()>/$stack3	10
<simplejavacalculator.UI: void actionPerformed(java.awt.event.ActionEvent)>/read-field-butAdd/0	<simplejavacalculator.UI: void actionPerformed(java.awt.event.ActionEvent)>/$stack5	10
<simplejavacalculator.UI: void init()>/read-field-panelSub3/0	<simplejavacalculator.UI: void init()>/$stack82	10
<simplejavacalculator.UI: void init()>/read-field-image/0	<simplejavacalculator.UI: void init()>/$stack7	10
<simplejavacalculator.UI: void init()>/read-field-font/16	<simplejavacalculator.UI: void init()>/$stack43	10
<simplejavacalculator.UI: void init()>/read-field-butMinus/2	<simplejavacalculator.UI: void init()>/$stack183	10
<simplejavacalculator.UI: void parsetoBinary()>/read-field-text/1	<simplejavacalculator.UI: void parsetoBinary()>/$stack5	10
<simplejavacalculator.UI: void init()>/read-field-font/5	<simplejavacalculator.UI: void init()>/$stack21	10
<simplejavacalculator.UI: void writer(java.lang.Double)>/read-field-text/1	<simplejavacalculator.UI: void writer(java.lang.Double)>/$stack4	10
<simplejavacalculator.UI: void init()>/read-field-font/7	<simplejavacalculator.UI: void init()>/$stack25	10
<simplejavacalculator.UI: void actionPerformed(java.awt.event.ActionEvent)>/read-field-butDivide/0	<simplejavacalculator.UI: void actionPerformed(java.awt.event.ActionEvent)>/$stack8	10
<simplejavacalculator.UI: void actionPerformed(java.awt.event.ActionEvent)>/read-field-calc/8	<simplejavacalculator.UI: void actionPerformed(java.awt.event.ActionEvent)>/$stack63	10
