<simplejavacalculator.UI: void parsetoBinary()>/java.lang.Long.toBinaryString/0	<java.lang.Long: java.lang.String toBinaryString(long)>	<simplejavacalculator.UI: void parsetoBinary()>	10
<simplejavacalculator.UI: void parsetoBinary()>/java.lang.Long.parseLong/0	<java.lang.Long: long parseLong(java.lang.String)>	<simplejavacalculator.UI: void parsetoBinary()>	10
<simplejavacalculator.UI: void init()>/javax.swing.JPanel.add/6	<javax.swing.Box: java.awt.Component createHorizontalStrut(int)>	<simplejavacalculator.UI: void init()>	1
<simplejavacalculator.Calculator: java.lang.Double calculateMono(simplejavacalculator.Calculator$MonoOperatorModes,java.lang.Double)>/java.lang.Double.valueOf/6	<java.lang.Double: java.lang.Double valueOf(double)>	<simplejavacalculator.Calculator: java.lang.Double calculateMono(simplejavacalculator.Calculator$MonoOperatorModes,java.lang.Double)>	0
<simplejavacalculator.Calculator: java.lang.Double calculateBi(simplejavacalculator.Calculator$BiOperatorModes,java.lang.Double)>/java.lang.Double.valueOf/0	<java.lang.Double: java.lang.Double valueOf(double)>	<simplejavacalculator.Calculator: java.lang.Double calculateBi(simplejavacalculator.Calculator$BiOperatorModes,java.lang.Double)>	0
<simplejavacalculator.Calculator: java.lang.Double calculateMono(simplejavacalculator.Calculator$MonoOperatorModes,java.lang.Double)>/java.lang.Double.valueOf/3	<java.lang.Double: java.lang.Double valueOf(double)>	<simplejavacalculator.Calculator: java.lang.Double calculateMono(simplejavacalculator.Calculator$MonoOperatorModes,java.lang.Double)>	0
<simplejavacalculator.Calculator: java.lang.Double calculateMono(simplejavacalculator.Calculator$MonoOperatorModes,java.lang.Double)>/java.lang.Math.tan/0	<java.lang.Math: double tan(double)>	<simplejavacalculator.Calculator: java.lang.Double calculateMono(simplejavacalculator.Calculator$MonoOperatorModes,java.lang.Double)>	0
<simplejavacalculator.Calculator: java.lang.Double calculateBiImpl()>/java.lang.Double.valueOf/0	<java.lang.Double: java.lang.Double valueOf(double)>	<simplejavacalculator.Calculator: java.lang.Double calculateBiImpl()>	0
<simplejavacalculator.UI: void writer(java.lang.Double)>/java.lang.Double.toString/0	<java.lang.Double: java.lang.String toString(double)>	<simplejavacalculator.UI: void writer(java.lang.Double)>	0
<simplejavacalculator.Calculator: java.lang.Double calculateMono(simplejavacalculator.Calculator$MonoOperatorModes,java.lang.Double)>/java.lang.Double.valueOf/1	<java.lang.Double: java.lang.Double valueOf(double)>	<simplejavacalculator.Calculator: java.lang.Double calculateMono(simplejavacalculator.Calculator$MonoOperatorModes,java.lang.Double)>	0
<simplejavacalculator.UI: void init()>/javax.swing.Box.createHorizontalStrut/2	<javax.swing.Box: java.awt.Component createHorizontalStrut(int)>	<simplejavacalculator.UI: void init()>	0
<simplejavacalculator.Calculator: java.lang.Double calculateBiImpl()>/java.lang.Double.valueOf/1	<java.lang.Double: java.lang.Double valueOf(double)>	<simplejavacalculator.Calculator: java.lang.Double calculateBiImpl()>	0
<simplejavacalculator.Calculator: java.lang.Double calculateBiImpl()>/java.lang.Math.pow/0	<java.lang.Math: double pow(double,double)>	<simplejavacalculator.Calculator: java.lang.Double calculateBiImpl()>	0
<simplejavacalculator.UI: void init()>/javax.swing.Box.createHorizontalStrut/3	<javax.swing.Box: java.awt.Component createHorizontalStrut(int)>	<simplejavacalculator.UI: void init()>	0
<simplejavacalculator.Calculator: java.lang.Double calculateBi(simplejavacalculator.Calculator$BiOperatorModes,java.lang.Double)>/java.lang.Double.valueOf/1	<java.lang.Double: java.lang.Double valueOf(double)>	<simplejavacalculator.Calculator: java.lang.Double calculateBi(simplejavacalculator.Calculator$BiOperatorModes,java.lang.Double)>	0
<simplejavacalculator.Calculator: java.lang.Double calculateMono(simplejavacalculator.Calculator$MonoOperatorModes,java.lang.Double)>/java.lang.Double.valueOf/5	<java.lang.Double: java.lang.Double valueOf(double)>	<simplejavacalculator.Calculator: java.lang.Double calculateMono(simplejavacalculator.Calculator$MonoOperatorModes,java.lang.Double)>	0
<simplejavacalculator.Calculator: java.lang.Double reset()>/java.lang.Double.valueOf/0	<java.lang.Double: java.lang.Double valueOf(double)>	<simplejavacalculator.Calculator: java.lang.Double reset()>	0
<simplejavacalculator.Calculator: java.lang.Double calculateMono(simplejavacalculator.Calculator$MonoOperatorModes,java.lang.Double)>/java.lang.Double.valueOf/4	<java.lang.Double: java.lang.Double valueOf(double)>	<simplejavacalculator.Calculator: java.lang.Double calculateMono(simplejavacalculator.Calculator$MonoOperatorModes,java.lang.Double)>	0
<simplejavacalculator.Calculator: java.lang.Double calculateMono(simplejavacalculator.Calculator$MonoOperatorModes,java.lang.Double)>/java.lang.Math.log10/0	<java.lang.Math: double log10(double)>	<simplejavacalculator.Calculator: java.lang.Double calculateMono(simplejavacalculator.Calculator$MonoOperatorModes,java.lang.Double)>	0
<simplejavacalculator.Calculator: java.lang.Double calculateMono(simplejavacalculator.Calculator$MonoOperatorModes,java.lang.Double)>/java.lang.Math.sin/0	<java.lang.Math: double sin(double)>	<simplejavacalculator.Calculator: java.lang.Double calculateMono(simplejavacalculator.Calculator$MonoOperatorModes,java.lang.Double)>	0
<simplejavacalculator.Calculator: java.lang.Double calculateBiImpl()>/java.lang.Double.valueOf/2	<java.lang.Double: java.lang.Double valueOf(double)>	<simplejavacalculator.Calculator: java.lang.Double calculateBiImpl()>	0
<simplejavacalculator.Calculator: java.lang.Double calculateMono(simplejavacalculator.Calculator$MonoOperatorModes,java.lang.Double)>/java.lang.Double.valueOf/2	<java.lang.Double: java.lang.Double valueOf(double)>	<simplejavacalculator.Calculator: java.lang.Double calculateMono(simplejavacalculator.Calculator$MonoOperatorModes,java.lang.Double)>	0
<simplejavacalculator.Calculator: java.lang.Double calculateBiImpl()>/java.lang.Double.valueOf/4	<java.lang.Double: java.lang.Double valueOf(double)>	<simplejavacalculator.Calculator: java.lang.Double calculateBiImpl()>	0
<simplejavacalculator.Calculator: java.lang.Double calculateMono(simplejavacalculator.Calculator$MonoOperatorModes,java.lang.Double)>/java.lang.Double.valueOf/7	<java.lang.Double: java.lang.Double valueOf(double)>	<simplejavacalculator.Calculator: java.lang.Double calculateMono(simplejavacalculator.Calculator$MonoOperatorModes,java.lang.Double)>	0
<simplejavacalculator.Calculator: java.lang.Double calculateMono(simplejavacalculator.Calculator$MonoOperatorModes,java.lang.Double)>/java.lang.Double.valueOf/9	<java.lang.Double: java.lang.Double valueOf(double)>	<simplejavacalculator.Calculator: java.lang.Double calculateMono(simplejavacalculator.Calculator$MonoOperatorModes,java.lang.Double)>	0
<simplejavacalculator.Calculator: java.lang.Double calculateBiImpl()>/java.lang.Double.valueOf/3	<java.lang.Double: java.lang.Double valueOf(double)>	<simplejavacalculator.Calculator: java.lang.Double calculateBiImpl()>	0
<simplejavacalculator.Calculator: java.lang.Double calculateMono(simplejavacalculator.Calculator$MonoOperatorModes,java.lang.Double)>/java.lang.Double.valueOf/8	<java.lang.Double: java.lang.Double valueOf(double)>	<simplejavacalculator.Calculator: java.lang.Double calculateMono(simplejavacalculator.Calculator$MonoOperatorModes,java.lang.Double)>	0
<simplejavacalculator.UI: void init()>/javax.swing.Box.createHorizontalStrut/0	<javax.swing.Box: java.awt.Component createHorizontalStrut(int)>	<simplejavacalculator.UI: void init()>	0
<simplejavacalculator.UI: void <init>()>/java.lang.String.valueOf/0	<java.lang.String: java.lang.String valueOf(int)>	<simplejavacalculator.UI: void <init>()>	0
<simplejavacalculator.Calculator: java.lang.Double calculateMono(simplejavacalculator.Calculator$MonoOperatorModes,java.lang.Double)>/java.lang.Math.cos/0	<java.lang.Math: double cos(double)>	<simplejavacalculator.Calculator: java.lang.Double calculateMono(simplejavacalculator.Calculator$MonoOperatorModes,java.lang.Double)>	0
<simplejavacalculator.UI: void init()>/javax.swing.Box.createHorizontalStrut/4	<javax.swing.Box: java.awt.Component createHorizontalStrut(int)>	<simplejavacalculator.UI: void init()>	0
<simplejavacalculator.Calculator: java.lang.Double calculateMono(simplejavacalculator.Calculator$MonoOperatorModes,java.lang.Double)>/java.lang.Math.sqrt/0	<java.lang.Math: double sqrt(double)>	<simplejavacalculator.Calculator: java.lang.Double calculateMono(simplejavacalculator.Calculator$MonoOperatorModes,java.lang.Double)>	0
<simplejavacalculator.UI: void writer(java.lang.Double)>/java.lang.Double.isNaN/0	<java.lang.Double: boolean isNaN(double)>	<simplejavacalculator.UI: void writer(java.lang.Double)>	0
<simplejavacalculator.Calculator: java.lang.Double calculateMono(simplejavacalculator.Calculator$MonoOperatorModes,java.lang.Double)>/java.lang.Double.valueOf/0	<java.lang.Double: java.lang.Double valueOf(double)>	<simplejavacalculator.Calculator: java.lang.Double calculateMono(simplejavacalculator.Calculator$MonoOperatorModes,java.lang.Double)>	10
<simplejavacalculator.Calculator: java.lang.Double calculateMono(simplejavacalculator.Calculator$MonoOperatorModes,java.lang.Double)>/java.lang.Double.valueOf/0	new_var_596	<simplejavacalculator.UI: void parsetoBinary()>	1
<simplejavacalculator.Calculator: java.lang.Double calculateMono(simplejavacalculator.Calculator$MonoOperatorModes,java.lang.Double)>/java.lang.Double.valueOf/10	<java.lang.Double: java.lang.Double valueOf(double)>	<simplejavacalculator.Calculator: java.lang.Double calculateMono(simplejavacalculator.Calculator$MonoOperatorModes,java.lang.Double)>	1
<simplejavacalculator.Calculator: java.lang.Double calculateMono(simplejavacalculator.Calculator$MonoOperatorModes,java.lang.Double)>/java.lang.Double.valueOf/10	<java.lang.Double: java.lang.Double valueOf(double)>	<simplejavacalculator.Calculator: java.lang.Double calculateMono(simplejavacalculator.Calculator$MonoOperatorModes,java.lang.Double)>	10
<simplejavacalculator.BufferedImageCustom: java.awt.Image imageReturn()>/javax.imageio.ImageIO.read/0	<java.lang.Double: java.lang.Double valueOf(double)>	<simplejavacalculator.Calculator: java.lang.Double calculateMono(simplejavacalculator.Calculator$MonoOperatorModes,java.lang.Double)>	1
<simplejavacalculator.BufferedImageCustom: java.awt.Image imageReturn()>/javax.imageio.ImageIO.read/0	<javax.imageio.ImageIO: java.awt.image.BufferedImage read(java.io.InputStream)>	<simplejavacalculator.BufferedImageCustom: java.awt.Image imageReturn()>	10
<simplejavacalculator.UI: void init()>/javax.swing.Box.createHorizontalStrut/1	<java.lang.Double: java.lang.Double valueOf(double)>	<simplejavacalculator.Calculator: java.lang.Double reset()>	1
<simplejavacalculator.UI: void init()>/javax.swing.Box.createHorizontalStrut/1	<javax.swing.Box: java.awt.Component createHorizontalStrut(int)>	<simplejavacalculator.UI: void init()>	10
<simplejavacalculator.Calculator: java.lang.Double reset()>/java.lang.Double.valueOf/2	<java.lang.Double: java.lang.Double valueOf(double)>	<simplejavacalculator.Calculator: java.lang.Double reset()>	10
<simplejavacalculator.Calculator: java.lang.Double reset()>/java.lang.Double.valueOf/2	<java.lang.Long: java.lang.String toBinaryString(long)>	<simplejavacalculator.UI: void parsetoBinary()>	1
<simplejavacalculator.UI: java.lang.Double reader()>/java.lang.Double.valueOf/0	<java.lang.Double: java.lang.Double valueOf(double)>	<simplejavacalculator.Calculator: java.lang.Double reset()>	1
<simplejavacalculator.UI: java.lang.Double reader()>/java.lang.Double.valueOf/0	<java.lang.Double: java.lang.Double valueOf(java.lang.String)>	<simplejavacalculator.UI: java.lang.Double reader()>	10
<simplejavacalculator.Calculator: java.lang.Double calculateMono(simplejavacalculator.Calculator$MonoOperatorModes,java.lang.Double)>/java.lang.Math.abs/0	<java.lang.Math: double abs(double)>	<simplejavacalculator.Calculator: java.lang.Double calculateMono(simplejavacalculator.Calculator$MonoOperatorModes,java.lang.Double)>	1
<simplejavacalculator.Calculator: java.lang.Double calculateMono(simplejavacalculator.Calculator$MonoOperatorModes,java.lang.Double)>/java.lang.Math.abs/0	<java.lang.Math: double abs(double)>	<simplejavacalculator.Calculator: java.lang.Double calculateMono(simplejavacalculator.Calculator$MonoOperatorModes,java.lang.Double)>	10
<simplejavacalculator.Calculator$MonoOperatorModes: simplejavacalculator.Calculator$MonoOperatorModes valueOf(java.lang.String)>/java.lang.Enum.valueOf/0	<java.lang.Enum: java.lang.Enum valueOf(java.lang.Class,java.lang.String)>	<simplejavacalculator.Calculator$MonoOperatorModes: simplejavacalculator.Calculator$MonoOperatorModes valueOf(java.lang.String)>	10
<simplejavacalculator.Calculator$MonoOperatorModes: simplejavacalculator.Calculator$MonoOperatorModes valueOf(java.lang.String)>/java.lang.Enum.valueOf/0	<java.lang.Enum: java.lang.Enum valueOf(java.lang.Class,java.lang.String)>	<simplejavacalculator.Calculator$BiOperatorModes: simplejavacalculator.Calculator$BiOperatorModes valueOf(java.lang.String)>	1
<simplejavacalculator.Calculator$BiOperatorModes: simplejavacalculator.Calculator$BiOperatorModes valueOf(java.lang.String)>/java.lang.Enum.valueOf/0	<java.lang.Enum: java.lang.Enum valueOf(java.lang.Class,java.lang.String)>	<simplejavacalculator.Calculator$MonoOperatorModes: simplejavacalculator.Calculator$MonoOperatorModes valueOf(java.lang.String)>	1
<simplejavacalculator.Calculator$BiOperatorModes: simplejavacalculator.Calculator$BiOperatorModes valueOf(java.lang.String)>/java.lang.Enum.valueOf/0	<java.lang.Enum: java.lang.Enum valueOf(java.lang.Class,java.lang.String)>	<simplejavacalculator.Calculator$BiOperatorModes: simplejavacalculator.Calculator$BiOperatorModes valueOf(java.lang.String)>	10
<simplejavacalculator.Calculator: java.lang.Double reset()>/java.lang.Double.valueOf/1	<java.lang.Double: java.lang.Double valueOf(double)>	<simplejavacalculator.Calculator: java.lang.Double reset()>	10
<simplejavacalculator.Calculator: java.lang.Double reset()>/java.lang.Double.valueOf/1	<java.lang.Double: java.lang.Double valueOf(java.lang.String)>	<simplejavacalculator.UI: java.lang.Double reader()>	1
