<simplejavacalculator.Calculator: java.lang.Double calculateBiImpl()>/java.lang.Double.valueOf/2	<simplejavacalculator.Calculator: java.lang.Double calculateBiImpl()>/$stack31	0
<simplejavacalculator.Calculator: java.lang.Double calculateMono(simplejavacalculator.Calculator$MonoOperatorModes,java.lang.Double)>/java.lang.Math.log10/0	<simplejavacalculator.Calculator: java.lang.Double calculateMono(simplejavacalculator.Calculator$MonoOperatorModes,java.lang.Double)>/$stack20	0
<simplejavacalculator.Calculator: java.lang.Double reset()>/java.lang.Double.valueOf/2	<simplejavacalculator.Calculator: java.lang.Double reset()>/$stack4	0
<simplejavacalculator.Calculator: java.lang.Double calculateMono(simplejavacalculator.Calculator$MonoOperatorModes,java.lang.Double)>/java.lang.Math.abs/0	<simplejavacalculator.Calculator: java.lang.Double calculateMono(simplejavacalculator.Calculator$MonoOperatorModes,java.lang.Double)>/$stack14	0
<simplejavacalculator.Calculator: java.lang.Double calculateMono(simplejavacalculator.Calculator$MonoOperatorModes,java.lang.Double)>/java.lang.Double.valueOf/9	<simplejavacalculator.Calculator: java.lang.Double calculateMono(simplejavacalculator.Calculator$MonoOperatorModes,java.lang.Double)>/$stack18	0
<simplejavacalculator.Calculator: java.lang.Double calculateBiImpl()>/java.lang.Double.valueOf/0	<simplejavacalculator.Calculator: java.lang.Double calculateBiImpl()>/$stack47	0
<simplejavacalculator.Calculator: java.lang.Double calculateMono(simplejavacalculator.Calculator$MonoOperatorModes,java.lang.Double)>/java.lang.Math.sqrt/0	<simplejavacalculator.Calculator: java.lang.Double calculateMono(simplejavacalculator.Calculator$MonoOperatorModes,java.lang.Double)>/$stack51	0
<simplejavacalculator.Calculator: java.lang.Double calculateMono(simplejavacalculator.Calculator$MonoOperatorModes,java.lang.Double)>/java.lang.Double.valueOf/7	<simplejavacalculator.Calculator: java.lang.Double calculateMono(simplejavacalculator.Calculator$MonoOperatorModes,java.lang.Double)>/$stack33	0
<simplejavacalculator.Calculator: java.lang.Double calculateMono(simplejavacalculator.Calculator$MonoOperatorModes,java.lang.Double)>/java.lang.Double.valueOf/3	<simplejavacalculator.Calculator: java.lang.Double calculateMono(simplejavacalculator.Calculator$MonoOperatorModes,java.lang.Double)>/$stack45	0
<simplejavacalculator.Calculator: java.lang.Double calculateMono(simplejavacalculator.Calculator$MonoOperatorModes,java.lang.Double)>/java.lang.Math.tan/0	<simplejavacalculator.Calculator: java.lang.Double calculateMono(simplejavacalculator.Calculator$MonoOperatorModes,java.lang.Double)>/$stack32	0
<simplejavacalculator.Calculator: java.lang.Double calculateBiImpl()>/java.lang.Math.pow/0	<simplejavacalculator.Calculator: java.lang.Double calculateBiImpl()>/$stack18	0
<simplejavacalculator.Calculator: java.lang.Double calculateMono(simplejavacalculator.Calculator$MonoOperatorModes,java.lang.Double)>/java.lang.Double.valueOf/5	<simplejavacalculator.Calculator: java.lang.Double calculateMono(simplejavacalculator.Calculator$MonoOperatorModes,java.lang.Double)>/$stack24	0
<simplejavacalculator.Calculator: java.lang.Double calculateMono(simplejavacalculator.Calculator$MonoOperatorModes,java.lang.Double)>/java.lang.Double.valueOf/2	<simplejavacalculator.Calculator: java.lang.Double calculateMono(simplejavacalculator.Calculator$MonoOperatorModes,java.lang.Double)>/$stack49	0
<simplejavacalculator.Calculator: java.lang.Double calculateMono(simplejavacalculator.Calculator$MonoOperatorModes,java.lang.Double)>/java.lang.Double.valueOf/6	<simplejavacalculator.Calculator: java.lang.Double calculateMono(simplejavacalculator.Calculator$MonoOperatorModes,java.lang.Double)>/$stack38	0
<simplejavacalculator.UI: void init()>/javax.swing.Box.createHorizontalStrut/0	<simplejavacalculator.UI: void init()>/$stack48	10
<simplejavacalculator.UI: void init()>/javax.swing.Box.createHorizontalStrut/0	<simplejavacalculator.UI: void init()>/$stack117	1
<simplejavacalculator.Calculator$MonoOperatorModes: simplejavacalculator.Calculator$MonoOperatorModes valueOf(java.lang.String)>/java.lang.Enum.valueOf/0	<simplejavacalculator.Calculator$BiOperatorModes: simplejavacalculator.Calculator$BiOperatorModes valueOf(java.lang.String)>/$stack1	1
<simplejavacalculator.Calculator$MonoOperatorModes: simplejavacalculator.Calculator$MonoOperatorModes valueOf(java.lang.String)>/java.lang.Enum.valueOf/0	<simplejavacalculator.Calculator$MonoOperatorModes: simplejavacalculator.Calculator$MonoOperatorModes valueOf(java.lang.String)>/$stack1	10
<simplejavacalculator.UI: void init()>/javax.swing.Box.createHorizontalStrut/3	<simplejavacalculator.UI: void init()>/$stack117	10
<simplejavacalculator.UI: void init()>/javax.swing.Box.createHorizontalStrut/3	<simplejavacalculator.UI: void actionPerformed(java.awt.event.ActionEvent)>/$stack95	1
<simplejavacalculator.Calculator: java.lang.Double calculateMono(simplejavacalculator.Calculator$MonoOperatorModes,java.lang.Double)>/java.lang.Math.cos/0	<simplejavacalculator.Calculator: java.lang.Double calculateMono(simplejavacalculator.Calculator$MonoOperatorModes,java.lang.Double)>/$stack44	0
<simplejavacalculator.UI: void init()>/javax.swing.Box.createHorizontalStrut/4	<simplejavacalculator.UI: void init()>/$stack133	10
<simplejavacalculator.UI: void init()>/javax.swing.Box.createHorizontalStrut/4	<simplejavacalculator.UI: void actionPerformed(java.awt.event.ActionEvent)>/$stack96	1
<simplejavacalculator.Calculator: java.lang.Double reset()>/java.lang.Double.valueOf/1	<simplejavacalculator.Calculator: java.lang.Double reset()>/$stack2	0
<simplejavacalculator.UI: void parsetoBinary()>/java.lang.Long.toBinaryString/0	<simplejavacalculator.UI: void parsetoBinary()>/$stack6	1
<simplejavacalculator.UI: void parsetoBinary()>/java.lang.Long.toBinaryString/0	<simplejavacalculator.UI: void parsetoBinary()>/$stack8	10
<simplejavacalculator.Calculator: java.lang.Double calculateBiImpl()>/java.lang.Double.valueOf/4	<simplejavacalculator.Calculator: java.lang.Double calculateBiImpl()>/$stack19	0
<simplejavacalculator.Calculator: java.lang.Double reset()>/java.lang.Double.valueOf/0	<simplejavacalculator.Calculator: java.lang.Double reset()>/$stack1	0
<simplejavacalculator.UI: void writer(java.lang.Double)>/java.lang.Double.toString/0	<simplejavacalculator.UI: void writer(java.lang.Double)>/$stack2	1
<simplejavacalculator.UI: void writer(java.lang.Double)>/java.lang.Double.toString/0	<simplejavacalculator.UI: void writer(java.lang.Double)>/$stack6	10
<simplejavacalculator.Calculator: java.lang.Double calculateBiImpl()>/java.lang.Double.valueOf/3	<simplejavacalculator.Calculator: java.lang.Double calculateBiImpl()>/$stack25	0
<simplejavacalculator.UI: void init()>/javax.swing.Box.createHorizontalStrut/2	<simplejavacalculator.UI: void init()>/$stack69	1
<simplejavacalculator.UI: void init()>/javax.swing.Box.createHorizontalStrut/2	<simplejavacalculator.UI: void init()>/$stack93	10
<simplejavacalculator.Calculator: java.lang.Double calculateBi(simplejavacalculator.Calculator$BiOperatorModes,java.lang.Double)>/java.lang.Double.valueOf/1	<simplejavacalculator.Calculator: java.lang.Double calculateBi(simplejavacalculator.Calculator$BiOperatorModes,java.lang.Double)>/$stack8	0
<simplejavacalculator.Calculator$BiOperatorModes: simplejavacalculator.Calculator$BiOperatorModes valueOf(java.lang.String)>/java.lang.Enum.valueOf/0	<simplejavacalculator.Calculator$BiOperatorModes: simplejavacalculator.Calculator$BiOperatorModes valueOf(java.lang.String)>/$stack1	10
<simplejavacalculator.Calculator$BiOperatorModes: simplejavacalculator.Calculator$BiOperatorModes valueOf(java.lang.String)>/java.lang.Enum.valueOf/0	<simplejavacalculator.Calculator$MonoOperatorModes: simplejavacalculator.Calculator$MonoOperatorModes valueOf(java.lang.String)>/$stack1	1
<simplejavacalculator.UI: void writer(java.lang.Double)>/java.lang.Double.isNaN/0	<simplejavacalculator.UI: void writer(java.lang.Double)>/$stack3	0
<simplejavacalculator.Calculator: java.lang.Double calculateBiImpl()>/java.lang.Double.valueOf/1	<simplejavacalculator.Calculator: java.lang.Double calculateBiImpl()>/$stack37	0
<simplejavacalculator.Calculator: java.lang.Double calculateMono(simplejavacalculator.Calculator$MonoOperatorModes,java.lang.Double)>/java.lang.Double.valueOf/0	<simplejavacalculator.Calculator: java.lang.Double calculateMono(simplejavacalculator.Calculator$MonoOperatorModes,java.lang.Double)>/$stack56	0
<simplejavacalculator.Calculator: java.lang.Double calculateMono(simplejavacalculator.Calculator$MonoOperatorModes,java.lang.Double)>/java.lang.Math.sin/0	<simplejavacalculator.Calculator: java.lang.Double calculateMono(simplejavacalculator.Calculator$MonoOperatorModes,java.lang.Double)>/$stack41	0
<simplejavacalculator.Calculator: java.lang.Double calculateMono(simplejavacalculator.Calculator$MonoOperatorModes,java.lang.Double)>/java.lang.Double.valueOf/1	<simplejavacalculator.Calculator: java.lang.Double calculateMono(simplejavacalculator.Calculator$MonoOperatorModes,java.lang.Double)>/$stack52	0
<simplejavacalculator.Calculator: java.lang.Double calculateMono(simplejavacalculator.Calculator$MonoOperatorModes,java.lang.Double)>/java.lang.Double.valueOf/4	<simplejavacalculator.Calculator: java.lang.Double calculateMono(simplejavacalculator.Calculator$MonoOperatorModes,java.lang.Double)>/$stack42	0
<simplejavacalculator.Calculator: java.lang.Double calculateMono(simplejavacalculator.Calculator$MonoOperatorModes,java.lang.Double)>/java.lang.Double.valueOf/8	<simplejavacalculator.Calculator: java.lang.Double calculateMono(simplejavacalculator.Calculator$MonoOperatorModes,java.lang.Double)>/$stack21	0
<simplejavacalculator.Calculator: java.lang.Double calculateMono(simplejavacalculator.Calculator$MonoOperatorModes,java.lang.Double)>/java.lang.Double.valueOf/10	<simplejavacalculator.Calculator: java.lang.Double calculateMono(simplejavacalculator.Calculator$MonoOperatorModes,java.lang.Double)>/$stack15	0
<simplejavacalculator.UI: void init()>/javax.swing.Box.createHorizontalStrut/1	<simplejavacalculator.UI: void init()>/$stack133	1
<simplejavacalculator.UI: void init()>/javax.swing.Box.createHorizontalStrut/1	<simplejavacalculator.UI: void init()>/$stack69	10
<simplejavacalculator.Calculator: java.lang.Double calculateBi(simplejavacalculator.Calculator$BiOperatorModes,java.lang.Double)>/java.lang.Double.valueOf/0	<simplejavacalculator.Calculator: java.lang.Double calculateBi(simplejavacalculator.Calculator$BiOperatorModes,java.lang.Double)>/$stack7	0
<simplejavacalculator.UI: java.lang.Double reader()>/java.lang.Double.valueOf/0	<simplejavacalculator.BufferedImageCustom: java.awt.Image imageReturn()>/$stack6	1
<simplejavacalculator.UI: java.lang.Double reader()>/java.lang.Double.valueOf/0	<simplejavacalculator.UI: java.lang.Double reader()>/$stack5	10
<simplejavacalculator.BufferedImageCustom: java.awt.Image imageReturn()>/javax.imageio.ImageIO.read/0	<simplejavacalculator.BufferedImageCustom: java.awt.Image imageReturn()>/$stack6	10
<simplejavacalculator.BufferedImageCustom: java.awt.Image imageReturn()>/javax.imageio.ImageIO.read/0	<simplejavacalculator.UI: void parsetoBinary()>/$stack17	1
<simplejavacalculator.UI: void <init>()>/java.lang.String.valueOf/0	<simplejavacalculator.UI: void <init>()>/$stack52	10
<simplejavacalculator.UI: void <init>()>/java.lang.String.valueOf/0	<simplejavacalculator.SimpleJavaCalculator: void main(java.lang.String[])>/$stack5	1
<simplejavacalculator.UI: void parsetoBinary()>/java.lang.Long.parseLong/0	<simplejavacalculator.UI: void parsetoBinary()>/$stack7	10
<simplejavacalculator.Calculator: java.lang.Double calculateBi(simplejavacalculator.Calculator$BiOperatorModes,java.lang.Double)>/simplejavacalculator.Calculator.calculateBiImpl/0	<simplejavacalculator.Calculator: java.lang.Double calculateBi(simplejavacalculator.Calculator$BiOperatorModes,java.lang.Double)>/$stack5	0
<simplejavacalculator.Calculator: java.lang.Double calculateMono(simplejavacalculator.Calculator$MonoOperatorModes,java.lang.Double)>/java.lang.Double.doubleValue/11	<simplejavacalculator.Calculator: java.lang.Double calculateMono(simplejavacalculator.Calculator$MonoOperatorModes,java.lang.Double)>/$stack19	0
<simplejavacalculator.UI: java.lang.Double reader()>/javax.swing.JTextArea.getText/0	<simplejavacalculator.UI: java.lang.Double reader()>/$stack4	10
<simplejavacalculator.UI: java.lang.Double reader()>/javax.swing.JTextArea.getText/0	<simplejavacalculator.BufferedImageCustom: java.awt.Image imageReturn()>/$stack5	1
<simplejavacalculator.Calculator: java.lang.Double calculateBiImpl()>/java.lang.Double.doubleValue/8	<simplejavacalculator.Calculator: java.lang.Double calculateBiImpl()>/$stack23	0
<simplejavacalculator.Calculator: java.lang.Double calculateMono(simplejavacalculator.Calculator$MonoOperatorModes,java.lang.Double)>/java.lang.Double.doubleValue/12	<simplejavacalculator.Calculator: java.lang.Double calculateMono(simplejavacalculator.Calculator$MonoOperatorModes,java.lang.Double)>/$stack16	0
<simplejavacalculator.Calculator: java.lang.Double calculateBiImpl()>/java.lang.Double.doubleValue/7	<simplejavacalculator.Calculator: java.lang.Double calculateBiImpl()>/$stack21	0
<simplejavacalculator.Calculator: java.lang.Double calculateMono(simplejavacalculator.Calculator$MonoOperatorModes,java.lang.Double)>/java.lang.Double.doubleValue/13	<simplejavacalculator.Calculator: java.lang.Double calculateMono(simplejavacalculator.Calculator$MonoOperatorModes,java.lang.Double)>/$stack13	0
<simplejavacalculator.UI: void actionPerformed(java.awt.event.ActionEvent)>/simplejavacalculator.UI.reader/14	<simplejavacalculator.UI: void actionPerformed(java.awt.event.ActionEvent)>/$stack29	10
<simplejavacalculator.UI: void actionPerformed(java.awt.event.ActionEvent)>/simplejavacalculator.UI.reader/14	<simplejavacalculator.UI: void actionPerformed(java.awt.event.ActionEvent)>/$stack114	1
<simplejavacalculator.Calculator: java.lang.Double calculateBiImpl()>/java.lang.Double.doubleValue/0	<simplejavacalculator.Calculator: java.lang.Double calculateBiImpl()>/$stack39	0
<simplejavacalculator.Calculator: java.lang.Double calculateMono(simplejavacalculator.Calculator$MonoOperatorModes,java.lang.Double)>/java.lang.Double.doubleValue/7	<simplejavacalculator.Calculator: java.lang.Double calculateMono(simplejavacalculator.Calculator$MonoOperatorModes,java.lang.Double)>/$stack25	0
<simplejavacalculator.Calculator: java.lang.Double calculateMono(simplejavacalculator.Calculator$MonoOperatorModes,java.lang.Double)>/java.lang.Double.doubleValue/4	<simplejavacalculator.Calculator: java.lang.Double calculateMono(simplejavacalculator.Calculator$MonoOperatorModes,java.lang.Double)>/$stack43	0
<simplejavacalculator.Calculator: java.lang.Double calculateMono(simplejavacalculator.Calculator$MonoOperatorModes,java.lang.Double)>/java.lang.Double.doubleValue/6	<simplejavacalculator.Calculator: java.lang.Double calculateMono(simplejavacalculator.Calculator$MonoOperatorModes,java.lang.Double)>/$stack22	0
<simplejavacalculator.Calculator: java.lang.Double calculateMono(simplejavacalculator.Calculator$MonoOperatorModes,java.lang.Double)>/java.lang.Double.doubleValue/3	<simplejavacalculator.Calculator: java.lang.Double calculateMono(simplejavacalculator.Calculator$MonoOperatorModes,java.lang.Double)>/$stack47	0
<simplejavacalculator.Calculator: java.lang.Double calculateBiImpl()>/java.lang.Double.doubleValue/9	<simplejavacalculator.Calculator: java.lang.Double calculateBiImpl()>/$stack15	0
<simplejavacalculator.Calculator: java.lang.Double calculateBiImpl()>/java.lang.Double.doubleValue/2	<simplejavacalculator.Calculator: java.lang.Double calculateBiImpl()>/$stack45	0
<simplejavacalculator.UI: void parsetoBinary()>/java.lang.StringBuilder.append/0	<simplejavacalculator.UI: void parsetoBinary()>/$stack16	1
<simplejavacalculator.UI: void parsetoBinary()>/java.lang.StringBuilder.append/0	<simplejavacalculator.UI: void parsetoBinary()>/$stack4	10
<simplejavacalculator.Calculator: java.lang.Double calculateBiImpl()>/java.lang.Double.doubleValue/4	<simplejavacalculator.Calculator: java.lang.Double calculateBiImpl()>/$stack35	0
<simplejavacalculator.Calculator: java.lang.Double calculateMono(simplejavacalculator.Calculator$MonoOperatorModes,java.lang.Double)>/java.lang.Double.doubleValue/0	<simplejavacalculator.Calculator: java.lang.Double calculateMono(simplejavacalculator.Calculator$MonoOperatorModes,java.lang.Double)>/$stack53	0
<simplejavacalculator.Calculator$MonoOperatorModes: simplejavacalculator.Calculator$MonoOperatorModes[] values()>/java.lang.Object.clone/0	<simplejavacalculator.Calculator$MonoOperatorModes: simplejavacalculator.Calculator$MonoOperatorModes[] values()>/$stack1	0
<simplejavacalculator.Calculator: java.lang.Double calculateMono(simplejavacalculator.Calculator$MonoOperatorModes,java.lang.Double)>/java.lang.Double.doubleValue/1	<simplejavacalculator.Calculator: java.lang.Double calculateMono(simplejavacalculator.Calculator$MonoOperatorModes,java.lang.Double)>/$stack54	0
<simplejavacalculator.Calculator: java.lang.Double calculateBiImpl()>/java.lang.Double.doubleValue/5	<simplejavacalculator.Calculator: java.lang.Double calculateBiImpl()>/$stack27	0
<simplejavacalculator.Calculator: java.lang.Double calculateBiImpl()>/java.lang.Double.doubleValue/1	<simplejavacalculator.Calculator: java.lang.Double calculateBiImpl()>/$stack43	0
<simplejavacalculator.Calculator$BiOperatorModes: simplejavacalculator.Calculator$BiOperatorModes[] values()>/java.lang.Object.clone/0	<simplejavacalculator.Calculator$BiOperatorModes: simplejavacalculator.Calculator$BiOperatorModes[] values()>/$stack1	0
<simplejavacalculator.Calculator: java.lang.Double calculateMono(simplejavacalculator.Calculator$MonoOperatorModes,java.lang.Double)>/java.lang.Double.doubleValue/9	<simplejavacalculator.Calculator: java.lang.Double calculateMono(simplejavacalculator.Calculator$MonoOperatorModes,java.lang.Double)>/$stack34	0
<simplejavacalculator.Calculator: java.lang.Double calculateBiImpl()>/java.lang.Double.doubleValue/6	<simplejavacalculator.Calculator: java.lang.Double calculateBiImpl()>/$stack29	0
<simplejavacalculator.Calculator: java.lang.Double calculateMono(simplejavacalculator.Calculator$MonoOperatorModes,java.lang.Double)>/java.lang.Double.doubleValue/5	<simplejavacalculator.Calculator: java.lang.Double calculateMono(simplejavacalculator.Calculator$MonoOperatorModes,java.lang.Double)>/$stack40	0
<simplejavacalculator.Calculator: java.lang.Double calculateMono(simplejavacalculator.Calculator$MonoOperatorModes,java.lang.Double)>/java.lang.Double.doubleValue/2	<simplejavacalculator.Calculator: java.lang.Double calculateMono(simplejavacalculator.Calculator$MonoOperatorModes,java.lang.Double)>/$stack50	0
<simplejavacalculator.UI: void parsetoBinary()>/java.lang.StringBuilder.append/2	<simplejavacalculator.UI: void parsetoBinary()>/$stack14	10
<simplejavacalculator.UI: void parsetoBinary()>/java.lang.StringBuilder.append/2	<simplejavacalculator.BufferedImageCustom: java.awt.Image imageReturn()>/$stack4	1
<simplejavacalculator.Calculator: java.lang.Double calculateBiImpl()>/java.lang.Double.doubleValue/3	<simplejavacalculator.Calculator: java.lang.Double calculateBiImpl()>/$stack33	0
<simplejavacalculator.Calculator: java.lang.Double calculateBiImpl()>/java.lang.Double.doubleValue/10	<simplejavacalculator.Calculator: java.lang.Double calculateBiImpl()>/$stack17	0
<simplejavacalculator.Calculator: java.lang.Double calculateMono(simplejavacalculator.Calculator$MonoOperatorModes,java.lang.Double)>/java.lang.Double.doubleValue/8	<simplejavacalculator.Calculator: java.lang.Double calculateMono(simplejavacalculator.Calculator$MonoOperatorModes,java.lang.Double)>/$stack28	0
<simplejavacalculator.UI: void actionPerformed(java.awt.event.ActionEvent)>/simplejavacalculator.Calculator.calculateMono/0	<simplejavacalculator.UI: void actionPerformed(java.awt.event.ActionEvent)>/$stack78	1
<simplejavacalculator.UI: void actionPerformed(java.awt.event.ActionEvent)>/simplejavacalculator.Calculator.calculateMono/0	<simplejavacalculator.UI: void actionPerformed(java.awt.event.ActionEvent)>/$stack84	10
<simplejavacalculator.UI: void actionPerformed(java.awt.event.ActionEvent)>/simplejavacalculator.UI.reader/1	<simplejavacalculator.UI: void actionPerformed(java.awt.event.ActionEvent)>/$stack107	0
<simplejavacalculator.UI: void actionPerformed(java.awt.event.ActionEvent)>/simplejavacalculator.UI.reader/13	<simplejavacalculator.UI: void actionPerformed(java.awt.event.ActionEvent)>/$stack35	0
<simplejavacalculator.UI: void init()>/javax.swing.JPanel.add/40	<simplejavacalculator.UI: void init()>/$stack179	0
<simplejavacalculator.UI: void init()>/javax.swing.JPanel.add/19	<simplejavacalculator.UI: void init()>/$stack115	0
<simplejavacalculator.UI: void init()>/javax.swing.JPanel.add/14	<simplejavacalculator.UI: void init()>/$stack97	0
<simplejavacalculator.UI: void init()>/javax.swing.JPanel.add/30	<simplejavacalculator.UI: void init()>/$stack149	0
<simplejavacalculator.UI: void init()>/javax.swing.JPanel.add/32	<simplejavacalculator.UI: void init()>/$stack155	0
<simplejavacalculator.UI: void init()>/javax.swing.JPanel.add/33	<simplejavacalculator.UI: void init()>/$stack158	0
<simplejavacalculator.UI: void init()>/javax.swing.JPanel.add/1	<simplejavacalculator.UI: void init()>/$stack52	0
<simplejavacalculator.UI: void init()>/javax.swing.JPanel.add/3	<simplejavacalculator.UI: void init()>/$stack59	0
<simplejavacalculator.UI: void actionPerformed(java.awt.event.ActionEvent)>/simplejavacalculator.UI.reader/4	<simplejavacalculator.UI: void actionPerformed(java.awt.event.ActionEvent)>/$stack89	0
<simplejavacalculator.UI: void actionPerformed(java.awt.event.ActionEvent)>/simplejavacalculator.UI.reader/6	<simplejavacalculator.UI: void actionPerformed(java.awt.event.ActionEvent)>/$stack77	0
<simplejavacalculator.UI: void init()>/javax.swing.JPanel.add/13	<simplejavacalculator.UI: void init()>/$stack94	0
<simplejavacalculator.UI: void actionPerformed(java.awt.event.ActionEvent)>/simplejavacalculator.Calculator.calculateMono/8	<simplejavacalculator.UI: void actionPerformed(java.awt.event.ActionEvent)>/$stack36	10
<simplejavacalculator.UI: void actionPerformed(java.awt.event.ActionEvent)>/simplejavacalculator.Calculator.calculateMono/8	<simplejavacalculator.UI: void actionPerformed(java.awt.event.ActionEvent)>/$stack30	1
<simplejavacalculator.UI: void actionPerformed(java.awt.event.ActionEvent)>/simplejavacalculator.UI.reader/8	<simplejavacalculator.UI: void actionPerformed(java.awt.event.ActionEvent)>/$stack65	0
<simplejavacalculator.UI: void actionPerformed(java.awt.event.ActionEvent)>/simplejavacalculator.Calculator.calculateBi/0	<simplejavacalculator.UI: void actionPerformed(java.awt.event.ActionEvent)>/$stack108	1
<simplejavacalculator.UI: void actionPerformed(java.awt.event.ActionEvent)>/simplejavacalculator.Calculator.calculateBi/0	<simplejavacalculator.UI: void actionPerformed(java.awt.event.ActionEvent)>/$stack114	10
<simplejavacalculator.SimpleJavaCalculator: void main(java.lang.String[])>/java.lang.Exception.getMessage/0	<simplejavacalculator.UI: java.lang.Double reader()>/$stack4	1
<simplejavacalculator.SimpleJavaCalculator: void main(java.lang.String[])>/java.lang.Exception.getMessage/0	<simplejavacalculator.SimpleJavaCalculator: void main(java.lang.String[])>/$stack5	10
<simplejavacalculator.UI: void init()>/javax.swing.JPanel.add/9	<simplejavacalculator.UI: void init()>/$stack79	0
<simplejavacalculator.UI: void actionPerformed(java.awt.event.ActionEvent)>/simplejavacalculator.Calculator.calculateMono/3	<simplejavacalculator.UI: void actionPerformed(java.awt.event.ActionEvent)>/$stack60	1
<simplejavacalculator.UI: void actionPerformed(java.awt.event.ActionEvent)>/simplejavacalculator.Calculator.calculateMono/3	<simplejavacalculator.UI: void actionPerformed(java.awt.event.ActionEvent)>/$stack66	10
<simplejavacalculator.UI: void parsetoBinary()>/java.lang.StringBuilder.toString/0	<simplejavacalculator.UI: void parsetoBinary()>/$stack10	0
<simplejavacalculator.UI: void init()>/javax.swing.JPanel.add/29	<simplejavacalculator.UI: void init()>/$stack146	0
<simplejavacalculator.UI: void actionPerformed(java.awt.event.ActionEvent)>/simplejavacalculator.Calculator.calculateBi/3	<simplejavacalculator.UI: void init()>/$stack49	1
<simplejavacalculator.UI: void actionPerformed(java.awt.event.ActionEvent)>/simplejavacalculator.Calculator.calculateBi/3	<simplejavacalculator.UI: void actionPerformed(java.awt.event.ActionEvent)>/$stack96	10
<simplejavacalculator.UI: void actionPerformed(java.awt.event.ActionEvent)>/simplejavacalculator.UI.reader/2	<simplejavacalculator.UI: void actionPerformed(java.awt.event.ActionEvent)>/$stack101	0
<simplejavacalculator.UI: void init()>/javax.swing.JPanel.add/6	<simplejavacalculator.UI: void init()>/$stack70	0
<simplejavacalculator.UI: void init()>/javax.swing.JPanel.add/27	<simplejavacalculator.UI: void init()>/$stack140	0
<simplejavacalculator.UI: void actionPerformed(java.awt.event.ActionEvent)>/simplejavacalculator.Calculator.calculateMono/6	<simplejavacalculator.UI: void actionPerformed(java.awt.event.ActionEvent)>/$stack42	1
<simplejavacalculator.UI: void actionPerformed(java.awt.event.ActionEvent)>/simplejavacalculator.Calculator.calculateMono/6	<simplejavacalculator.UI: void actionPerformed(java.awt.event.ActionEvent)>/$stack48	10
<simplejavacalculator.Calculator: java.lang.Double calculateMono(simplejavacalculator.Calculator$MonoOperatorModes,java.lang.Double)>/java.lang.Double.doubleValue/10	<simplejavacalculator.Calculator: java.lang.Double calculateMono(simplejavacalculator.Calculator$MonoOperatorModes,java.lang.Double)>/$stack31	0
<simplejavacalculator.UI: void actionPerformed(java.awt.event.ActionEvent)>/simplejavacalculator.Calculator.reset/0	<simplejavacalculator.UI: void actionPerformed(java.awt.event.ActionEvent)>/$stack25	10
<simplejavacalculator.UI: void actionPerformed(java.awt.event.ActionEvent)>/simplejavacalculator.Calculator.reset/0	<simplejavacalculator.UI: void actionPerformed(java.awt.event.ActionEvent)>/$stack113	1
<simplejavacalculator.UI: void actionPerformed(java.awt.event.ActionEvent)>/simplejavacalculator.Calculator.calculateMono/2	<simplejavacalculator.UI: void actionPerformed(java.awt.event.ActionEvent)>/$stack72	10
<simplejavacalculator.UI: void actionPerformed(java.awt.event.ActionEvent)>/simplejavacalculator.Calculator.calculateMono/2	<simplejavacalculator.UI: void actionPerformed(java.awt.event.ActionEvent)>/$stack66	1
<simplejavacalculator.UI: void init()>/javax.swing.JPanel.add/11	<simplejavacalculator.UI: void init()>/$stack87	0
<simplejavacalculator.UI: void init()>/javax.swing.JPanel.add/5	<simplejavacalculator.UI: void init()>/$stack67	0
<simplejavacalculator.UI: void init()>/javax.swing.JPanel.add/24	<simplejavacalculator.UI: void init()>/$stack131	0
<simplejavacalculator.UI: void init()>/javax.swing.JPanel.add/21	<simplejavacalculator.UI: void init()>/$stack121	0
<simplejavacalculator.UI: void init()>/javax.swing.JPanel.add/18	<simplejavacalculator.UI: void init()>/$stack111	0
<simplejavacalculator.UI: void <init>()>/simplejavacalculator.BufferedImageCustom.imageReturn/0	<simplejavacalculator.UI: void <init>()>/$stack52	1
<simplejavacalculator.UI: void <init>()>/simplejavacalculator.BufferedImageCustom.imageReturn/0	<simplejavacalculator.UI: void <init>()>/$stack7	10
<simplejavacalculator.UI: void init()>/javax.swing.JPanel.add/10	<simplejavacalculator.UI: void init()>/$stack83	0
<simplejavacalculator.UI: void init()>/javax.swing.JPanel.add/39	<simplejavacalculator.UI: void init()>/$stack176	0
<simplejavacalculator.UI: void init()>/javax.swing.JPanel.add/34	<simplejavacalculator.UI: void init()>/$stack161	0
<simplejavacalculator.UI: void init()>/javax.swing.JPanel.add/35	<simplejavacalculator.UI: void init()>/$stack164	0
<simplejavacalculator.UI: void init()>/javax.swing.JPanel.add/25	<simplejavacalculator.UI: void init()>/$stack134	0
<simplejavacalculator.UI: void actionPerformed(java.awt.event.ActionEvent)>/simplejavacalculator.Calculator.calculateMono/7	<simplejavacalculator.UI: void actionPerformed(java.awt.event.ActionEvent)>/$stack36	1
<simplejavacalculator.UI: void actionPerformed(java.awt.event.ActionEvent)>/simplejavacalculator.Calculator.calculateMono/7	<simplejavacalculator.UI: void actionPerformed(java.awt.event.ActionEvent)>/$stack42	10
<simplejavacalculator.BufferedImageCustom: java.awt.Image imageReturn()>/java.lang.Object.getClass/0	<simplejavacalculator.BufferedImageCustom: java.awt.Image imageReturn()>/$stack4	10
<simplejavacalculator.BufferedImageCustom: java.awt.Image imageReturn()>/java.lang.Object.getClass/0	<simplejavacalculator.UI: void actionPerformed(java.awt.event.ActionEvent)>/$stack29	1
<simplejavacalculator.UI: void actionPerformed(java.awt.event.ActionEvent)>/simplejavacalculator.UI.reader/9	<simplejavacalculator.UI: void actionPerformed(java.awt.event.ActionEvent)>/$stack59	0
<simplejavacalculator.UI: void init()>/javax.swing.JPanel.add/2	<simplejavacalculator.UI: void init()>/$stack55	0
<simplejavacalculator.UI: void actionPerformed(java.awt.event.ActionEvent)>/simplejavacalculator.UI.reader/12	<simplejavacalculator.UI: void actionPerformed(java.awt.event.ActionEvent)>/$stack41	0
<simplejavacalculator.UI: void init()>/javax.swing.JPanel.add/15	<simplejavacalculator.UI: void init()>/$stack100	0
<simplejavacalculator.UI: void init()>/javax.swing.JPanel.add/36	<simplejavacalculator.UI: void init()>/$stack167	0
<simplejavacalculator.UI: void actionPerformed(java.awt.event.ActionEvent)>/simplejavacalculator.Calculator.calculateEqual/0	<simplejavacalculator.UI: void actionPerformed(java.awt.event.ActionEvent)>/$stack30	10
<simplejavacalculator.UI: void actionPerformed(java.awt.event.ActionEvent)>/simplejavacalculator.Calculator.calculateEqual/0	<simplejavacalculator.UI: void actionPerformed(java.awt.event.ActionEvent)>/$stack25	1
<simplejavacalculator.UI: void init()>/javax.swing.JPanel.add/37	<simplejavacalculator.UI: void init()>/$stack170	0
<simplejavacalculator.UI: void actionPerformed(java.awt.event.ActionEvent)>/simplejavacalculator.Calculator.calculateBi/2	<simplejavacalculator.UI: void actionPerformed(java.awt.event.ActionEvent)>/$stack102	10
<simplejavacalculator.UI: void actionPerformed(java.awt.event.ActionEvent)>/simplejavacalculator.Calculator.calculateBi/2	<simplejavacalculator.UI: void <init>()>/$stack7	1
<simplejavacalculator.UI: void init()>/javax.swing.JPanel.add/4	<simplejavacalculator.UI: void init()>/$stack63	0
<simplejavacalculator.UI: void init()>/javax.swing.JPanel.add/26	<simplejavacalculator.UI: void init()>/$stack137	0
<simplejavacalculator.UI: void actionPerformed(java.awt.event.ActionEvent)>/java.awt.event.ActionEvent.getSource/0	<simplejavacalculator.UI: void actionPerformed(java.awt.event.ActionEvent)>/$stack4	10
<simplejavacalculator.UI: void actionPerformed(java.awt.event.ActionEvent)>/java.awt.event.ActionEvent.getSource/0	<simplejavacalculator.UI: void parsetoBinary()>/$stack8	1
<simplejavacalculator.UI: void init()>/javax.swing.JPanel.add/23	<simplejavacalculator.UI: void init()>/$stack127	0
<simplejavacalculator.UI: void init()>/javax.swing.JPanel.add/16	<simplejavacalculator.UI: void init()>/$stack103	0
<simplejavacalculator.UI: void init()>/javax.swing.JPanel.add/8	<simplejavacalculator.UI: void init()>/$stack76	0
<simplejavacalculator.UI: void init()>/javax.swing.JPanel.add/38	<simplejavacalculator.UI: void init()>/$stack173	0
<simplejavacalculator.UI: void actionPerformed(java.awt.event.ActionEvent)>/simplejavacalculator.UI.reader/0	<simplejavacalculator.UI: void init()>/$stack48	1
<simplejavacalculator.UI: void actionPerformed(java.awt.event.ActionEvent)>/simplejavacalculator.UI.reader/0	<simplejavacalculator.UI: void actionPerformed(java.awt.event.ActionEvent)>/$stack113	10
<simplejavacalculator.UI: void init()>/javax.swing.JPanel.add/17	<simplejavacalculator.UI: void init()>/$stack107	0
<simplejavacalculator.UI: void actionPerformed(java.awt.event.ActionEvent)>/simplejavacalculator.Calculator.calculateMono/4	<simplejavacalculator.UI: void actionPerformed(java.awt.event.ActionEvent)>/$stack60	10
<simplejavacalculator.UI: void actionPerformed(java.awt.event.ActionEvent)>/simplejavacalculator.Calculator.calculateMono/4	<simplejavacalculator.UI: void actionPerformed(java.awt.event.ActionEvent)>/$stack54	1
<simplejavacalculator.Calculator: java.lang.Double calculateEqual(java.lang.Double)>/simplejavacalculator.Calculator.calculateBi/0	<simplejavacalculator.Calculator: java.lang.Double calculateEqual(java.lang.Double)>/$stack3	10
<simplejavacalculator.Calculator: java.lang.Double calculateEqual(java.lang.Double)>/simplejavacalculator.Calculator.calculateBi/0	<simplejavacalculator.UI: void actionPerformed(java.awt.event.ActionEvent)>/$stack84	1
<simplejavacalculator.UI: void init()>/javax.swing.JPanel.add/20	<simplejavacalculator.UI: void init()>/$stack118	0
<simplejavacalculator.UI: void actionPerformed(java.awt.event.ActionEvent)>/simplejavacalculator.UI.reader/10	<simplejavacalculator.UI: void actionPerformed(java.awt.event.ActionEvent)>/$stack53	0
<simplejavacalculator.UI: void parsetoBinary()>/java.lang.NumberFormatException.toString/0	<simplejavacalculator.UI: void parsetoBinary()>/$stack15	0
<simplejavacalculator.BufferedImageCustom: java.awt.Image imageReturn()>/java.lang.Class.getResourceAsStream/0	<simplejavacalculator.BufferedImageCustom: java.awt.Image imageReturn()>/$stack5	10
<simplejavacalculator.BufferedImageCustom: java.awt.Image imageReturn()>/java.lang.Class.getResourceAsStream/0	<simplejavacalculator.UI: void parsetoBinary()>/$stack14	1
<simplejavacalculator.UI: void actionPerformed(java.awt.event.ActionEvent)>/simplejavacalculator.UI.reader/3	<simplejavacalculator.UI: void actionPerformed(java.awt.event.ActionEvent)>/$stack95	10
<simplejavacalculator.UI: void actionPerformed(java.awt.event.ActionEvent)>/simplejavacalculator.UI.reader/3	<simplejavacalculator.UI: void init()>/$stack93	1
<simplejavacalculator.UI: void init()>/javax.swing.JPanel.add/12	<simplejavacalculator.UI: void init()>/$stack91	0
<simplejavacalculator.UI: void actionPerformed(java.awt.event.ActionEvent)>/simplejavacalculator.Calculator.calculateMono/1	<simplejavacalculator.UI: void actionPerformed(java.awt.event.ActionEvent)>/$stack78	10
<simplejavacalculator.UI: void actionPerformed(java.awt.event.ActionEvent)>/simplejavacalculator.Calculator.calculateMono/1	<simplejavacalculator.UI: void actionPerformed(java.awt.event.ActionEvent)>/$stack72	1
<simplejavacalculator.UI: void init()>/javax.swing.JPanel.add/0	<simplejavacalculator.Calculator: java.lang.Double calculateEqual(java.lang.Double)>/$stack3	1
<simplejavacalculator.UI: void init()>/javax.swing.JPanel.add/0	<simplejavacalculator.UI: void init()>/$stack49	10
<simplejavacalculator.UI: void init()>/javax.swing.JPanel.add/22	<simplejavacalculator.UI: void init()>/$stack124	0
<simplejavacalculator.UI: void actionPerformed(java.awt.event.ActionEvent)>/simplejavacalculator.UI.reader/7	<simplejavacalculator.UI: void actionPerformed(java.awt.event.ActionEvent)>/$stack71	0
<simplejavacalculator.UI: void parsetoBinary()>/java.lang.StringBuilder.append/1	<simplejavacalculator.UI: void parsetoBinary()>/$stack4	1
<simplejavacalculator.UI: void parsetoBinary()>/java.lang.StringBuilder.append/1	<simplejavacalculator.UI: void parsetoBinary()>/$stack9	10
<simplejavacalculator.UI: void init()>/javax.swing.JPanel.add/28	<simplejavacalculator.UI: void init()>/$stack143	0
<simplejavacalculator.UI: void actionPerformed(java.awt.event.ActionEvent)>/simplejavacalculator.Calculator.calculateMono/5	<simplejavacalculator.UI: void actionPerformed(java.awt.event.ActionEvent)>/$stack48	1
<simplejavacalculator.UI: void actionPerformed(java.awt.event.ActionEvent)>/simplejavacalculator.Calculator.calculateMono/5	<simplejavacalculator.UI: void actionPerformed(java.awt.event.ActionEvent)>/$stack54	10
<simplejavacalculator.UI: void actionPerformed(java.awt.event.ActionEvent)>/simplejavacalculator.Calculator.calculateBi/1	<simplejavacalculator.UI: void actionPerformed(java.awt.event.ActionEvent)>/$stack108	10
<simplejavacalculator.UI: void actionPerformed(java.awt.event.ActionEvent)>/simplejavacalculator.Calculator.calculateBi/1	<simplejavacalculator.UI: void actionPerformed(java.awt.event.ActionEvent)>/$stack102	1
<simplejavacalculator.UI: void init()>/javax.swing.JPanel.add/7	<simplejavacalculator.UI: void init()>/$stack73	0
<simplejavacalculator.UI: void init()>/javax.swing.ImageIcon.getImage/0	<simplejavacalculator.UI: void init()>/$stack9	0
<simplejavacalculator.UI: void parsetoBinary()>/java.lang.StringBuilder.toString/1	<simplejavacalculator.UI: void parsetoBinary()>/$stack17	10
<simplejavacalculator.UI: void parsetoBinary()>/java.lang.StringBuilder.toString/1	<simplejavacalculator.UI: void parsetoBinary()>/$stack7	1
<simplejavacalculator.UI: void actionPerformed(java.awt.event.ActionEvent)>/simplejavacalculator.UI.reader/5	<simplejavacalculator.UI: void actionPerformed(java.awt.event.ActionEvent)>/$stack83	0
<simplejavacalculator.UI: void init()>/javax.swing.JFrame.add/0	<simplejavacalculator.UI: void init()>/$stack201	0
<simplejavacalculator.UI: void actionPerformed(java.awt.event.ActionEvent)>/simplejavacalculator.Calculator.calculateBi/4	<simplejavacalculator.UI: void actionPerformed(java.awt.event.ActionEvent)>/$stack90	0
<simplejavacalculator.UI: void actionPerformed(java.awt.event.ActionEvent)>/simplejavacalculator.UI.reader/11	<simplejavacalculator.UI: void actionPerformed(java.awt.event.ActionEvent)>/$stack47	0
<simplejavacalculator.UI: void init()>/javax.swing.JPanel.add/31	<simplejavacalculator.UI: void init()>/$stack152	0
<simplejavacalculator.UI: void parsetoBinary()>/java.lang.StringBuilder.append/3	<simplejavacalculator.UI: void parsetoBinary()>/$stack16	10
<simplejavacalculator.UI: void writer(java.lang.Double)>/java.lang.Double.doubleValue/0	<simplejavacalculator.UI: void writer(java.lang.Double)>/$stack2	10
<simplejavacalculator.UI: void writer(java.lang.Double)>/java.lang.Double.doubleValue/1	<simplejavacalculator.UI: void writer(java.lang.Double)>/$stack5	10
<simplejavacalculator.UI: void parsetoBinary()>/javax.swing.JTextArea.getText/0	<simplejavacalculator.UI: void parsetoBinary()>/$stack6	10
