<simplejavacalculator.UI: void actionPerformed(java.awt.event.ActionEvent)>/$stack8	javax.swing.JButton
<simplejavacalculator.Calculator: java.lang.Double calculateBiImpl()>/$stack9	simplejavacalculator.Calculator$BiOperatorModes
<simplejavacalculator.UI: void actionPerformed(java.awt.event.ActionEvent)>/$stack64	simplejavacalculator.Calculator$MonoOperatorModes
<simplejavacalculator.Calculator: java.lang.Double calculateMono(simplejavacalculator.Calculator$MonoOperatorModes,java.lang.Double)>/$stack45	java.lang.Double
<simplejavacalculator.Calculator: java.lang.Double calculateEqual(java.lang.Double)>/$stack3	java.lang.Double
<simplejavacalculator.Calculator$MonoOperatorModes: void <clinit>()>/$stringconstant5	java.lang.String
<simplejavacalculator.Calculator: java.lang.Double calculateBiImpl()>/$stack19	java.lang.Double
<simplejavacalculator.Calculator$MonoOperatorModes: simplejavacalculator.Calculator$MonoOperatorModes valueOf(java.lang.String)>/$classconstant0	java.lang.Class
<simplejavacalculator.Calculator: java.lang.Double calculateMono(simplejavacalculator.Calculator$MonoOperatorModes,java.lang.Double)>/$stack50	double
<simplejavacalculator.Calculator: java.lang.Double calculateMono(simplejavacalculator.Calculator$MonoOperatorModes,java.lang.Double)>/$stack33	java.lang.Double
<simplejavacalculator.UI: void <init>()>/$stack33	javax.swing.JButton
<simplejavacalculator.Calculator: java.lang.Double calculateBiImpl()>/$stack25	java.lang.Double
<simplejavacalculator.UI: void <init>()>/$stack36	javax.swing.JButton
<simplejavacalculator.UI: void <init>()>/i_$$A_1_$$A_1#_87	int
<simplejavacalculator.UI: void init()>/$stack33	java.awt.Font
<simplejavacalculator.UI: void init()>/$stack184	javax.swing.JButton
<simplejavacalculator.Calculator: java.lang.Double calculateBiImpl()>/$stack40	byte
<simplejavacalculator.UI: void actionPerformed(java.awt.event.ActionEvent)>/$stack108	java.lang.Double
<simplejavacalculator.UI: void init()>/$stack104	javax.swing.JButton[]
<simplejavacalculator.UI: void init()>/$stack139	javax.swing.JPanel
<simplejavacalculator.UI: void actionPerformed(java.awt.event.ActionEvent)>/$stack17	javax.swing.JButton
<simplejavacalculator.Calculator: java.lang.Double calculateBiImpl()>/$stack23	double
<simplejavacalculator.Calculator$BiOperatorModes: void <clinit>()>/$numconstant1	int
<simplejavacalculator.UI: void actionPerformed(java.awt.event.ActionEvent)>/$stack43	simplejavacalculator.UI
<simplejavacalculator.UI: void parsetoBinary()>/ex#_310	java.lang.NumberFormatException
<simplejavacalculator.Calculator$BiOperatorModes: void <clinit>()>/$stringconstant4	java.lang.String
<simplejavacalculator.UI: void init()>/$stack143	java.awt.Component
<simplejavacalculator.UI: void actionPerformed(java.awt.event.ActionEvent)>/$stack72	java.lang.Double
<simplejavacalculator.Calculator$MonoOperatorModes: void <clinit>()>/$stack9	simplejavacalculator.Calculator$MonoOperatorModes[]
<simplejavacalculator.UI: void <init>()>/$numconstant0	int
<simplejavacalculator.Calculator: java.lang.Double reset()>/this#_0	simplejavacalculator.Calculator
<simplejavacalculator.Calculator$MonoOperatorModes: void <clinit>()>/$stringconstant6	java.lang.String
<simplejavacalculator.UI: void init()>/i_$$A_1_$$A_3#_193	int
<simplejavacalculator.UI: void actionPerformed(java.awt.event.ActionEvent)>/$stack18	javax.swing.JButton
<simplejavacalculator.UI: void init()>/$stack177	javax.swing.JPanel
<simplejavacalculator.UI: void init()>/$stack100	java.awt.Component
<simplejavacalculator.UI: void <init>()>/$stack37	javax.swing.JButton
<simplejavacalculator.UI: void init()>/$stack35	java.awt.Font
<simplejavacalculator.Calculator$MonoOperatorModes: void <init>(java.lang.String,int)>/@this	simplejavacalculator.Calculator$MonoOperatorModes
<simplejavacalculator.UI: void parsetoBinary()>/$stack15	java.lang.String
<simplejavacalculator.UI: void init()>/$stack105	javax.swing.JButton
<simplejavacalculator.UI: void init()>/$stack36	javax.swing.JButton
<simplejavacalculator.UI: void <init>()>/$stringconstant5	java.lang.String
<simplejavacalculator.UI: void writer(java.lang.Double)>/$stack6	java.lang.String
<simplejavacalculator.UI: void init()>/$stack167	java.awt.Component
<simplejavacalculator.Calculator: java.lang.Double calculateBi(simplejavacalculator.Calculator$BiOperatorModes,java.lang.Double)>/$stack5	java.lang.Double
<simplejavacalculator.Calculator: java.lang.Double calculateMono(simplejavacalculator.Calculator$MonoOperatorModes,java.lang.Double)>/$stack28	double
<simplejavacalculator.Calculator: java.lang.Double calculateMono(simplejavacalculator.Calculator$MonoOperatorModes,java.lang.Double)>/$stack17	double
<simplejavacalculator.UI: void writer(java.lang.Double)>/@parameter0	java.lang.Double
<simplejavacalculator.UI: void <init>()>/$stringconstant18	java.lang.String
<simplejavacalculator.UI: void init()>/$stack108	javax.swing.JButton[]
<simplejavacalculator.Calculator: java.lang.Double calculateBiImpl()>/$stack46	double
<simplejavacalculator.UI: void actionPerformed(java.awt.event.ActionEvent)>/$stack9	javax.swing.JButton
<simplejavacalculator.Calculator$MonoOperatorModes: void <clinit>()>/$numconstant6	int
<simplejavacalculator.Calculator: java.lang.Double calculateBi(simplejavacalculator.Calculator$BiOperatorModes,java.lang.Double)>/$numconstant0	double
<simplejavacalculator.UI: void init()>/$stack197	javax.swing.JButton
<simplejavacalculator.UI: void init()>/$stack169	javax.swing.JPanel
<simplejavacalculator.Calculator: java.lang.Double calculateBi(simplejavacalculator.Calculator$BiOperatorModes,java.lang.Double)>/$stack7	java.lang.Double
<simplejavacalculator.UI: java.lang.Double reader()>/this#_0	simplejavacalculator.UI
<simplejavacalculator.UI: java.lang.Double reader()>/$stack5	java.lang.Double
<simplejavacalculator.UI: void init()>/$stack146	java.awt.Component
<simplejavacalculator.Calculator: java.lang.Double calculateBiImpl()>/$stack3	simplejavacalculator.Calculator$BiOperatorModes
<simplejavacalculator.UI: void init()>/$stack85	javax.swing.JButton
<simplejavacalculator.Calculator: java.lang.Double calculateBiImpl()>/@this	simplejavacalculator.Calculator
<simplejavacalculator.UI: void init()>/$stack141	javax.swing.JButton
<simplejavacalculator.Calculator: java.lang.Double calculateMono(simplejavacalculator.Calculator$MonoOperatorModes,java.lang.Double)>/$stack52	java.lang.Double
<simplejavacalculator.UI: void actionPerformed(java.awt.event.ActionEvent)>/$stack33	simplejavacalculator.Calculator
<simplejavacalculator.UI: void init()>/$stack128	javax.swing.JButton[]
<simplejavacalculator.Calculator: java.lang.Double calculateEqual(java.lang.Double)>/num#_0	java.lang.Double
<simplejavacalculator.UI: void <init>()>/$stringconstant3	java.lang.String
<simplejavacalculator.UI: void actionPerformed(java.awt.event.ActionEvent)>/$stack28	simplejavacalculator.Calculator
<simplejavacalculator.UI: void init()>/$stack71	javax.swing.JButton
<simplejavacalculator.UI: void actionPerformed(java.awt.event.ActionEvent)>/$stack66	java.lang.Double
<simplejavacalculator.UI: void actionPerformed(java.awt.event.ActionEvent)>/$stack58	simplejavacalculator.Calculator$MonoOperatorModes
<simplejavacalculator.Calculator: void <init>()>/@this	simplejavacalculator.Calculator
<simplejavacalculator.Calculator$BiOperatorModes: void <clinit>()>/$stack10	simplejavacalculator.Calculator$BiOperatorModes
<simplejavacalculator.UI: void init()>/$stack107	java.awt.Component
<simplejavacalculator.UI: void init()>/$stack176	java.awt.Component
<simplejavacalculator.Calculator: java.lang.Double calculateMono(simplejavacalculator.Calculator$MonoOperatorModes,java.lang.Double)>/$stack15	java.lang.Double
<simplejavacalculator.UI: void init()>/$stack50	javax.swing.JTextArea
<simplejavacalculator.Calculator: java.lang.Double calculateMono(simplejavacalculator.Calculator$MonoOperatorModes,java.lang.Double)>/$stack47	double
<simplejavacalculator.Calculator$BiOperatorModes: void <clinit>()>/$stack6	simplejavacalculator.Calculator$BiOperatorModes[]
<simplejavacalculator.Calculator: java.lang.Double calculateBi(simplejavacalculator.Calculator$BiOperatorModes,java.lang.Double)>/num#_0	java.lang.Double
<simplejavacalculator.Calculator: java.lang.Double calculateMono(simplejavacalculator.Calculator$MonoOperatorModes,java.lang.Double)>/$stack20	double
<simplejavacalculator.Calculator$MonoOperatorModes: void <init>(java.lang.String,int)>/@parameter1	int
<simplejavacalculator.UI: void init()>/$stack171	javax.swing.JButton
<simplejavacalculator.UI: void actionPerformed(java.awt.event.ActionEvent)>/$stack21	javax.swing.JButton
<simplejavacalculator.UI: void actionPerformed(java.awt.event.ActionEvent)>/$stack52	simplejavacalculator.Calculator$MonoOperatorModes
<simplejavacalculator.UI: void actionPerformed(java.awt.event.ActionEvent)>/$stack94	simplejavacalculator.Calculator$BiOperatorModes
<simplejavacalculator.UI: void init()>/$stack129	javax.swing.JButton
<simplejavacalculator.UI: void init()>/$stack21	java.awt.Font
<simplejavacalculator.Calculator: java.lang.Double calculateMono(simplejavacalculator.Calculator$MonoOperatorModes,java.lang.Double)>/@this	simplejavacalculator.Calculator
<simplejavacalculator.UI: java.lang.Double reader()>/str#_318	java.lang.String
<simplejavacalculator.UI: void actionPerformed(java.awt.event.ActionEvent)>/$stack15	javax.swing.JButton
<simplejavacalculator.UI: void init()>/$stack124	java.awt.Component
<simplejavacalculator.UI: void actionPerformed(java.awt.event.ActionEvent)>/$stack39	simplejavacalculator.Calculator
<simplejavacalculator.Calculator$BiOperatorModes: void <init>(java.lang.String,int)>/this#_0	simplejavacalculator.Calculator$BiOperatorModes
<simplejavacalculator.Calculator: java.lang.Double calculateBiImpl()>/$stack42	java.lang.Double
<simplejavacalculator.UI: void <init>()>/$stack3	javax.swing.JFrame
<simplejavacalculator.UI: void init()>/$stack7	javax.swing.ImageIcon
<simplejavacalculator.UI: void init()>/$stack133	java.awt.Component
<simplejavacalculator.Calculator: java.lang.Double calculateBiImpl()>/$stack47	java.lang.Double
<simplejavacalculator.UI: void init()>/$stack38	javax.swing.JButton
<simplejavacalculator.Calculator$BiOperatorModes: void <clinit>()>/$stringconstant2	java.lang.String
<simplejavacalculator.Calculator: java.lang.Double calculateBiImpl()>/$stack8	simplejavacalculator.Calculator$BiOperatorModes
<simplejavacalculator.UI: void init()>/$stack111	java.awt.Component
<simplejavacalculator.UI: void actionPerformed(java.awt.event.ActionEvent)>/$stack5	javax.swing.JButton
<simplejavacalculator.UI: void <init>()>/$stack35	javax.swing.JButton
<simplejavacalculator.Calculator: java.lang.Double calculateMono(simplejavacalculator.Calculator$MonoOperatorModes,java.lang.Double)>/$stack43	double
<simplejavacalculator.UI: void <init>()>/$stringconstant15	java.lang.String
<simplejavacalculator.Calculator: java.lang.Double calculateBiImpl()>/$stack44	java.lang.Double
<simplejavacalculator.UI: void <init>()>/i	bottom_type
<simplejavacalculator.UI: void init()>/$stack201	java.awt.Component
<simplejavacalculator.UI: void actionPerformed(java.awt.event.ActionEvent)>/$stack82	simplejavacalculator.Calculator$MonoOperatorModes
<simplejavacalculator.UI: void parsetoBinary()>/$stack6	java.lang.String
<simplejavacalculator.UI: void writer(java.lang.Double)>/$stack5	double
<simplejavacalculator.UI: void init()>/$numconstant0	int
<simplejavacalculator.UI: void <init>()>/i_$$A_1_$$A_2#_86	int
<simplejavacalculator.Calculator$MonoOperatorModes: void <clinit>()>/$stringconstant4	java.lang.String
<simplejavacalculator.UI: void <init>()>/$stringconstant12	java.lang.String
<simplejavacalculator.UI: void init()>/$stack59	java.awt.Component
<simplejavacalculator.UI: void init()>/$stack77	javax.swing.JPanel
<simplejavacalculator.UI: void init()>/$stack131	java.awt.Component
<simplejavacalculator.Calculator: java.lang.Double calculateBiImpl()>/$stack33	double
<simplejavacalculator.UI: void init()>/$stack145	javax.swing.JPanel
<simplejavacalculator.UI: void parsetoBinary()>/$stack8	java.lang.String
<simplejavacalculator.UI: void actionPerformed(java.awt.event.ActionEvent)>/$stack54	java.lang.Double
<simplejavacalculator.Calculator$MonoOperatorModes: void <clinit>()>/$stringconstant8	java.lang.String
<simplejavacalculator.UI: void init()>/$stack157	javax.swing.JPanel
<simplejavacalculator.UI: void <init>()>/@this	simplejavacalculator.UI
<simplejavacalculator.UI: void actionPerformed(java.awt.event.ActionEvent)>/$stack69	simplejavacalculator.Calculator
<simplejavacalculator.UI: void <init>()>/$stringconstant7	java.lang.String
<simplejavacalculator.Calculator: java.lang.Double calculateBiImpl()>/$stack24	double
<simplejavacalculator.UI: void actionPerformed(java.awt.event.ActionEvent)>/$stack45	simplejavacalculator.Calculator
<simplejavacalculator.UI: void actionPerformed(java.awt.event.ActionEvent)>/$stack11	javax.swing.JButton
<simplejavacalculator.UI: void init()>/$stack65	javax.swing.JButton
<simplejavacalculator.UI: void actionPerformed(java.awt.event.ActionEvent)>/$stack103	simplejavacalculator.UI
<simplejavacalculator.UI: void <init>()>/$stringconstant21	java.lang.String
<simplejavacalculator.UI: void init()>/$stack13	java.awt.Font
<simplejavacalculator.UI: void init()>/$numconstant7	int
<simplejavacalculator.Calculator$BiOperatorModes: void <clinit>()>/$stack1	simplejavacalculator.Calculator$BiOperatorModes
<simplejavacalculator.UI: void init()>/i_$$A_1_$$A_1#_123	int
<simplejavacalculator.UI: void init()>/$stack209	byte
<simplejavacalculator.Calculator: java.lang.Double calculateMono(simplejavacalculator.Calculator$MonoOperatorModes,java.lang.Double)>/$stack6	simplejavacalculator.Calculator$MonoOperatorModes
<simplejavacalculator.UI: void init()>/$numconstant8	int
<simplejavacalculator.Calculator: java.lang.Double reset()>/$stack2	java.lang.Double
<simplejavacalculator.UI: void actionPerformed(java.awt.event.ActionEvent)>/$stack63	simplejavacalculator.Calculator
<simplejavacalculator.UI: void init()>/$stack193	javax.swing.JButton
<simplejavacalculator.UI: void init()>/$stack120	javax.swing.JPanel
<simplejavacalculator.UI: void init()>/$stack54	javax.swing.JPanel
<simplejavacalculator.UI: void actionPerformed(java.awt.event.ActionEvent)>/$stack23	simplejavacalculator.UI
<simplejavacalculator.Calculator: java.lang.Double calculateMono(simplejavacalculator.Calculator$MonoOperatorModes,java.lang.Double)>/$stack5	simplejavacalculator.Calculator$MonoOperatorModes
<simplejavacalculator.UI: void actionPerformed(java.awt.event.ActionEvent)>/$stack112	simplejavacalculator.Calculator$BiOperatorModes
<simplejavacalculator.UI: void init()>/$stack53	javax.swing.JPanel
<simplejavacalculator.UI: void init()>/$stack46	javax.swing.JButton
<simplejavacalculator.Calculator$BiOperatorModes: void <init>(java.lang.String,int)>/l1#_0	java.lang.String
<simplejavacalculator.UI: java.lang.Double reader()>/$stack3	javax.swing.JTextArea
<simplejavacalculator.Calculator: java.lang.Double calculateBiImpl()>/$stack1	simplejavacalculator.Calculator$BiOperatorModes
<simplejavacalculator.UI: java.lang.Double reader()>/@this	simplejavacalculator.UI
<simplejavacalculator.UI: void init()>/$stack158	java.awt.Component
<simplejavacalculator.UI: void init()>/$stack142	javax.swing.JPanel
<simplejavacalculator.Calculator: java.lang.Double calculateBiImpl()>/$stack14	java.lang.Double
<simplejavacalculator.Calculator: java.lang.Double calculateEqual(java.lang.Double)>/$stack2	simplejavacalculator.Calculator$BiOperatorModes
<simplejavacalculator.Calculator: java.lang.Double calculateMono(simplejavacalculator.Calculator$MonoOperatorModes,java.lang.Double)>/$stack36	byte
<simplejavacalculator.Calculator: java.lang.Double calculateBiImpl()>/$stack32	java.lang.Double
<simplejavacalculator.UI: void actionPerformed(java.awt.event.ActionEvent)>/$stack13	javax.swing.JButton
<simplejavacalculator.UI: void init()>/$stack80	javax.swing.JButton[]
<simplejavacalculator.Calculator$MonoOperatorModes: void <clinit>()>/$stack15	simplejavacalculator.Calculator$MonoOperatorModes
<simplejavacalculator.UI: void init()>/$stack151	javax.swing.JPanel
<simplejavacalculator.Calculator: java.lang.Double calculateMono(simplejavacalculator.Calculator$MonoOperatorModes,java.lang.Double)>/$stack53	double
<simplejavacalculator.UI: void <init>()>/$stack27	java.awt.Font
<simplejavacalculator.Calculator: java.lang.Double calculateEqual(java.lang.Double)>/@parameter0	java.lang.Double
<simplejavacalculator.UI: void actionPerformed(java.awt.event.ActionEvent)>/$stack68	java.lang.Object
<simplejavacalculator.UI: void init()>/$stack62	javax.swing.JPanel
<simplejavacalculator.Calculator: java.lang.Double calculateBiImpl()>/$stack31	java.lang.Double
<simplejavacalculator.Calculator: java.lang.Double reset()>/$stack3	simplejavacalculator.Calculator$BiOperatorModes
<simplejavacalculator.Calculator$MonoOperatorModes: void <clinit>()>/$numconstant2	int
<simplejavacalculator.Calculator: java.lang.Double calculateBiImpl()>/$stack16	java.lang.Double
<simplejavacalculator.UI: void parsetoBinary()>/$stack17	java.lang.String
<simplejavacalculator.Calculator$MonoOperatorModes: void <clinit>()>/$stack11	simplejavacalculator.Calculator$MonoOperatorModes
<simplejavacalculator.UI: void <init>()>/$stack39	javax.swing.JButton
<simplejavacalculator.UI: void <init>()>/$stringconstant17	java.lang.String
<simplejavacalculator.UI: void actionPerformed(java.awt.event.ActionEvent)>/$stack29	java.lang.Double
<simplejavacalculator.UI: void init()>/$stack115	java.awt.Component
<simplejavacalculator.Calculator$MonoOperatorModes: void <clinit>()>/$numconstant4	int
<simplejavacalculator.UI: void <init>()>/$stack17	javax.swing.JPanel
<simplejavacalculator.UI: void init()>/$stack18	javax.swing.JButton
<simplejavacalculator.UI: void init()>/$numconstant3	int
<simplejavacalculator.SimpleJavaCalculator: void <init>()>/@this	simplejavacalculator.SimpleJavaCalculator
<simplejavacalculator.UI: void init()>/$numconstant5	int
<simplejavacalculator.UI: void init()>/$stack116	javax.swing.JPanel
<simplejavacalculator.Calculator: java.lang.Double calculateMono(simplejavacalculator.Calculator$MonoOperatorModes,java.lang.Double)>/num#_0	java.lang.Double
<simplejavacalculator.Calculator: java.lang.Double calculateMono(simplejavacalculator.Calculator$MonoOperatorModes,java.lang.Double)>/$stack14	double
<simplejavacalculator.UI: void init()>/$stack90	javax.swing.JPanel
<simplejavacalculator.UI: void init()>/$stack163	javax.swing.JPanel
<simplejavacalculator.Calculator: java.lang.Double calculateMono(simplejavacalculator.Calculator$MonoOperatorModes,java.lang.Double)>/$stack8	simplejavacalculator.Calculator$MonoOperatorModes
<simplejavacalculator.Calculator: java.lang.Double calculateBiImpl()>/$stack41	java.lang.Double
<simplejavacalculator.UI: void actionPerformed(java.awt.event.ActionEvent)>/$stack121	java.lang.String[]
<simplejavacalculator.UI: void actionPerformed(java.awt.event.ActionEvent)>/$stack89	java.lang.Double
<simplejavacalculator.Calculator$BiOperatorModes: void <clinit>()>/$numconstant4	int
<simplejavacalculator.UI: void init()>/$stack119	javax.swing.JButton
<simplejavacalculator.Calculator$BiOperatorModes: void <init>(java.lang.String,int)>/l2#_0	int
<simplejavacalculator.Calculator$BiOperatorModes: void <clinit>()>/$stack4	simplejavacalculator.Calculator$BiOperatorModes
<simplejavacalculator.UI: void actionPerformed(java.awt.event.ActionEvent)>/$stack46	simplejavacalculator.Calculator$MonoOperatorModes
<simplejavacalculator.UI: void init()>/$stack57	javax.swing.JButton
<simplejavacalculator.Calculator$BiOperatorModes: simplejavacalculator.Calculator$BiOperatorModes[] values()>/$stack0	simplejavacalculator.Calculator$BiOperatorModes[]
<simplejavacalculator.Calculator$BiOperatorModes: void <clinit>()>/$stringconstant3	java.lang.String
<simplejavacalculator.Calculator$MonoOperatorModes: void <clinit>()>/$stringconstant0	java.lang.String
<simplejavacalculator.UI: void init()>/$stack60	javax.swing.JButton[]
<simplejavacalculator.UI: void init()>/$stack205	int
<simplejavacalculator.Calculator$BiOperatorModes: void <clinit>()>/$stack11	simplejavacalculator.Calculator$BiOperatorModes
<simplejavacalculator.UI: void init()>/$stack3	javax.swing.JFrame
<simplejavacalculator.Calculator: java.lang.Double calculateMono(simplejavacalculator.Calculator$MonoOperatorModes,java.lang.Double)>/$stack27	byte
<simplejavacalculator.UI: void init()>/$stack148	javax.swing.JPanel
<simplejavacalculator.Calculator: java.lang.Double calculateMono(simplejavacalculator.Calculator$MonoOperatorModes,java.lang.Double)>/$stack55	double
<simplejavacalculator.UI: void init()>/$stack43	java.awt.Font
<simplejavacalculator.UI: void actionPerformed(java.awt.event.ActionEvent)>/$stack93	simplejavacalculator.Calculator
<simplejavacalculator.UI: void actionPerformed(java.awt.event.ActionEvent)>/$stack84	java.lang.Double
<simplejavacalculator.Calculator: java.lang.Double calculateMono(simplejavacalculator.Calculator$MonoOperatorModes,java.lang.Double)>/$stack46	double
<simplejavacalculator.UI: void writer(java.lang.Double)>/$stack4	javax.swing.JTextArea
<simplejavacalculator.UI: void init()>/$stack67	java.awt.Component
<simplejavacalculator.Calculator$MonoOperatorModes: void <clinit>()>/$stack13	simplejavacalculator.Calculator$MonoOperatorModes
<simplejavacalculator.UI: void init()>/$stack206	javax.swing.JButton[]
<simplejavacalculator.UI: void init()>/$stack98	javax.swing.JButton
<simplejavacalculator.Calculator: java.lang.Double calculateBiImpl()>/$stack22	java.lang.Double
<simplejavacalculator.UI: void init()>/$stack42	javax.swing.JButton
<simplejavacalculator.UI: void actionPerformed(java.awt.event.ActionEvent)>/@this	simplejavacalculator.UI
<simplejavacalculator.Calculator$MonoOperatorModes: void <clinit>()>/$numconstant5	int
<simplejavacalculator.UI: void actionPerformed(java.awt.event.ActionEvent)>/$stack37	simplejavacalculator.UI
<simplejavacalculator.UI: void init()>/$stack64	javax.swing.JButton[]
<simplejavacalculator.UI: void init()>/$stack28	javax.swing.JButton
<simplejavacalculator.SimpleJavaCalculator: void main(java.lang.String[])>/args#_0	java.lang.String[]
<simplejavacalculator.Calculator: java.lang.Double calculateMono(simplejavacalculator.Calculator$MonoOperatorModes,java.lang.Double)>/$stack35	double
<simplejavacalculator.UI: void actionPerformed(java.awt.event.ActionEvent)>/$stack6	javax.swing.JButton
<simplejavacalculator.Calculator: java.lang.Double calculateBi(simplejavacalculator.Calculator$BiOperatorModes,java.lang.Double)>/$stack6	java.lang.Double
<simplejavacalculator.Calculator$MonoOperatorModes: void <clinit>()>/$stack6	simplejavacalculator.Calculator$MonoOperatorModes
<simplejavacalculator.UI: void init()>/$stack174	javax.swing.JButton
<simplejavacalculator.UI: void actionPerformed(java.awt.event.ActionEvent)>/$stack49	simplejavacalculator.UI
<simplejavacalculator.UI: void <init>()>/$stringconstant4	java.lang.String
<simplejavacalculator.UI: void actionPerformed(java.awt.event.ActionEvent)>/$stack77	java.lang.Double
<simplejavacalculator.UI: void init()>/$stack5	javax.swing.JFrame
<simplejavacalculator.UI: void actionPerformed(java.awt.event.ActionEvent)>/$stack51	simplejavacalculator.Calculator
<simplejavacalculator.UI: void init()>/$stack102	javax.swing.JPanel
<simplejavacalculator.Calculator$MonoOperatorModes: simplejavacalculator.Calculator$MonoOperatorModes valueOf(java.lang.String)>/name#_0	java.lang.String
<simplejavacalculator.UI: void <init>()>/$stack51	int
<simplejavacalculator.UI: void actionPerformed(java.awt.event.ActionEvent)>/$stack90	java.lang.Double
<simplejavacalculator.UI: void actionPerformed(java.awt.event.ActionEvent)>/$stack41	java.lang.Double
<simplejavacalculator.UI: void actionPerformed(java.awt.event.ActionEvent)>/$stack55	simplejavacalculator.UI
<simplejavacalculator.UI: void actionPerformed(java.awt.event.ActionEvent)>/$stack91	simplejavacalculator.UI
<simplejavacalculator.Calculator$MonoOperatorModes: simplejavacalculator.Calculator$MonoOperatorModes valueOf(java.lang.String)>/$stack2	simplejavacalculator.Calculator$MonoOperatorModes
<simplejavacalculator.UI: void init()>/$stack187	javax.swing.JButton
<simplejavacalculator.UI: void <init>()>/$stack40	javax.swing.JButton
<simplejavacalculator.SimpleJavaCalculator: void main(java.lang.String[])>/@parameter0	java.lang.String[]
<simplejavacalculator.UI: void actionPerformed(java.awt.event.ActionEvent)>/$stack16	javax.swing.JButton
<simplejavacalculator.Calculator: java.lang.Double calculateMono(simplejavacalculator.Calculator$MonoOperatorModes,java.lang.Double)>/$stack11	simplejavacalculator.Calculator$MonoOperatorModes
<simplejavacalculator.UI: void <init>()>/$stringconstant2	java.lang.String
<simplejavacalculator.UI: void actionPerformed(java.awt.event.ActionEvent)>/$stack86	java.lang.Object
<simplejavacalculator.UI: void actionPerformed(java.awt.event.ActionEvent)>/$stack70	simplejavacalculator.Calculator$MonoOperatorModes
<simplejavacalculator.UI: void actionPerformed(java.awt.event.ActionEvent)>/$stack78	java.lang.Double
<simplejavacalculator.Calculator: java.lang.Double calculateBi(simplejavacalculator.Calculator$BiOperatorModes,java.lang.Double)>/$stack3	simplejavacalculator.Calculator$BiOperatorModes
<simplejavacalculator.UI: void <init>()>/$numconstant2	int
<simplejavacalculator.UI: void writer(java.lang.Double)>/$stack2	double
<simplejavacalculator.UI: void actionPerformed(java.awt.event.ActionEvent)>/$stack85	simplejavacalculator.UI
<simplejavacalculator.UI: void init()>/$stack37	java.awt.Font
<simplejavacalculator.UI: void actionPerformed(java.awt.event.ActionEvent)>/$stack102	java.lang.Double
<simplejavacalculator.UI: void init()>/$stack156	javax.swing.JButton
<simplejavacalculator.UI: void parsetoBinary()>/$stack12	java.lang.StringBuilder
<simplejavacalculator.Calculator: java.lang.Double calculateMono(simplejavacalculator.Calculator$MonoOperatorModes,java.lang.Double)>/@parameter0	simplejavacalculator.Calculator$MonoOperatorModes
<simplejavacalculator.UI: void actionPerformed(java.awt.event.ActionEvent)>/$stack27	java.lang.Object
<simplejavacalculator.Calculator$BiOperatorModes: void <clinit>()>/$stack3	simplejavacalculator.Calculator$BiOperatorModes
<simplejavacalculator.UI: void <init>()>/$stack48	javax.swing.JButton[]
<simplejavacalculator.UI: void init()>/$numconstant4	int
<simplejavacalculator.UI: void init()>/$stack49	java.awt.Component
<simplejavacalculator.UI: void init()>/$stack15	java.awt.Font
<simplejavacalculator.UI: void actionPerformed(java.awt.event.ActionEvent)>/$stack10	javax.swing.JButton
<simplejavacalculator.UI: void actionPerformed(java.awt.event.ActionEvent)>/$stack40	simplejavacalculator.Calculator$MonoOperatorModes
<simplejavacalculator.UI: void <init>()>/$stack16	java.awt.FlowLayout
<simplejavacalculator.UI: void init()>/$stack203	javax.swing.JButton
<simplejavacalculator.Calculator$MonoOperatorModes: void <clinit>()>/$stack4	simplejavacalculator.Calculator$MonoOperatorModes
<simplejavacalculator.UI: void <init>()>/$stack31	javax.swing.JButton
<simplejavacalculator.UI: void actionPerformed(java.awt.event.ActionEvent)>/$stack114	java.lang.Double
<simplejavacalculator.Calculator: java.lang.Double calculateMono(simplejavacalculator.Calculator$MonoOperatorModes,java.lang.Double)>/$stack31	double
<simplejavacalculator.UI: void <init>()>/$stack42	javax.swing.JButton
<simplejavacalculator.Calculator: java.lang.Double calculateBiImpl()>/$stack48	java.lang.Double
<simplejavacalculator.UI: void actionPerformed(java.awt.event.ActionEvent)>/$stack97	simplejavacalculator.UI
<simplejavacalculator.Calculator: java.lang.Double calculateBiImpl()>/$stack12	simplejavacalculator.Calculator$BiOperatorModes
<simplejavacalculator.Calculator: java.lang.Double calculateBiImpl()>/$stack5	simplejavacalculator.Calculator$BiOperatorModes
<simplejavacalculator.UI: void init()>/$stack45	java.awt.Font
<simplejavacalculator.UI: void actionPerformed(java.awt.event.ActionEvent)>/$stack109	simplejavacalculator.UI
<simplejavacalculator.Calculator: java.lang.Double reset()>/$numconstant2	double
<simplejavacalculator.UI: void init()>/$stack16	javax.swing.JButton
<simplejavacalculator.Calculator$BiOperatorModes: void <clinit>()>/$numconstant0	int
<simplejavacalculator.Calculator: java.lang.Double calculateMono(simplejavacalculator.Calculator$MonoOperatorModes,java.lang.Double)>/$stack54	double
<simplejavacalculator.UI: void init()>/$stack188	javax.swing.JButton
<simplejavacalculator.UI: void init()>/$stack192	javax.swing.JButton
<simplejavacalculator.UI: void actionPerformed(java.awt.event.ActionEvent)>/$stack19	javax.swing.JButton
<simplejavacalculator.UI: void init()>/$stack179	java.awt.Component
<simplejavacalculator.UI: void actionPerformed(java.awt.event.ActionEvent)>/$stack123	javax.swing.JTextArea
<simplejavacalculator.Calculator: java.lang.Double calculateMono(simplejavacalculator.Calculator$MonoOperatorModes,java.lang.Double)>/this#_0	simplejavacalculator.Calculator
<simplejavacalculator.UI: void init()>/$stack12	javax.swing.JTextArea
<simplejavacalculator.UI: void init()>/$stack161	java.awt.Component
<simplejavacalculator.Calculator$MonoOperatorModes: void <clinit>()>/$stringconstant7	java.lang.String
<simplejavacalculator.UI: void actionPerformed(java.awt.event.ActionEvent)>/$stack81	simplejavacalculator.Calculator
<simplejavacalculator.UI: void init()>/$stack20	javax.swing.JButton
<simplejavacalculator.Calculator: void <init>()>/this#_0	simplejavacalculator.Calculator
<simplejavacalculator.UI: void init()>/$stack34	javax.swing.JButton
<simplejavacalculator.UI: void actionPerformed(java.awt.event.ActionEvent)>/$stack12	javax.swing.JButton
<simplejavacalculator.UI: void init()>/$stack4	javax.swing.JFrame
<simplejavacalculator.UI: void init()>/$stack40	javax.swing.JButton
<simplejavacalculator.UI: void init()>/$stack72	javax.swing.JPanel
<simplejavacalculator.UI: void <init>()>/$stringconstant24	java.lang.String
<simplejavacalculator.UI: void init()>/$stack199	javax.swing.JPanel
<simplejavacalculator.Calculator: java.lang.Double calculateBiImpl()>/$stack34	java.lang.Double
<simplejavacalculator.Calculator: java.lang.Double calculateBiImpl()>/$stack43	double
<simplejavacalculator.UI: void <init>()>/$stringconstant9	java.lang.String
<simplejavacalculator.UI: void init()>/$stack31	java.awt.Font
<simplejavacalculator.UI: void <init>()>/i_$$A_1#_86	int
<simplejavacalculator.UI: void <init>()>/$stringconstant19	java.lang.String
<simplejavacalculator.UI: void init()>/$stack86	javax.swing.JPanel
<simplejavacalculator.UI: void init()>/$stack44	javax.swing.JButton
<simplejavacalculator.UI: void <init>()>/$stack18	java.awt.FlowLayout
<simplejavacalculator.Calculator$MonoOperatorModes: void <init>(java.lang.String,int)>/l2#_0	int
<simplejavacalculator.UI: void actionPerformed(java.awt.event.ActionEvent)>/$stack60	java.lang.Double
<simplejavacalculator.UI: void init()>/$numconstant10	int
<simplejavacalculator.Calculator: java.lang.Double calculateBiImpl()>/$stack36	double
<simplejavacalculator.UI: void init()>/$stack10	java.awt.Font
<simplejavacalculator.UI: void init()>/$stack135	javax.swing.JPanel
<simplejavacalculator.UI: void init()>/$stack83	java.awt.Component
<simplejavacalculator.Calculator$BiOperatorModes: simplejavacalculator.Calculator$BiOperatorModes valueOf(java.lang.String)>/name#_0	java.lang.String
<simplejavacalculator.UI: void writer(java.lang.Double)>/$stringconstant0	java.lang.String
<simplejavacalculator.Calculator: java.lang.Double calculateEqual(java.lang.Double)>/@this	simplejavacalculator.Calculator
<simplejavacalculator.UI: void init()>/$stack132	javax.swing.JPanel
<simplejavacalculator.UI: void init()>/$stack32	javax.swing.JButton
<simplejavacalculator.UI: void init()>/$stack117	java.awt.Component
<simplejavacalculator.UI: void init()>/$stack170	java.awt.Component
<simplejavacalculator.UI: void actionPerformed(java.awt.event.ActionEvent)>/$stack53	java.lang.Double
<simplejavacalculator.UI: void init()>/$stack175	javax.swing.JPanel
<simplejavacalculator.UI: void actionPerformed(java.awt.event.ActionEvent)>/$stack50	java.lang.Object
<simplejavacalculator.UI: void init()>/$stack149	java.awt.Component
<simplejavacalculator.UI: void init()>/$numconstant1	int
<simplejavacalculator.Calculator$MonoOperatorModes: void <clinit>()>/$stack7	simplejavacalculator.Calculator$MonoOperatorModes
<simplejavacalculator.UI: void init()>/$stack30	javax.swing.JButton
<simplejavacalculator.UI: void <init>()>/$stack32	javax.swing.JButton
<simplejavacalculator.Calculator: java.lang.Double calculateBiImpl()>/$stack26	java.lang.Double
<simplejavacalculator.Calculator: java.lang.Double calculateBiImpl()>/$stack35	double
<simplejavacalculator.UI: void actionPerformed(java.awt.event.ActionEvent)>/$stack14	javax.swing.JButton
<simplejavacalculator.Calculator$MonoOperatorModes: void <clinit>()>/$stringconstant2	java.lang.String
<simplejavacalculator.UI: void actionPerformed(java.awt.event.ActionEvent)>/$stack87	simplejavacalculator.Calculator
<simplejavacalculator.Calculator$MonoOperatorModes: void <init>(java.lang.String,int)>/l1#_0	java.lang.String
<simplejavacalculator.UI: void init()>/$stack91	java.awt.Component
<simplejavacalculator.Calculator$MonoOperatorModes: void <clinit>()>/$stack5	simplejavacalculator.Calculator$MonoOperatorModes
<simplejavacalculator.UI: void init()>/$stack61	javax.swing.JButton
<simplejavacalculator.Calculator$BiOperatorModes: void <clinit>()>/$stack7	simplejavacalculator.Calculator$BiOperatorModes
<simplejavacalculator.UI: void <init>()>/$stack50	byte
<simplejavacalculator.UI: void init()>/$stack136	javax.swing.JPanel
<simplejavacalculator.UI: void init()>/$numconstant2	int
<simplejavacalculator.UI: void init()>/$stack58	javax.swing.JPanel
<simplejavacalculator.Calculator: java.lang.Double calculateBiImpl()>/$stack6	simplejavacalculator.Calculator$BiOperatorModes
<simplejavacalculator.UI: void init()>/$stack63	java.awt.Component
<simplejavacalculator.Calculator: java.lang.Double calculateMono(simplejavacalculator.Calculator$MonoOperatorModes,java.lang.Double)>/$stack26	double
<simplejavacalculator.UI: void init()>/$stack48	java.awt.Component
<simplejavacalculator.UI: void init()>/$numconstant6	int
<simplejavacalculator.UI: void actionPerformed(java.awt.event.ActionEvent)>/$stack96	java.lang.Double
<simplejavacalculator.UI: void init()>/$stack92	javax.swing.JPanel
<simplejavacalculator.Calculator$BiOperatorModes: void <init>(java.lang.String,int)>/@parameter0	java.lang.String
<simplejavacalculator.UI: void actionPerformed(java.awt.event.ActionEvent)>/$stack20	javax.swing.JButton
<simplejavacalculator.UI: void init()>/$stack17	java.awt.Font
<simplejavacalculator.UI: void actionPerformed(java.awt.event.ActionEvent)>/$stack92	java.lang.Object
<simplejavacalculator.UI: void actionPerformed(java.awt.event.ActionEvent)>/$stack36	java.lang.Double
<simplejavacalculator.Calculator$BiOperatorModes: void <clinit>()>/$numconstant2	int
<simplejavacalculator.UI: void actionPerformed(java.awt.event.ActionEvent)>/$stack113	java.lang.Double
<simplejavacalculator.Calculator$BiOperatorModes: void <init>(java.lang.String,int)>/@parameter1	int
<simplejavacalculator.Calculator$MonoOperatorModes: void <clinit>()>/$stringconstant1	java.lang.String
<simplejavacalculator.UI: void <init>()>/$stack23	javax.swing.JPanel
<simplejavacalculator.UI: void init()>/$stack198	javax.swing.JButton
<simplejavacalculator.UI: void init()>/$stack183	javax.swing.JButton
<simplejavacalculator.UI: void init()>/$stack76	java.awt.Component
<simplejavacalculator.UI: void init()>/$stack130	javax.swing.JPanel
<simplejavacalculator.UI: void init()>/$stack68	javax.swing.JPanel
<simplejavacalculator.Calculator: java.lang.Double calculateMono(simplejavacalculator.Calculator$MonoOperatorModes,java.lang.Double)>/$stack7	simplejavacalculator.Calculator$MonoOperatorModes
<simplejavacalculator.UI: void init()>/$stack14	javax.swing.JButton
<simplejavacalculator.Calculator: java.lang.Double calculateBiImpl()>/this#_0	simplejavacalculator.Calculator
<simplejavacalculator.Calculator$MonoOperatorModes: simplejavacalculator.Calculator$MonoOperatorModes[] values()>/$stack0	simplejavacalculator.Calculator$MonoOperatorModes[]
<simplejavacalculator.UI: void parsetoBinary()>/$stack7	long
<simplejavacalculator.Calculator$BiOperatorModes: void <clinit>()>/$stringconstant0	java.lang.String
<simplejavacalculator.Calculator: java.lang.Double calculateMono(simplejavacalculator.Calculator$MonoOperatorModes,java.lang.Double)>/$stack48	double
<simplejavacalculator.UI: void init()>/$stack154	javax.swing.JPanel
<simplejavacalculator.UI: void init()>/$stack160	javax.swing.JPanel
<simplejavacalculator.UI: void init()>/$stack196	javax.swing.JButton
<simplejavacalculator.Calculator: java.lang.Double reset()>/$numconstant1	double
<simplejavacalculator.Calculator: java.lang.Double calculateBiImpl()>/$stack45	double
<simplejavacalculator.Calculator$BiOperatorModes: simplejavacalculator.Calculator$BiOperatorModes valueOf(java.lang.String)>/$classconstant0	java.lang.Class
<simplejavacalculator.Calculator$MonoOperatorModes: void <clinit>()>/$numconstant1	int
<simplejavacalculator.UI: void parsetoBinary()>/this#_0	simplejavacalculator.UI
<simplejavacalculator.UI: void init()>/$stack26	javax.swing.JButton
<simplejavacalculator.UI: void init()>/$stack178	javax.swing.JPanel
<simplejavacalculator.UI: void init()>/$stack88	javax.swing.JButton[]
<simplejavacalculator.Calculator: java.lang.Double calculateMono(simplejavacalculator.Calculator$MonoOperatorModes,java.lang.Double)>/$stack18	java.lang.Double
<simplejavacalculator.UI: void init()>/$stack82	javax.swing.JPanel
<simplejavacalculator.UI: void <init>()>/$numconstant1	int
<simplejavacalculator.UI: void actionPerformed(java.awt.event.ActionEvent)>/$stack24	simplejavacalculator.Calculator
<simplejavacalculator.Calculator: void <init>()>/$stack1	simplejavacalculator.Calculator$BiOperatorModes
<simplejavacalculator.UI: void init()>/this#_0	simplejavacalculator.UI
<simplejavacalculator.UI: void init()>/$stack173	java.awt.Component
<simplejavacalculator.UI: void actionPerformed(java.awt.event.ActionEvent)>/$stack122	java.lang.String
<simplejavacalculator.Calculator: java.lang.Double calculateMono(simplejavacalculator.Calculator$MonoOperatorModes,java.lang.Double)>/$stack10	simplejavacalculator.Calculator$MonoOperatorModes
<simplejavacalculator.Calculator: java.lang.Double calculateMono(simplejavacalculator.Calculator$MonoOperatorModes,java.lang.Double)>/$stack41	double
<simplejavacalculator.UI: void actionPerformed(java.awt.event.ActionEvent)>/$stack83	java.lang.Double
<simplejavacalculator.UI: void init()>/$stack127	java.awt.Component
<simplejavacalculator.UI: void init()>/$stack150	javax.swing.JPanel
<simplejavacalculator.Calculator: java.lang.Double calculateBiImpl()>/$stack11	simplejavacalculator.Calculator$BiOperatorModes
<simplejavacalculator.UI: void <init>()>/this#_0	simplejavacalculator.UI
<simplejavacalculator.Calculator: java.lang.Double calculateBi(simplejavacalculator.Calculator$BiOperatorModes,java.lang.Double)>/$stack4	simplejavacalculator.Calculator$BiOperatorModes
<simplejavacalculator.UI: void actionPerformed(java.awt.event.ActionEvent)>/$stack31	simplejavacalculator.UI
<simplejavacalculator.UI: void init()>/$stack29	java.awt.Font
<simplejavacalculator.UI: void init()>/$stack55	java.awt.Component
<simplejavacalculator.UI: void parsetoBinary()>/$stringconstant1	java.lang.String
<simplejavacalculator.Calculator$MonoOperatorModes: void <clinit>()>/$stack8	simplejavacalculator.Calculator$MonoOperatorModes
<simplejavacalculator.Calculator$MonoOperatorModes: void <clinit>()>/$stack3	simplejavacalculator.Calculator$MonoOperatorModes
<simplejavacalculator.UI: void init()>/$stack207	java.awt.Font
<simplejavacalculator.UI: void init()>/$stack204	byte
<simplejavacalculator.UI: void parsetoBinary()>/$stack3	javax.swing.JTextArea
<simplejavacalculator.UI: void <init>()>/$stringconstant10	java.lang.String
<simplejavacalculator.UI: void init()>/$stack109	javax.swing.JButton
<simplejavacalculator.UI: void init()>/$stack186	javax.swing.JButton
<simplejavacalculator.UI: void init()>/$stack155	java.awt.Component
<simplejavacalculator.UI: void init()>/$stack74	javax.swing.JButton
<simplejavacalculator.UI: void init()>/i_$$A_1#_122	int
<simplejavacalculator.UI: void actionPerformed(java.awt.event.ActionEvent)>/$stack100	simplejavacalculator.Calculator$BiOperatorModes
<simplejavacalculator.UI: void <init>()>/$stack38	javax.swing.JButton
<simplejavacalculator.Calculator: java.lang.Double calculateBi(simplejavacalculator.Calculator$BiOperatorModes,java.lang.Double)>/newMode#_0	simplejavacalculator.Calculator$BiOperatorModes
<simplejavacalculator.Calculator: java.lang.Double calculateEqual(java.lang.Double)>/this#_0	simplejavacalculator.Calculator
<simplejavacalculator.UI: void init()>/$stack113	javax.swing.JButton
<simplejavacalculator.UI: void init()>/$stack22	javax.swing.JButton
<simplejavacalculator.UI: void actionPerformed(java.awt.event.ActionEvent)>/$stack7	javax.swing.JButton
<simplejavacalculator.UI: void init()>/$stack144	javax.swing.JButton
<simplejavacalculator.Calculator: java.lang.Double calculateMono(simplejavacalculator.Calculator$MonoOperatorModes,java.lang.Double)>/$stack37	java.lang.Double
<simplejavacalculator.Calculator$BiOperatorModes: void <clinit>()>/$stack9	simplejavacalculator.Calculator$BiOperatorModes
<simplejavacalculator.UI: void parsetoBinary()>/$stack10	java.lang.String
<simplejavacalculator.UI: void init()>/$stack2	javax.swing.JFrame
<simplejavacalculator.UI: void init()>/$stack172	javax.swing.JPanel
<simplejavacalculator.UI: void actionPerformed(java.awt.event.ActionEvent)>/$stack116	java.lang.Object
<simplejavacalculator.UI: void <init>()>/$stack41	javax.swing.JButton
<simplejavacalculator.UI: void init()>/$stack114	javax.swing.JPanel
<simplejavacalculator.Calculator$MonoOperatorModes: void <clinit>()>/$stack17	simplejavacalculator.Calculator$MonoOperatorModes
<simplejavacalculator.UI: void actionPerformed(java.awt.event.ActionEvent)>/$stack38	java.lang.Object
<simplejavacalculator.UI: void init()>/$stack123	javax.swing.JPanel
<simplejavacalculator.Calculator: java.lang.Double calculateBiImpl()>/$stack13	java.lang.Error
<simplejavacalculator.UI: void <init>()>/$numconstant6	int
<simplejavacalculator.Calculator: java.lang.Double calculateMono(simplejavacalculator.Calculator$MonoOperatorModes,java.lang.Double)>/@parameter1	java.lang.Double
<simplejavacalculator.Calculator$BiOperatorModes: simplejavacalculator.Calculator$BiOperatorModes[] values()>/$stack2	simplejavacalculator.Calculator$BiOperatorModes[]
<simplejavacalculator.UI: void init()>/$stack190	javax.swing.JButton
<simplejavacalculator.Calculator: java.lang.Double calculateMono(simplejavacalculator.Calculator$MonoOperatorModes,java.lang.Double)>/$stack56	java.lang.Double
<simplejavacalculator.Calculator: java.lang.Double calculateMono(simplejavacalculator.Calculator$MonoOperatorModes,java.lang.Double)>/$stack3	simplejavacalculator.Calculator$MonoOperatorModes
<simplejavacalculator.Calculator$MonoOperatorModes: void <clinit>()>/$stack10	simplejavacalculator.Calculator$MonoOperatorModes
<simplejavacalculator.UI: void <init>()>/$stack45	javax.swing.JButton
<simplejavacalculator.Calculator: java.lang.Double calculateBiImpl()>/$stack7	simplejavacalculator.Calculator$BiOperatorModes
<simplejavacalculator.Calculator: java.lang.Double calculateMono(simplejavacalculator.Calculator$MonoOperatorModes,java.lang.Double)>/$stack9	simplejavacalculator.Calculator$MonoOperatorModes
<simplejavacalculator.UI: void actionPerformed(java.awt.event.ActionEvent)>/$stack105	simplejavacalculator.Calculator
<simplejavacalculator.SimpleJavaCalculator: void main(java.lang.String[])>/$stack2	simplejavacalculator.UI
<simplejavacalculator.Calculator: java.lang.Double calculateBi(simplejavacalculator.Calculator$BiOperatorModes,java.lang.Double)>/$stack8	java.lang.Double
<simplejavacalculator.UI: java.lang.Double reader()>/num#_319	java.lang.Double
<simplejavacalculator.Calculator$MonoOperatorModes: void <clinit>()>/$stack16	simplejavacalculator.Calculator$MonoOperatorModes
<simplejavacalculator.UI: void writer(java.lang.Double)>/num#_0	java.lang.Double
<simplejavacalculator.UI: void <init>()>/$stack20	java.awt.FlowLayout
<simplejavacalculator.UI: void init()>/$stack79	java.awt.Component
<simplejavacalculator.UI: void init()>/$stack78	javax.swing.JPanel
<simplejavacalculator.UI: void actionPerformed(java.awt.event.ActionEvent)>/source#_220	java.lang.Object
<simplejavacalculator.Calculator: java.lang.Double calculateBiImpl()>/$stack2	simplejavacalculator.Calculator$BiOperatorModes
<simplejavacalculator.UI: void init()>/$stack11	javax.swing.JTextArea
<simplejavacalculator.UI: void actionPerformed(java.awt.event.ActionEvent)>/$stack35	java.lang.Double
<simplejavacalculator.UI: void <init>()>/$numconstant4	int
<simplejavacalculator.UI: void init()>/$stack147	javax.swing.JButton
<simplejavacalculator.Calculator: java.lang.Double calculateMono(simplejavacalculator.Calculator$MonoOperatorModes,java.lang.Double)>/$numconstant0	double
<simplejavacalculator.UI: void actionPerformed(java.awt.event.ActionEvent)>/$stack79	simplejavacalculator.UI
<simplejavacalculator.Calculator$BiOperatorModes: void <clinit>()>/$numconstant3	int
<simplejavacalculator.UI: void init()>/$stack125	javax.swing.JPanel
<simplejavacalculator.Calculator$BiOperatorModes: simplejavacalculator.Calculator$BiOperatorModes valueOf(java.lang.String)>/@parameter0	java.lang.String
<simplejavacalculator.UI: void <init>()>/$stack7	javax.swing.JPanel
<simplejavacalculator.UI: void <init>()>/$numconstant5	int
<simplejavacalculator.Calculator: java.lang.Double calculateMono(simplejavacalculator.Calculator$MonoOperatorModes,java.lang.Double)>/$stack38	java.lang.Double
<simplejavacalculator.UI: void init()>/$stack23	java.awt.Font
<simplejavacalculator.UI: void init()>/$stack140	java.awt.Component
<simplejavacalculator.Calculator$BiOperatorModes: void <clinit>()>/$stack2	simplejavacalculator.Calculator$BiOperatorModes
<simplejavacalculator.UI: void init()>/$stack51	javax.swing.JPanel
<simplejavacalculator.Calculator$MonoOperatorModes: void <clinit>()>/$stack12	simplejavacalculator.Calculator$MonoOperatorModes
<simplejavacalculator.Calculator$MonoOperatorModes: simplejavacalculator.Calculator$MonoOperatorModes[] values()>/$stack2	simplejavacalculator.Calculator$MonoOperatorModes[]
<simplejavacalculator.UI: void <init>()>/$stack43	javax.swing.JButton
<simplejavacalculator.UI: void init()>/$stack182	javax.swing.JButton
<simplejavacalculator.UI: void actionPerformed(java.awt.event.ActionEvent)>/i	bottom_type
<simplejavacalculator.UI: void init()>/$stack195	javax.swing.JButton
<simplejavacalculator.UI: void actionPerformed(java.awt.event.ActionEvent)>/$stack47	java.lang.Double
<simplejavacalculator.Calculator: java.lang.Double calculateMono(simplejavacalculator.Calculator$MonoOperatorModes,java.lang.Double)>/$stack23	byte
<simplejavacalculator.Calculator$MonoOperatorModes: simplejavacalculator.Calculator$MonoOperatorModes[] values()>/$stack1	java.lang.Object
<simplejavacalculator.UI: void <init>()>/$stack15	javax.swing.JPanel
<simplejavacalculator.UI: void parsetoBinary()>/$stack14	java.lang.StringBuilder
<simplejavacalculator.Calculator: java.lang.Double calculateBiImpl()>/$stack4	simplejavacalculator.Calculator$BiOperatorModes
<simplejavacalculator.UI: void init()>/$stack87	java.awt.Component
<simplejavacalculator.UI: void actionPerformed(java.awt.event.ActionEvent)>/$stack32	java.lang.Object
<simplejavacalculator.UI: void <init>()>/$stack44	javax.swing.JButton
<simplejavacalculator.UI: void actionPerformed(java.awt.event.ActionEvent)>/$stack118	javax.swing.JButton
<simplejavacalculator.UI: void init()>/$stack137	java.awt.Component
<simplejavacalculator.UI: void init()>/$stack81	javax.swing.JButton
<simplejavacalculator.UI: void init()>/$stack126	javax.swing.JPanel
<simplejavacalculator.UI: void actionPerformed(java.awt.event.ActionEvent)>/i_$$A_1_$$A_2#_222	int
<simplejavacalculator.UI: void init()>/$stack166	javax.swing.JPanel
<simplejavacalculator.Calculator: java.lang.Double reset()>/$stack4	java.lang.Double
<simplejavacalculator.UI: void <init>()>/$stringconstant0	java.lang.String
<simplejavacalculator.UI: void init()>/$stack70	java.awt.Component
<simplejavacalculator.UI: void actionPerformed(java.awt.event.ActionEvent)>/$stack57	simplejavacalculator.Calculator
<simplejavacalculator.Calculator: java.lang.Double calculateMono(simplejavacalculator.Calculator$MonoOperatorModes,java.lang.Double)>/$stack34	double
<simplejavacalculator.UI: void actionPerformed(java.awt.event.ActionEvent)>/$stack80	java.lang.Object
<simplejavacalculator.Calculator: java.lang.Double calculateMono(simplejavacalculator.Calculator$MonoOperatorModes,java.lang.Double)>/$stack16	double
<simplejavacalculator.Calculator: java.lang.Double calculateBiImpl()>/$stack20	java.lang.Double
<simplejavacalculator.UI: void <init>()>/$stack24	java.awt.FlowLayout
<simplejavacalculator.UI: void actionPerformed(java.awt.event.ActionEvent)>/$stack22	javax.swing.JTextArea
<simplejavacalculator.UI: void actionPerformed(java.awt.event.ActionEvent)>/$stack71	java.lang.Double
<simplejavacalculator.UI: void init()>/$stack9	java.awt.Image
<simplejavacalculator.UI: void <init>()>/$stack21	javax.swing.JPanel
<simplejavacalculator.UI: void <init>()>/$numconstant3	int
<simplejavacalculator.UI: void init()>/$stack159	javax.swing.JButton
<simplejavacalculator.Calculator$BiOperatorModes: simplejavacalculator.Calculator$BiOperatorModes[] values()>/$stack1	java.lang.Object
<simplejavacalculator.Calculator$MonoOperatorModes: void <clinit>()>/$numconstant0	int
<simplejavacalculator.UI: void init()>/$stack200	javax.swing.JFrame
<simplejavacalculator.UI: void parsetoBinary()>/@this	simplejavacalculator.UI
<simplejavacalculator.UI: void writer(java.lang.Double)>/$stack3	boolean
<simplejavacalculator.UI: void actionPerformed(java.awt.event.ActionEvent)>/$stack73	simplejavacalculator.UI
<simplejavacalculator.Calculator: java.lang.Double calculateBiImpl()>/$stack27	double
<simplejavacalculator.Calculator: java.lang.Double reset()>/$numconstant0	double
<simplejavacalculator.Calculator: java.lang.Double calculateBiImpl()>/$stack37	java.lang.Double
<simplejavacalculator.UI: void actionPerformed(java.awt.event.ActionEvent)>/$stack65	java.lang.Double
<simplejavacalculator.Calculator: java.lang.Double reset()>/@this	simplejavacalculator.Calculator
<simplejavacalculator.UI: void init()>/$stack56	javax.swing.JButton[]
<simplejavacalculator.UI: void init()>/$stack162	javax.swing.JPanel
<simplejavacalculator.Calculator$BiOperatorModes: void <clinit>()>/$stack12	simplejavacalculator.Calculator$BiOperatorModes
<simplejavacalculator.Calculator$MonoOperatorModes: void <clinit>()>/$stack0	simplejavacalculator.Calculator$MonoOperatorModes
<simplejavacalculator.Calculator$MonoOperatorModes: void <clinit>()>/$numconstant8	int
<simplejavacalculator.UI: void <init>()>/$stringconstant11	java.lang.String
<simplejavacalculator.UI: void init()>/$stack134	java.awt.Component
<simplejavacalculator.UI: void actionPerformed(java.awt.event.ActionEvent)>/$stack25	java.lang.Double
<simplejavacalculator.UI: void <init>()>/$stringconstant29	java.lang.String
<simplejavacalculator.UI: void actionPerformed(java.awt.event.ActionEvent)>/$stack117	javax.swing.JButton[]
<simplejavacalculator.UI: void init()>/$stack122	javax.swing.JButton
<simplejavacalculator.UI: void actionPerformed(java.awt.event.ActionEvent)>/$stack59	java.lang.Double
<simplejavacalculator.UI: void <init>()>/$stack14	java.awt.FlowLayout
<simplejavacalculator.Calculator: java.lang.Double calculateBi(simplejavacalculator.Calculator$BiOperatorModes,java.lang.Double)>/this#_0	simplejavacalculator.Calculator
<simplejavacalculator.UI: void <init>()>/$stack12	java.awt.FlowLayout
<simplejavacalculator.UI: void actionPerformed(java.awt.event.ActionEvent)>/$stack62	java.lang.Object
<simplejavacalculator.UI: void parsetoBinary()>/$stack11	java.lang.NumberFormatException
<simplejavacalculator.UI: void <init>()>/$stringconstant20	java.lang.String
<simplejavacalculator.UI: void init()>/$stack194	javax.swing.JButton
<simplejavacalculator.UI: void actionPerformed(java.awt.event.ActionEvent)>/$stack48	java.lang.Double
<simplejavacalculator.Calculator$BiOperatorModes: void <clinit>()>/$stringconstant5	java.lang.String
<simplejavacalculator.UI: void actionPerformed(java.awt.event.ActionEvent)>/i_$$A_1#_222	int
<simplejavacalculator.UI: void init()>/$stack24	javax.swing.JButton
<simplejavacalculator.UI: void actionPerformed(java.awt.event.ActionEvent)>/$stack98	java.lang.Object
<simplejavacalculator.UI: void init()>/$stack19	java.awt.Font
<simplejavacalculator.UI: void init()>/$stack27	java.awt.Font
<simplejavacalculator.UI: void parsetoBinary()>/$stringconstant0	java.lang.String
<simplejavacalculator.UI: void init()>/$stack103	java.awt.Component
<simplejavacalculator.Calculator: java.lang.Double calculateMono(simplejavacalculator.Calculator$MonoOperatorModes,java.lang.Double)>/$stack22	double
<simplejavacalculator.Calculator: java.lang.Double calculateMono(simplejavacalculator.Calculator$MonoOperatorModes,java.lang.Double)>/$stack30	byte
<simplejavacalculator.Calculator$MonoOperatorModes: simplejavacalculator.Calculator$MonoOperatorModes valueOf(java.lang.String)>/@parameter0	java.lang.String
<simplejavacalculator.Calculator$MonoOperatorModes: void <init>(java.lang.String,int)>/this#_0	simplejavacalculator.Calculator$MonoOperatorModes
<simplejavacalculator.Calculator: java.lang.Double calculateBi(simplejavacalculator.Calculator$BiOperatorModes,java.lang.Double)>/@parameter1	java.lang.Double
<simplejavacalculator.Calculator: java.lang.Double calculateMono(simplejavacalculator.Calculator$MonoOperatorModes,java.lang.Double)>/$stack13	double
<simplejavacalculator.UI: void actionPerformed(java.awt.event.ActionEvent)>/$stack119	byte
<simplejavacalculator.Calculator: java.lang.Double calculateBi(simplejavacalculator.Calculator$BiOperatorModes,java.lang.Double)>/@parameter0	simplejavacalculator.Calculator$BiOperatorModes
<simplejavacalculator.UI: void parsetoBinary()>/$stack5	javax.swing.JTextArea
<simplejavacalculator.Calculator: java.lang.Double calculateMono(simplejavacalculator.Calculator$MonoOperatorModes,java.lang.Double)>/$stack25	double
<simplejavacalculator.Calculator: java.lang.Double calculateBiImpl()>/$stack15	double
<simplejavacalculator.Calculator$MonoOperatorModes: simplejavacalculator.Calculator$MonoOperatorModes valueOf(java.lang.String)>/$stack1	java.lang.Enum
<simplejavacalculator.UI: void actionPerformed(java.awt.event.ActionEvent)>/$stack74	java.lang.Object
<simplejavacalculator.UI: void <init>()>/$stack10	java.awt.FlowLayout
<simplejavacalculator.UI: void init()>/$stack96	javax.swing.JPanel
<simplejavacalculator.UI: void actionPerformed(java.awt.event.ActionEvent)>/$stack44	java.lang.Object
<simplejavacalculator.Calculator: java.lang.Double calculateMono(simplejavacalculator.Calculator$MonoOperatorModes,java.lang.Double)>/$stack19	double
<simplejavacalculator.UI: void init()>/$stack110	javax.swing.JPanel
<simplejavacalculator.UI: void init()>/$stack25	java.awt.Font
<simplejavacalculator.Calculator: java.lang.Double calculateMono(simplejavacalculator.Calculator$MonoOperatorModes,java.lang.Double)>/$stack4	simplejavacalculator.Calculator$MonoOperatorModes
<simplejavacalculator.UI: void actionPerformed(java.awt.event.ActionEvent)>/$stack88	simplejavacalculator.Calculator$BiOperatorModes
<simplejavacalculator.UI: void init()>/$stack118	java.awt.Component
<simplejavacalculator.UI: void actionPerformed(java.awt.event.ActionEvent)>/e#_0	java.awt.event.ActionEvent
<simplejavacalculator.UI: void init()>/$stack75	javax.swing.JPanel
<simplejavacalculator.UI: void <init>()>/$stack2	java.lang.String[]
<simplejavacalculator.UI: void <init>()>/$stringconstant6	java.lang.String
<simplejavacalculator.Calculator: java.lang.Double calculateBiImpl()>/$stack18	double
<simplejavacalculator.UI: void <init>()>/$stack22	java.awt.FlowLayout
<simplejavacalculator.Calculator$MonoOperatorModes: void <clinit>()>/$stack18	simplejavacalculator.Calculator$MonoOperatorModes
<simplejavacalculator.UI: void actionPerformed(java.awt.event.ActionEvent)>/$stack4	java.lang.Object
<simplejavacalculator.Calculator: java.lang.Double calculateMono(simplejavacalculator.Calculator$MonoOperatorModes,java.lang.Double)>/$stack51	double
<simplejavacalculator.UI: void actionPerformed(java.awt.event.ActionEvent)>/$stack104	java.lang.Object
<simplejavacalculator.UI: void writer(java.lang.Double)>/this#_0	simplejavacalculator.UI
<simplejavacalculator.UI: void <init>()>/$stringconstant25	java.lang.String
<simplejavacalculator.Calculator$MonoOperatorModes: void <clinit>()>/$stack2	simplejavacalculator.Calculator$MonoOperatorModes
<simplejavacalculator.UI: java.lang.Double reader()>/$stack4	java.lang.String
<simplejavacalculator.Calculator: java.lang.Double calculateBiImpl()>/$stack39	double
<simplejavacalculator.UI: void <init>()>/$stringconstant26	java.lang.String
<simplejavacalculator.UI: void init()>/$stack181	javax.swing.JButton
<simplejavacalculator.UI: void init()>/i	bottom_type
<simplejavacalculator.UI: void actionPerformed(java.awt.event.ActionEvent)>/$stack26	simplejavacalculator.UI
<simplejavacalculator.UI: void parsetoBinary()>/$stack2	java.lang.StringBuilder
<simplejavacalculator.UI: void init()>/$stack202	javax.swing.JButton[]
<simplejavacalculator.UI: void actionPerformed(java.awt.event.ActionEvent)>/$stack34	simplejavacalculator.Calculator$MonoOperatorModes
<simplejavacalculator.Calculator: java.lang.Double calculateMono(simplejavacalculator.Calculator$MonoOperatorModes,java.lang.Double)>/$stack24	java.lang.Double
<simplejavacalculator.UI: void actionPerformed(java.awt.event.ActionEvent)>/$stack120	int
<simplejavacalculator.UI: void <init>()>/$stringconstant23	java.lang.String
<simplejavacalculator.Calculator: java.lang.Double calculateBiImpl()>/$stack17	double
<simplejavacalculator.UI: void parsetoBinary()>/$stack9	java.lang.StringBuilder
<simplejavacalculator.UI: void init()>/$stack52	java.awt.Component
<simplejavacalculator.UI: void <init>()>/$stringconstant16	java.lang.String
<simplejavacalculator.Calculator$BiOperatorModes: simplejavacalculator.Calculator$BiOperatorModes valueOf(java.lang.String)>/$stack1	java.lang.Enum
<simplejavacalculator.Calculator$MonoOperatorModes: void <clinit>()>/$stringconstant3	java.lang.String
<simplejavacalculator.UI: void init()>/$stack41	java.awt.Font
<simplejavacalculator.UI: void init()>/$stack47	javax.swing.JPanel
<simplejavacalculator.UI: void init()>/$stack191	javax.swing.JButton
<simplejavacalculator.UI: void init()>/$stack93	java.awt.Component
<simplejavacalculator.UI: void init()>/$stack94	java.awt.Component
<simplejavacalculator.UI: void actionPerformed(java.awt.event.ActionEvent)>/$stack30	java.lang.Double
<simplejavacalculator.UI: void init()>/i_$$A_1_$$A_2#_122	int
<simplejavacalculator.UI: void init()>/$stack185	javax.swing.JButton
<simplejavacalculator.Calculator: java.lang.Double calculateBi(simplejavacalculator.Calculator$BiOperatorModes,java.lang.Double)>/$numconstant1	double
<simplejavacalculator.UI: void init()>/$stack210	int
<simplejavacalculator.Calculator: java.lang.Double calculateBiImpl()>/$stack28	java.lang.Double
<simplejavacalculator.UI: void init()>/$stack208	javax.swing.JButton
<simplejavacalculator.Calculator: java.lang.Double reset()>/$stack1	java.lang.Double
<simplejavacalculator.Calculator$BiOperatorModes: void <clinit>()>/$stack0	simplejavacalculator.Calculator$BiOperatorModes
<simplejavacalculator.Calculator$BiOperatorModes: void <clinit>()>/$stack8	simplejavacalculator.Calculator$BiOperatorModes
<simplejavacalculator.UI: void actionPerformed(java.awt.event.ActionEvent)>/$stack67	simplejavacalculator.UI
<simplejavacalculator.UI: void <init>()>/$stringconstant27	java.lang.String
<simplejavacalculator.UI: void <init>()>/$stack9	javax.swing.JPanel
<simplejavacalculator.UI: void init()>/$stack112	javax.swing.JButton[]
<simplejavacalculator.UI: void <init>()>/$stringconstant14	java.lang.String
<simplejavacalculator.UI: void writer(java.lang.Double)>/$stack7	javax.swing.JTextArea
<simplejavacalculator.Calculator: java.lang.Double calculateBiImpl()>/$stack21	double
<simplejavacalculator.UI: void init()>/$stack101	javax.swing.JPanel
<simplejavacalculator.UI: void init()>/$stack89	javax.swing.JButton
<simplejavacalculator.UI: void actionPerformed(java.awt.event.ActionEvent)>/$stack56	java.lang.Object
<simplejavacalculator.Calculator$BiOperatorModes: void <clinit>()>/$stringconstant1	java.lang.String
<simplejavacalculator.UI: void init()>/@this	simplejavacalculator.UI
<simplejavacalculator.UI: void init()>/$null0	java.awt.Component
<simplejavacalculator.Calculator: java.lang.Double calculateMono(simplejavacalculator.Calculator$MonoOperatorModes,java.lang.Double)>/$stack12	java.lang.Error
<simplejavacalculator.UI: void <init>()>/$stack13	javax.swing.JPanel
<simplejavacalculator.Calculator: java.lang.Double calculateBiImpl()>/$stack30	double
<simplejavacalculator.UI: void <init>()>/$stack11	javax.swing.JPanel
<simplejavacalculator.UI: void init()>/$stack168	javax.swing.JButton
<simplejavacalculator.UI: void init()>/$stack8	javax.swing.JFrame
<simplejavacalculator.UI: void init()>/$stack138	javax.swing.JButton
<simplejavacalculator.Calculator: java.lang.Double calculateMono(simplejavacalculator.Calculator$MonoOperatorModes,java.lang.Double)>/$stack40	double
<simplejavacalculator.Calculator: java.lang.Double calculateMono(simplejavacalculator.Calculator$MonoOperatorModes,java.lang.Double)>/newMode#_0	simplejavacalculator.Calculator$MonoOperatorModes
<simplejavacalculator.UI: void <init>()>/$stack6	javax.swing.BoxLayout
<simplejavacalculator.UI: void actionPerformed(java.awt.event.ActionEvent)>/$stack107	java.lang.Double
<simplejavacalculator.UI: void actionPerformed(java.awt.event.ActionEvent)>/$stack95	java.lang.Double
<simplejavacalculator.UI: void actionPerformed(java.awt.event.ActionEvent)>/$stack110	java.lang.Object
<simplejavacalculator.UI: void init()>/$stack164	java.awt.Component
<simplejavacalculator.UI: void actionPerformed(java.awt.event.ActionEvent)>/$stack61	simplejavacalculator.UI
<simplejavacalculator.Calculator: java.lang.Double calculateBiImpl()>/$stack29	double
<simplejavacalculator.UI: void <init>()>/$stack28	javax.swing.JButton[]
<simplejavacalculator.UI: void actionPerformed(java.awt.event.ActionEvent)>/$stack75	simplejavacalculator.Calculator
<simplejavacalculator.UI: void parsetoBinary()>/$stack13	java.io.PrintStream
<simplejavacalculator.UI: void actionPerformed(java.awt.event.ActionEvent)>/$stack111	simplejavacalculator.Calculator
<simplejavacalculator.UI: void actionPerformed(java.awt.event.ActionEvent)>/$stack42	java.lang.Double
<simplejavacalculator.UI: void <init>()>/$stack34	javax.swing.JButton
<simplejavacalculator.Calculator$BiOperatorModes: void <clinit>()>/$stack5	simplejavacalculator.Calculator$BiOperatorModes
<simplejavacalculator.SimpleJavaCalculator: void <init>()>/this#_0	simplejavacalculator.SimpleJavaCalculator
<simplejavacalculator.Calculator: java.lang.Double calculateBi(simplejavacalculator.Calculator$BiOperatorModes,java.lang.Double)>/@this	simplejavacalculator.Calculator
<simplejavacalculator.Calculator: java.lang.Double calculateMono(simplejavacalculator.Calculator$MonoOperatorModes,java.lang.Double)>/$stack29	double
<simplejavacalculator.Calculator$MonoOperatorModes: void <clinit>()>/$stack14	simplejavacalculator.Calculator$MonoOperatorModes
<simplejavacalculator.Calculator: java.lang.Double calculateBiImpl()>/$stack38	java.lang.Double
<simplejavacalculator.Calculator$MonoOperatorModes: void <init>(java.lang.String,int)>/@parameter0	java.lang.String
<simplejavacalculator.UI: void <init>()>/$stringconstant22	java.lang.String
<simplejavacalculator.UI: void init()>/$stack73	java.awt.Component
<simplejavacalculator.Calculator: java.lang.Double calculateMono(simplejavacalculator.Calculator$MonoOperatorModes,java.lang.Double)>/$stack32	double
<simplejavacalculator.UI: void actionPerformed(java.awt.event.ActionEvent)>/@parameter0	java.awt.event.ActionEvent
<simplejavacalculator.UI: void init()>/$stack121	java.awt.Component
<simplejavacalculator.UI: void init()>/$stack165	javax.swing.JButton
<simplejavacalculator.UI: void <init>()>/$stringconstant1	java.lang.String
<simplejavacalculator.UI: void <init>()>/$stringconstant13	java.lang.String
<simplejavacalculator.UI: void actionPerformed(java.awt.event.ActionEvent)>/this#_0	simplejavacalculator.UI
<simplejavacalculator.UI: void actionPerformed(java.awt.event.ActionEvent)>/$stack99	simplejavacalculator.Calculator
<simplejavacalculator.UI: void parsetoBinary()>/$stack16	java.lang.StringBuilder
<simplejavacalculator.UI: void init()>/$stack152	java.awt.Component
<simplejavacalculator.UI: void init()>/i_$$A_1_$$A_4#_194	int
<simplejavacalculator.UI: void parsetoBinary()>/$stack4	java.lang.StringBuilder
<simplejavacalculator.Calculator: java.lang.Double calculateMono(simplejavacalculator.Calculator$MonoOperatorModes,java.lang.Double)>/$stack42	java.lang.Double
<simplejavacalculator.UI: void init()>/$stack180	javax.swing.JButton[]
<simplejavacalculator.UI: void actionPerformed(java.awt.event.ActionEvent)>/$stack115	simplejavacalculator.UI
<simplejavacalculator.Calculator$MonoOperatorModes: void <clinit>()>/$numconstant7	int
<simplejavacalculator.UI: void init()>/$stack99	javax.swing.JPanel
<simplejavacalculator.UI: void actionPerformed(java.awt.event.ActionEvent)>/$stack76	simplejavacalculator.Calculator$MonoOperatorModes
<simplejavacalculator.Calculator$BiOperatorModes: void <clinit>()>/$numconstant5	int
<simplejavacalculator.UI: void init()>/$stack95	javax.swing.JButton
<simplejavacalculator.Calculator$BiOperatorModes: void <init>(java.lang.String,int)>/@this	simplejavacalculator.Calculator$BiOperatorModes
<simplejavacalculator.UI: void init()>/$stack153	javax.swing.JButton
<simplejavacalculator.UI: void actionPerformed(java.awt.event.ActionEvent)>/i_$$A_1_$$A_1#_223	int
<simplejavacalculator.UI: void actionPerformed(java.awt.event.ActionEvent)>/$stack101	java.lang.Double
<simplejavacalculator.UI: void actionPerformed(java.awt.event.ActionEvent)>/$stack106	simplejavacalculator.Calculator$BiOperatorModes
<simplejavacalculator.UI: void <init>()>/$stringconstant30	java.lang.String
<simplejavacalculator.Calculator$BiOperatorModes: simplejavacalculator.Calculator$BiOperatorModes valueOf(java.lang.String)>/$stack2	simplejavacalculator.Calculator$BiOperatorModes
<simplejavacalculator.Calculator: java.lang.Double calculateMono(simplejavacalculator.Calculator$MonoOperatorModes,java.lang.Double)>/$stack39	double
<simplejavacalculator.UI: void init()>/$stack189	javax.swing.JButton
<simplejavacalculator.Calculator: java.lang.Double calculateMono(simplejavacalculator.Calculator$MonoOperatorModes,java.lang.Double)>/$stack44	double
<simplejavacalculator.UI: void <init>()>/$stringconstant28	java.lang.String
<simplejavacalculator.Calculator: java.lang.Double calculateMono(simplejavacalculator.Calculator$MonoOperatorModes,java.lang.Double)>/$stack21	java.lang.Double
<simplejavacalculator.UI: void init()>/$stack106	javax.swing.JPanel
<simplejavacalculator.UI: void init()>/i_$$A_1_$$A_5#_193	int
<simplejavacalculator.UI: void init()>/$stack97	java.awt.Component
<simplejavacalculator.UI: void writer(java.lang.Double)>/@this	simplejavacalculator.UI
<simplejavacalculator.UI: void init()>/$stack84	javax.swing.JButton[]
<simplejavacalculator.UI: void init()>/$stack6	javax.swing.JFrame
<simplejavacalculator.Calculator$MonoOperatorModes: void <clinit>()>/$stack1	simplejavacalculator.Calculator$MonoOperatorModes
<simplejavacalculator.Calculator: java.lang.Double calculateMono(simplejavacalculator.Calculator$MonoOperatorModes,java.lang.Double)>/$stack49	java.lang.Double
<simplejavacalculator.Calculator$MonoOperatorModes: void <clinit>()>/$numconstant3	int
<simplejavacalculator.UI: void init()>/$stack69	java.awt.Component
<simplejavacalculator.Calculator: java.lang.Double calculateBiImpl()>/$stack10	simplejavacalculator.Calculator$BiOperatorModes
<simplejavacalculator.UI: void <init>()>/$stringconstant8	java.lang.String
<simplejavacalculator.UI: void init()>/$stack39	java.awt.Font
<simplejavacalculator.UI: void init()>/$stack66	javax.swing.JPanel
<simplejavacalculator.UI: void init()>/$numconstant9	int
<simplejavacalculator.UI: void <init>()>/$stack47	javax.swing.JButton
<simplejavacalculator.UI: void <init>()>/$stack49	java.lang.String
<simplejavacalculator.UI: void <init>()>/$stack46	simplejavacalculator.Calculator
<simplejavacalculator.UI: void <init>()>/$stack30	javax.swing.JButton
<simplejavacalculator.UI: void <init>()>/$stack25	java.awt.Font
<simplejavacalculator.UI: void <init>()>/$stack4	javax.swing.ImageIcon
<simplejavacalculator.UI: void <init>()>/$stack29	javax.swing.JButton
<simplejavacalculator.SimpleJavaCalculator: void main(java.lang.String[])>/uiCal#_22	simplejavacalculator.UI
<simplejavacalculator.UI: void <init>()>/$stack5	javax.swing.JPanel
<simplejavacalculator.UI: void <init>()>/$stack8	javax.swing.JPanel
<simplejavacalculator.UI: void <init>()>/$stack19	javax.swing.JPanel
<simplejavacalculator.UI: void <init>()>/$stack26	javax.swing.JTextArea
