<simplejavacalculator.Calculator$BiOperatorModes: simplejavacalculator.Calculator$BiOperatorModes[] values()>/$stack0	<simplejavacalculator.Calculator$BiOperatorModes: simplejavacalculator.Calculator$BiOperatorModes[] values()>
<simplejavacalculator.Calculator$BiOperatorModes: simplejavacalculator.Calculator$BiOperatorModes[] values()>/$stack1	<simplejavacalculator.Calculator$BiOperatorModes: simplejavacalculator.Calculator$BiOperatorModes[] values()>
<simplejavacalculator.Calculator$BiOperatorModes: simplejavacalculator.Calculator$BiOperatorModes[] values()>/$stack2	<simplejavacalculator.Calculator$BiOperatorModes: simplejavacalculator.Calculator$BiOperatorModes[] values()>
<simplejavacalculator.Calculator$BiOperatorModes: simplejavacalculator.Calculator$BiOperatorModes valueOf(java.lang.String)>/@parameter0	<simplejavacalculator.Calculator$BiOperatorModes: simplejavacalculator.Calculator$BiOperatorModes valueOf(java.lang.String)>
<simplejavacalculator.Calculator$BiOperatorModes: simplejavacalculator.Calculator$BiOperatorModes valueOf(java.lang.String)>/name#_0	<simplejavacalculator.Calculator$BiOperatorModes: simplejavacalculator.Calculator$BiOperatorModes valueOf(java.lang.String)>
<simplejavacalculator.Calculator$BiOperatorModes: simplejavacalculator.Calculator$BiOperatorModes valueOf(java.lang.String)>/$stack1	<simplejavacalculator.Calculator$BiOperatorModes: simplejavacalculator.Calculator$BiOperatorModes valueOf(java.lang.String)>
<simplejavacalculator.Calculator$BiOperatorModes: simplejavacalculator.Calculator$BiOperatorModes valueOf(java.lang.String)>/$stack2	<simplejavacalculator.Calculator$BiOperatorModes: simplejavacalculator.Calculator$BiOperatorModes valueOf(java.lang.String)>
<simplejavacalculator.Calculator$BiOperatorModes: simplejavacalculator.Calculator$BiOperatorModes valueOf(java.lang.String)>/$classconstant0	<simplejavacalculator.Calculator$BiOperatorModes: simplejavacalculator.Calculator$BiOperatorModes valueOf(java.lang.String)>
<simplejavacalculator.Calculator$BiOperatorModes: void <init>(java.lang.String,int)>/@this	<simplejavacalculator.Calculator$BiOperatorModes: void <init>(java.lang.String,int)>
<simplejavacalculator.Calculator$BiOperatorModes: void <init>(java.lang.String,int)>/@parameter0	<simplejavacalculator.Calculator$BiOperatorModes: void <init>(java.lang.String,int)>
<simplejavacalculator.Calculator$BiOperatorModes: void <init>(java.lang.String,int)>/@parameter1	<simplejavacalculator.Calculator$BiOperatorModes: void <init>(java.lang.String,int)>
<simplejavacalculator.Calculator$BiOperatorModes: void <init>(java.lang.String,int)>/this#_0	<simplejavacalculator.Calculator$BiOperatorModes: void <init>(java.lang.String,int)>
<simplejavacalculator.Calculator$BiOperatorModes: void <init>(java.lang.String,int)>/l1#_0	<simplejavacalculator.Calculator$BiOperatorModes: void <init>(java.lang.String,int)>
<simplejavacalculator.Calculator$BiOperatorModes: void <init>(java.lang.String,int)>/l2#_0	<simplejavacalculator.Calculator$BiOperatorModes: void <init>(java.lang.String,int)>
<simplejavacalculator.Calculator$BiOperatorModes: void <clinit>()>/$stack0	<simplejavacalculator.Calculator$BiOperatorModes: void <clinit>()>
<simplejavacalculator.Calculator$BiOperatorModes: void <clinit>()>/$stack1	<simplejavacalculator.Calculator$BiOperatorModes: void <clinit>()>
<simplejavacalculator.Calculator$BiOperatorModes: void <clinit>()>/$stack2	<simplejavacalculator.Calculator$BiOperatorModes: void <clinit>()>
<simplejavacalculator.Calculator$BiOperatorModes: void <clinit>()>/$stack3	<simplejavacalculator.Calculator$BiOperatorModes: void <clinit>()>
<simplejavacalculator.Calculator$BiOperatorModes: void <clinit>()>/$stack4	<simplejavacalculator.Calculator$BiOperatorModes: void <clinit>()>
<simplejavacalculator.Calculator$BiOperatorModes: void <clinit>()>/$stack5	<simplejavacalculator.Calculator$BiOperatorModes: void <clinit>()>
<simplejavacalculator.Calculator$BiOperatorModes: void <clinit>()>/$stack6	<simplejavacalculator.Calculator$BiOperatorModes: void <clinit>()>
<simplejavacalculator.Calculator$BiOperatorModes: void <clinit>()>/$stack7	<simplejavacalculator.Calculator$BiOperatorModes: void <clinit>()>
<simplejavacalculator.Calculator$BiOperatorModes: void <clinit>()>/$stack8	<simplejavacalculator.Calculator$BiOperatorModes: void <clinit>()>
<simplejavacalculator.Calculator$BiOperatorModes: void <clinit>()>/$stack9	<simplejavacalculator.Calculator$BiOperatorModes: void <clinit>()>
<simplejavacalculator.Calculator$BiOperatorModes: void <clinit>()>/$stack10	<simplejavacalculator.Calculator$BiOperatorModes: void <clinit>()>
<simplejavacalculator.Calculator$BiOperatorModes: void <clinit>()>/$stack11	<simplejavacalculator.Calculator$BiOperatorModes: void <clinit>()>
<simplejavacalculator.Calculator$BiOperatorModes: void <clinit>()>/$stack12	<simplejavacalculator.Calculator$BiOperatorModes: void <clinit>()>
<simplejavacalculator.Calculator$BiOperatorModes: void <clinit>()>/$stringconstant0	<simplejavacalculator.Calculator$BiOperatorModes: void <clinit>()>
<simplejavacalculator.Calculator$BiOperatorModes: void <clinit>()>/$numconstant0	<simplejavacalculator.Calculator$BiOperatorModes: void <clinit>()>
<simplejavacalculator.Calculator$BiOperatorModes: void <clinit>()>/$stringconstant1	<simplejavacalculator.Calculator$BiOperatorModes: void <clinit>()>
<simplejavacalculator.Calculator$BiOperatorModes: void <clinit>()>/$numconstant1	<simplejavacalculator.Calculator$BiOperatorModes: void <clinit>()>
<simplejavacalculator.Calculator$BiOperatorModes: void <clinit>()>/$stringconstant2	<simplejavacalculator.Calculator$BiOperatorModes: void <clinit>()>
<simplejavacalculator.Calculator$BiOperatorModes: void <clinit>()>/$numconstant2	<simplejavacalculator.Calculator$BiOperatorModes: void <clinit>()>
<simplejavacalculator.Calculator$BiOperatorModes: void <clinit>()>/$stringconstant3	<simplejavacalculator.Calculator$BiOperatorModes: void <clinit>()>
<simplejavacalculator.Calculator$BiOperatorModes: void <clinit>()>/$numconstant3	<simplejavacalculator.Calculator$BiOperatorModes: void <clinit>()>
<simplejavacalculator.Calculator$BiOperatorModes: void <clinit>()>/$stringconstant4	<simplejavacalculator.Calculator$BiOperatorModes: void <clinit>()>
<simplejavacalculator.Calculator$BiOperatorModes: void <clinit>()>/$numconstant4	<simplejavacalculator.Calculator$BiOperatorModes: void <clinit>()>
<simplejavacalculator.Calculator$BiOperatorModes: void <clinit>()>/$stringconstant5	<simplejavacalculator.Calculator$BiOperatorModes: void <clinit>()>
<simplejavacalculator.Calculator$BiOperatorModes: void <clinit>()>/$numconstant5	<simplejavacalculator.Calculator$BiOperatorModes: void <clinit>()>
<simplejavacalculator.Calculator: void <init>()>/@this	<simplejavacalculator.Calculator: void <init>()>
<simplejavacalculator.Calculator: void <init>()>/this#_0	<simplejavacalculator.Calculator: void <init>()>
<simplejavacalculator.Calculator: void <init>()>/$stack1	<simplejavacalculator.Calculator: void <init>()>
<simplejavacalculator.Calculator: java.lang.Double calculateBiImpl()>/@this	<simplejavacalculator.Calculator: java.lang.Double calculateBiImpl()>
<simplejavacalculator.Calculator: java.lang.Double calculateBiImpl()>/this#_0	<simplejavacalculator.Calculator: java.lang.Double calculateBiImpl()>
<simplejavacalculator.Calculator: java.lang.Double calculateBiImpl()>/$stack1	<simplejavacalculator.Calculator: java.lang.Double calculateBiImpl()>
<simplejavacalculator.Calculator: java.lang.Double calculateBiImpl()>/$stack2	<simplejavacalculator.Calculator: java.lang.Double calculateBiImpl()>
<simplejavacalculator.Calculator: java.lang.Double calculateBiImpl()>/$stack3	<simplejavacalculator.Calculator: java.lang.Double calculateBiImpl()>
<simplejavacalculator.Calculator: java.lang.Double calculateBiImpl()>/$stack4	<simplejavacalculator.Calculator: java.lang.Double calculateBiImpl()>
<simplejavacalculator.Calculator: java.lang.Double calculateBiImpl()>/$stack5	<simplejavacalculator.Calculator: java.lang.Double calculateBiImpl()>
<simplejavacalculator.Calculator: java.lang.Double calculateBiImpl()>/$stack6	<simplejavacalculator.Calculator: java.lang.Double calculateBiImpl()>
<simplejavacalculator.Calculator: java.lang.Double calculateBiImpl()>/$stack7	<simplejavacalculator.Calculator: java.lang.Double calculateBiImpl()>
<simplejavacalculator.Calculator: java.lang.Double calculateBiImpl()>/$stack8	<simplejavacalculator.Calculator: java.lang.Double calculateBiImpl()>
<simplejavacalculator.Calculator: java.lang.Double calculateBiImpl()>/$stack9	<simplejavacalculator.Calculator: java.lang.Double calculateBiImpl()>
<simplejavacalculator.Calculator: java.lang.Double calculateBiImpl()>/$stack10	<simplejavacalculator.Calculator: java.lang.Double calculateBiImpl()>
<simplejavacalculator.Calculator: java.lang.Double calculateBiImpl()>/$stack11	<simplejavacalculator.Calculator: java.lang.Double calculateBiImpl()>
<simplejavacalculator.Calculator: java.lang.Double calculateBiImpl()>/$stack12	<simplejavacalculator.Calculator: java.lang.Double calculateBiImpl()>
<simplejavacalculator.Calculator: java.lang.Double calculateBiImpl()>/$stack13	<simplejavacalculator.Calculator: java.lang.Double calculateBiImpl()>
<simplejavacalculator.Calculator: java.lang.Double calculateBiImpl()>/$stack14	<simplejavacalculator.Calculator: java.lang.Double calculateBiImpl()>
<simplejavacalculator.Calculator: java.lang.Double calculateBiImpl()>/$stack15	<simplejavacalculator.Calculator: java.lang.Double calculateBiImpl()>
<simplejavacalculator.Calculator: java.lang.Double calculateBiImpl()>/$stack16	<simplejavacalculator.Calculator: java.lang.Double calculateBiImpl()>
<simplejavacalculator.Calculator: java.lang.Double calculateBiImpl()>/$stack17	<simplejavacalculator.Calculator: java.lang.Double calculateBiImpl()>
<simplejavacalculator.Calculator: java.lang.Double calculateBiImpl()>/$stack18	<simplejavacalculator.Calculator: java.lang.Double calculateBiImpl()>
<simplejavacalculator.Calculator: java.lang.Double calculateBiImpl()>/$stack19	<simplejavacalculator.Calculator: java.lang.Double calculateBiImpl()>
<simplejavacalculator.Calculator: java.lang.Double calculateBiImpl()>/$stack20	<simplejavacalculator.Calculator: java.lang.Double calculateBiImpl()>
<simplejavacalculator.Calculator: java.lang.Double calculateBiImpl()>/$stack21	<simplejavacalculator.Calculator: java.lang.Double calculateBiImpl()>
<simplejavacalculator.Calculator: java.lang.Double calculateBiImpl()>/$stack22	<simplejavacalculator.Calculator: java.lang.Double calculateBiImpl()>
<simplejavacalculator.Calculator: java.lang.Double calculateBiImpl()>/$stack23	<simplejavacalculator.Calculator: java.lang.Double calculateBiImpl()>
<simplejavacalculator.Calculator: java.lang.Double calculateBiImpl()>/$stack24	<simplejavacalculator.Calculator: java.lang.Double calculateBiImpl()>
<simplejavacalculator.Calculator: java.lang.Double calculateBiImpl()>/$stack25	<simplejavacalculator.Calculator: java.lang.Double calculateBiImpl()>
<simplejavacalculator.Calculator: java.lang.Double calculateBiImpl()>/$stack26	<simplejavacalculator.Calculator: java.lang.Double calculateBiImpl()>
<simplejavacalculator.Calculator: java.lang.Double calculateBiImpl()>/$stack27	<simplejavacalculator.Calculator: java.lang.Double calculateBiImpl()>
<simplejavacalculator.Calculator: java.lang.Double calculateBiImpl()>/$stack28	<simplejavacalculator.Calculator: java.lang.Double calculateBiImpl()>
<simplejavacalculator.Calculator: java.lang.Double calculateBiImpl()>/$stack29	<simplejavacalculator.Calculator: java.lang.Double calculateBiImpl()>
<simplejavacalculator.Calculator: java.lang.Double calculateBiImpl()>/$stack30	<simplejavacalculator.Calculator: java.lang.Double calculateBiImpl()>
<simplejavacalculator.Calculator: java.lang.Double calculateBiImpl()>/$stack31	<simplejavacalculator.Calculator: java.lang.Double calculateBiImpl()>
<simplejavacalculator.Calculator: java.lang.Double calculateBiImpl()>/$stack32	<simplejavacalculator.Calculator: java.lang.Double calculateBiImpl()>
<simplejavacalculator.Calculator: java.lang.Double calculateBiImpl()>/$stack33	<simplejavacalculator.Calculator: java.lang.Double calculateBiImpl()>
<simplejavacalculator.Calculator: java.lang.Double calculateBiImpl()>/$stack34	<simplejavacalculator.Calculator: java.lang.Double calculateBiImpl()>
<simplejavacalculator.Calculator: java.lang.Double calculateBiImpl()>/$stack35	<simplejavacalculator.Calculator: java.lang.Double calculateBiImpl()>
<simplejavacalculator.Calculator: java.lang.Double calculateBiImpl()>/$stack36	<simplejavacalculator.Calculator: java.lang.Double calculateBiImpl()>
<simplejavacalculator.Calculator: java.lang.Double calculateBiImpl()>/$stack37	<simplejavacalculator.Calculator: java.lang.Double calculateBiImpl()>
<simplejavacalculator.Calculator: java.lang.Double calculateBiImpl()>/$stack38	<simplejavacalculator.Calculator: java.lang.Double calculateBiImpl()>
<simplejavacalculator.Calculator: java.lang.Double calculateBiImpl()>/$stack39	<simplejavacalculator.Calculator: java.lang.Double calculateBiImpl()>
<simplejavacalculator.Calculator: java.lang.Double calculateBiImpl()>/$stack40	<simplejavacalculator.Calculator: java.lang.Double calculateBiImpl()>
<simplejavacalculator.Calculator: java.lang.Double calculateBiImpl()>/$stack41	<simplejavacalculator.Calculator: java.lang.Double calculateBiImpl()>
<simplejavacalculator.Calculator: java.lang.Double calculateBiImpl()>/$stack42	<simplejavacalculator.Calculator: java.lang.Double calculateBiImpl()>
<simplejavacalculator.Calculator: java.lang.Double calculateBiImpl()>/$stack43	<simplejavacalculator.Calculator: java.lang.Double calculateBiImpl()>
<simplejavacalculator.Calculator: java.lang.Double calculateBiImpl()>/$stack44	<simplejavacalculator.Calculator: java.lang.Double calculateBiImpl()>
<simplejavacalculator.Calculator: java.lang.Double calculateBiImpl()>/$stack45	<simplejavacalculator.Calculator: java.lang.Double calculateBiImpl()>
<simplejavacalculator.Calculator: java.lang.Double calculateBiImpl()>/$stack46	<simplejavacalculator.Calculator: java.lang.Double calculateBiImpl()>
<simplejavacalculator.Calculator: java.lang.Double calculateBiImpl()>/$stack47	<simplejavacalculator.Calculator: java.lang.Double calculateBiImpl()>
<simplejavacalculator.Calculator: java.lang.Double calculateBiImpl()>/$stack48	<simplejavacalculator.Calculator: java.lang.Double calculateBiImpl()>
<simplejavacalculator.Calculator: java.lang.Double calculateBi(simplejavacalculator.Calculator$BiOperatorModes,java.lang.Double)>/@this	<simplejavacalculator.Calculator: java.lang.Double calculateBi(simplejavacalculator.Calculator$BiOperatorModes,java.lang.Double)>
<simplejavacalculator.Calculator: java.lang.Double calculateBi(simplejavacalculator.Calculator$BiOperatorModes,java.lang.Double)>/@parameter0	<simplejavacalculator.Calculator: java.lang.Double calculateBi(simplejavacalculator.Calculator$BiOperatorModes,java.lang.Double)>
<simplejavacalculator.Calculator: java.lang.Double calculateBi(simplejavacalculator.Calculator$BiOperatorModes,java.lang.Double)>/@parameter1	<simplejavacalculator.Calculator: java.lang.Double calculateBi(simplejavacalculator.Calculator$BiOperatorModes,java.lang.Double)>
<simplejavacalculator.Calculator: java.lang.Double calculateBi(simplejavacalculator.Calculator$BiOperatorModes,java.lang.Double)>/this#_0	<simplejavacalculator.Calculator: java.lang.Double calculateBi(simplejavacalculator.Calculator$BiOperatorModes,java.lang.Double)>
<simplejavacalculator.Calculator: java.lang.Double calculateBi(simplejavacalculator.Calculator$BiOperatorModes,java.lang.Double)>/$stack3	<simplejavacalculator.Calculator: java.lang.Double calculateBi(simplejavacalculator.Calculator$BiOperatorModes,java.lang.Double)>
<simplejavacalculator.Calculator: java.lang.Double calculateBi(simplejavacalculator.Calculator$BiOperatorModes,java.lang.Double)>/$stack4	<simplejavacalculator.Calculator: java.lang.Double calculateBi(simplejavacalculator.Calculator$BiOperatorModes,java.lang.Double)>
<simplejavacalculator.Calculator: java.lang.Double calculateBi(simplejavacalculator.Calculator$BiOperatorModes,java.lang.Double)>/num#_0	<simplejavacalculator.Calculator: java.lang.Double calculateBi(simplejavacalculator.Calculator$BiOperatorModes,java.lang.Double)>
<simplejavacalculator.Calculator: java.lang.Double calculateBi(simplejavacalculator.Calculator$BiOperatorModes,java.lang.Double)>/$stack5	<simplejavacalculator.Calculator: java.lang.Double calculateBi(simplejavacalculator.Calculator$BiOperatorModes,java.lang.Double)>
<simplejavacalculator.Calculator: java.lang.Double calculateBi(simplejavacalculator.Calculator$BiOperatorModes,java.lang.Double)>/newMode#_0	<simplejavacalculator.Calculator: java.lang.Double calculateBi(simplejavacalculator.Calculator$BiOperatorModes,java.lang.Double)>
<simplejavacalculator.Calculator: java.lang.Double calculateBi(simplejavacalculator.Calculator$BiOperatorModes,java.lang.Double)>/$stack6	<simplejavacalculator.Calculator: java.lang.Double calculateBi(simplejavacalculator.Calculator$BiOperatorModes,java.lang.Double)>
<simplejavacalculator.Calculator: java.lang.Double calculateBi(simplejavacalculator.Calculator$BiOperatorModes,java.lang.Double)>/$stack7	<simplejavacalculator.Calculator: java.lang.Double calculateBi(simplejavacalculator.Calculator$BiOperatorModes,java.lang.Double)>
<simplejavacalculator.Calculator: java.lang.Double calculateBi(simplejavacalculator.Calculator$BiOperatorModes,java.lang.Double)>/$stack8	<simplejavacalculator.Calculator: java.lang.Double calculateBi(simplejavacalculator.Calculator$BiOperatorModes,java.lang.Double)>
<simplejavacalculator.Calculator: java.lang.Double calculateBi(simplejavacalculator.Calculator$BiOperatorModes,java.lang.Double)>/$numconstant0	<simplejavacalculator.Calculator: java.lang.Double calculateBi(simplejavacalculator.Calculator$BiOperatorModes,java.lang.Double)>
<simplejavacalculator.Calculator: java.lang.Double calculateBi(simplejavacalculator.Calculator$BiOperatorModes,java.lang.Double)>/$numconstant1	<simplejavacalculator.Calculator: java.lang.Double calculateBi(simplejavacalculator.Calculator$BiOperatorModes,java.lang.Double)>
<simplejavacalculator.Calculator: java.lang.Double calculateEqual(java.lang.Double)>/@this	<simplejavacalculator.Calculator: java.lang.Double calculateEqual(java.lang.Double)>
<simplejavacalculator.Calculator: java.lang.Double calculateEqual(java.lang.Double)>/@parameter0	<simplejavacalculator.Calculator: java.lang.Double calculateEqual(java.lang.Double)>
<simplejavacalculator.Calculator: java.lang.Double calculateEqual(java.lang.Double)>/this#_0	<simplejavacalculator.Calculator: java.lang.Double calculateEqual(java.lang.Double)>
<simplejavacalculator.Calculator: java.lang.Double calculateEqual(java.lang.Double)>/num#_0	<simplejavacalculator.Calculator: java.lang.Double calculateEqual(java.lang.Double)>
<simplejavacalculator.Calculator: java.lang.Double calculateEqual(java.lang.Double)>/$stack2	<simplejavacalculator.Calculator: java.lang.Double calculateEqual(java.lang.Double)>
<simplejavacalculator.Calculator: java.lang.Double calculateEqual(java.lang.Double)>/$stack3	<simplejavacalculator.Calculator: java.lang.Double calculateEqual(java.lang.Double)>
<simplejavacalculator.Calculator: java.lang.Double reset()>/@this	<simplejavacalculator.Calculator: java.lang.Double reset()>
<simplejavacalculator.Calculator: java.lang.Double reset()>/this#_0	<simplejavacalculator.Calculator: java.lang.Double reset()>
<simplejavacalculator.Calculator: java.lang.Double reset()>/$stack1	<simplejavacalculator.Calculator: java.lang.Double reset()>
<simplejavacalculator.Calculator: java.lang.Double reset()>/$stack2	<simplejavacalculator.Calculator: java.lang.Double reset()>
<simplejavacalculator.Calculator: java.lang.Double reset()>/$stack3	<simplejavacalculator.Calculator: java.lang.Double reset()>
<simplejavacalculator.Calculator: java.lang.Double reset()>/$stack4	<simplejavacalculator.Calculator: java.lang.Double reset()>
<simplejavacalculator.Calculator: java.lang.Double reset()>/$numconstant0	<simplejavacalculator.Calculator: java.lang.Double reset()>
<simplejavacalculator.Calculator: java.lang.Double reset()>/$numconstant1	<simplejavacalculator.Calculator: java.lang.Double reset()>
<simplejavacalculator.Calculator: java.lang.Double reset()>/$numconstant2	<simplejavacalculator.Calculator: java.lang.Double reset()>
<simplejavacalculator.Calculator: java.lang.Double calculateMono(simplejavacalculator.Calculator$MonoOperatorModes,java.lang.Double)>/@this	<simplejavacalculator.Calculator: java.lang.Double calculateMono(simplejavacalculator.Calculator$MonoOperatorModes,java.lang.Double)>
<simplejavacalculator.Calculator: java.lang.Double calculateMono(simplejavacalculator.Calculator$MonoOperatorModes,java.lang.Double)>/@parameter0	<simplejavacalculator.Calculator: java.lang.Double calculateMono(simplejavacalculator.Calculator$MonoOperatorModes,java.lang.Double)>
<simplejavacalculator.Calculator: java.lang.Double calculateMono(simplejavacalculator.Calculator$MonoOperatorModes,java.lang.Double)>/@parameter1	<simplejavacalculator.Calculator: java.lang.Double calculateMono(simplejavacalculator.Calculator$MonoOperatorModes,java.lang.Double)>
<simplejavacalculator.Calculator: java.lang.Double calculateMono(simplejavacalculator.Calculator$MonoOperatorModes,java.lang.Double)>/newMode#_0	<simplejavacalculator.Calculator: java.lang.Double calculateMono(simplejavacalculator.Calculator$MonoOperatorModes,java.lang.Double)>
<simplejavacalculator.Calculator: java.lang.Double calculateMono(simplejavacalculator.Calculator$MonoOperatorModes,java.lang.Double)>/$stack3	<simplejavacalculator.Calculator: java.lang.Double calculateMono(simplejavacalculator.Calculator$MonoOperatorModes,java.lang.Double)>
<simplejavacalculator.Calculator: java.lang.Double calculateMono(simplejavacalculator.Calculator$MonoOperatorModes,java.lang.Double)>/$stack4	<simplejavacalculator.Calculator: java.lang.Double calculateMono(simplejavacalculator.Calculator$MonoOperatorModes,java.lang.Double)>
<simplejavacalculator.Calculator: java.lang.Double calculateMono(simplejavacalculator.Calculator$MonoOperatorModes,java.lang.Double)>/$stack5	<simplejavacalculator.Calculator: java.lang.Double calculateMono(simplejavacalculator.Calculator$MonoOperatorModes,java.lang.Double)>
<simplejavacalculator.Calculator: java.lang.Double calculateMono(simplejavacalculator.Calculator$MonoOperatorModes,java.lang.Double)>/$stack6	<simplejavacalculator.Calculator: java.lang.Double calculateMono(simplejavacalculator.Calculator$MonoOperatorModes,java.lang.Double)>
<simplejavacalculator.Calculator: java.lang.Double calculateMono(simplejavacalculator.Calculator$MonoOperatorModes,java.lang.Double)>/$stack7	<simplejavacalculator.Calculator: java.lang.Double calculateMono(simplejavacalculator.Calculator$MonoOperatorModes,java.lang.Double)>
<simplejavacalculator.Calculator: java.lang.Double calculateMono(simplejavacalculator.Calculator$MonoOperatorModes,java.lang.Double)>/$stack8	<simplejavacalculator.Calculator: java.lang.Double calculateMono(simplejavacalculator.Calculator$MonoOperatorModes,java.lang.Double)>
<simplejavacalculator.Calculator: java.lang.Double calculateMono(simplejavacalculator.Calculator$MonoOperatorModes,java.lang.Double)>/$stack9	<simplejavacalculator.Calculator: java.lang.Double calculateMono(simplejavacalculator.Calculator$MonoOperatorModes,java.lang.Double)>
<simplejavacalculator.Calculator: java.lang.Double calculateMono(simplejavacalculator.Calculator$MonoOperatorModes,java.lang.Double)>/$stack10	<simplejavacalculator.Calculator: java.lang.Double calculateMono(simplejavacalculator.Calculator$MonoOperatorModes,java.lang.Double)>
<simplejavacalculator.Calculator: java.lang.Double calculateMono(simplejavacalculator.Calculator$MonoOperatorModes,java.lang.Double)>/$stack11	<simplejavacalculator.Calculator: java.lang.Double calculateMono(simplejavacalculator.Calculator$MonoOperatorModes,java.lang.Double)>
<simplejavacalculator.Calculator: java.lang.Double calculateMono(simplejavacalculator.Calculator$MonoOperatorModes,java.lang.Double)>/$stack12	<simplejavacalculator.Calculator: java.lang.Double calculateMono(simplejavacalculator.Calculator$MonoOperatorModes,java.lang.Double)>
<simplejavacalculator.Calculator: java.lang.Double calculateMono(simplejavacalculator.Calculator$MonoOperatorModes,java.lang.Double)>/num#_0	<simplejavacalculator.Calculator: java.lang.Double calculateMono(simplejavacalculator.Calculator$MonoOperatorModes,java.lang.Double)>
<simplejavacalculator.Calculator: java.lang.Double calculateMono(simplejavacalculator.Calculator$MonoOperatorModes,java.lang.Double)>/$stack13	<simplejavacalculator.Calculator: java.lang.Double calculateMono(simplejavacalculator.Calculator$MonoOperatorModes,java.lang.Double)>
<simplejavacalculator.Calculator: java.lang.Double calculateMono(simplejavacalculator.Calculator$MonoOperatorModes,java.lang.Double)>/$stack14	<simplejavacalculator.Calculator: java.lang.Double calculateMono(simplejavacalculator.Calculator$MonoOperatorModes,java.lang.Double)>
<simplejavacalculator.Calculator: java.lang.Double calculateMono(simplejavacalculator.Calculator$MonoOperatorModes,java.lang.Double)>/$stack15	<simplejavacalculator.Calculator: java.lang.Double calculateMono(simplejavacalculator.Calculator$MonoOperatorModes,java.lang.Double)>
<simplejavacalculator.Calculator: java.lang.Double calculateMono(simplejavacalculator.Calculator$MonoOperatorModes,java.lang.Double)>/$stack16	<simplejavacalculator.Calculator: java.lang.Double calculateMono(simplejavacalculator.Calculator$MonoOperatorModes,java.lang.Double)>
<simplejavacalculator.Calculator: java.lang.Double calculateMono(simplejavacalculator.Calculator$MonoOperatorModes,java.lang.Double)>/$stack17	<simplejavacalculator.Calculator: java.lang.Double calculateMono(simplejavacalculator.Calculator$MonoOperatorModes,java.lang.Double)>
<simplejavacalculator.Calculator: java.lang.Double calculateMono(simplejavacalculator.Calculator$MonoOperatorModes,java.lang.Double)>/$stack18	<simplejavacalculator.Calculator: java.lang.Double calculateMono(simplejavacalculator.Calculator$MonoOperatorModes,java.lang.Double)>
<simplejavacalculator.Calculator: java.lang.Double calculateMono(simplejavacalculator.Calculator$MonoOperatorModes,java.lang.Double)>/$stack19	<simplejavacalculator.Calculator: java.lang.Double calculateMono(simplejavacalculator.Calculator$MonoOperatorModes,java.lang.Double)>
<simplejavacalculator.Calculator: java.lang.Double calculateMono(simplejavacalculator.Calculator$MonoOperatorModes,java.lang.Double)>/$stack20	<simplejavacalculator.Calculator: java.lang.Double calculateMono(simplejavacalculator.Calculator$MonoOperatorModes,java.lang.Double)>
<simplejavacalculator.Calculator: java.lang.Double calculateMono(simplejavacalculator.Calculator$MonoOperatorModes,java.lang.Double)>/$stack21	<simplejavacalculator.Calculator: java.lang.Double calculateMono(simplejavacalculator.Calculator$MonoOperatorModes,java.lang.Double)>
<simplejavacalculator.Calculator: java.lang.Double calculateMono(simplejavacalculator.Calculator$MonoOperatorModes,java.lang.Double)>/$stack22	<simplejavacalculator.Calculator: java.lang.Double calculateMono(simplejavacalculator.Calculator$MonoOperatorModes,java.lang.Double)>
<simplejavacalculator.Calculator: java.lang.Double calculateMono(simplejavacalculator.Calculator$MonoOperatorModes,java.lang.Double)>/$stack23	<simplejavacalculator.Calculator: java.lang.Double calculateMono(simplejavacalculator.Calculator$MonoOperatorModes,java.lang.Double)>
<simplejavacalculator.Calculator: java.lang.Double calculateMono(simplejavacalculator.Calculator$MonoOperatorModes,java.lang.Double)>/$stack24	<simplejavacalculator.Calculator: java.lang.Double calculateMono(simplejavacalculator.Calculator$MonoOperatorModes,java.lang.Double)>
<simplejavacalculator.Calculator: java.lang.Double calculateMono(simplejavacalculator.Calculator$MonoOperatorModes,java.lang.Double)>/$stack25	<simplejavacalculator.Calculator: java.lang.Double calculateMono(simplejavacalculator.Calculator$MonoOperatorModes,java.lang.Double)>
<simplejavacalculator.Calculator: java.lang.Double calculateMono(simplejavacalculator.Calculator$MonoOperatorModes,java.lang.Double)>/$stack26	<simplejavacalculator.Calculator: java.lang.Double calculateMono(simplejavacalculator.Calculator$MonoOperatorModes,java.lang.Double)>
<simplejavacalculator.Calculator: java.lang.Double calculateMono(simplejavacalculator.Calculator$MonoOperatorModes,java.lang.Double)>/$stack27	<simplejavacalculator.Calculator: java.lang.Double calculateMono(simplejavacalculator.Calculator$MonoOperatorModes,java.lang.Double)>
<simplejavacalculator.Calculator: java.lang.Double calculateMono(simplejavacalculator.Calculator$MonoOperatorModes,java.lang.Double)>/$stack28	<simplejavacalculator.Calculator: java.lang.Double calculateMono(simplejavacalculator.Calculator$MonoOperatorModes,java.lang.Double)>
<simplejavacalculator.Calculator: java.lang.Double calculateMono(simplejavacalculator.Calculator$MonoOperatorModes,java.lang.Double)>/$stack29	<simplejavacalculator.Calculator: java.lang.Double calculateMono(simplejavacalculator.Calculator$MonoOperatorModes,java.lang.Double)>
<simplejavacalculator.Calculator: java.lang.Double calculateMono(simplejavacalculator.Calculator$MonoOperatorModes,java.lang.Double)>/$stack30	<simplejavacalculator.Calculator: java.lang.Double calculateMono(simplejavacalculator.Calculator$MonoOperatorModes,java.lang.Double)>
<simplejavacalculator.Calculator: java.lang.Double calculateMono(simplejavacalculator.Calculator$MonoOperatorModes,java.lang.Double)>/$stack31	<simplejavacalculator.Calculator: java.lang.Double calculateMono(simplejavacalculator.Calculator$MonoOperatorModes,java.lang.Double)>
<simplejavacalculator.Calculator: java.lang.Double calculateMono(simplejavacalculator.Calculator$MonoOperatorModes,java.lang.Double)>/$stack32	<simplejavacalculator.Calculator: java.lang.Double calculateMono(simplejavacalculator.Calculator$MonoOperatorModes,java.lang.Double)>
<simplejavacalculator.Calculator: java.lang.Double calculateMono(simplejavacalculator.Calculator$MonoOperatorModes,java.lang.Double)>/$stack33	<simplejavacalculator.Calculator: java.lang.Double calculateMono(simplejavacalculator.Calculator$MonoOperatorModes,java.lang.Double)>
<simplejavacalculator.Calculator: java.lang.Double calculateMono(simplejavacalculator.Calculator$MonoOperatorModes,java.lang.Double)>/$stack34	<simplejavacalculator.Calculator: java.lang.Double calculateMono(simplejavacalculator.Calculator$MonoOperatorModes,java.lang.Double)>
<simplejavacalculator.Calculator: java.lang.Double calculateMono(simplejavacalculator.Calculator$MonoOperatorModes,java.lang.Double)>/$stack35	<simplejavacalculator.Calculator: java.lang.Double calculateMono(simplejavacalculator.Calculator$MonoOperatorModes,java.lang.Double)>
<simplejavacalculator.Calculator: java.lang.Double calculateMono(simplejavacalculator.Calculator$MonoOperatorModes,java.lang.Double)>/$stack36	<simplejavacalculator.Calculator: java.lang.Double calculateMono(simplejavacalculator.Calculator$MonoOperatorModes,java.lang.Double)>
<simplejavacalculator.Calculator: java.lang.Double calculateMono(simplejavacalculator.Calculator$MonoOperatorModes,java.lang.Double)>/$stack37	<simplejavacalculator.Calculator: java.lang.Double calculateMono(simplejavacalculator.Calculator$MonoOperatorModes,java.lang.Double)>
<simplejavacalculator.Calculator: java.lang.Double calculateMono(simplejavacalculator.Calculator$MonoOperatorModes,java.lang.Double)>/$stack38	<simplejavacalculator.Calculator: java.lang.Double calculateMono(simplejavacalculator.Calculator$MonoOperatorModes,java.lang.Double)>
<simplejavacalculator.Calculator: java.lang.Double calculateMono(simplejavacalculator.Calculator$MonoOperatorModes,java.lang.Double)>/$stack39	<simplejavacalculator.Calculator: java.lang.Double calculateMono(simplejavacalculator.Calculator$MonoOperatorModes,java.lang.Double)>
<simplejavacalculator.Calculator: java.lang.Double calculateMono(simplejavacalculator.Calculator$MonoOperatorModes,java.lang.Double)>/$stack40	<simplejavacalculator.Calculator: java.lang.Double calculateMono(simplejavacalculator.Calculator$MonoOperatorModes,java.lang.Double)>
<simplejavacalculator.Calculator: java.lang.Double calculateMono(simplejavacalculator.Calculator$MonoOperatorModes,java.lang.Double)>/$stack41	<simplejavacalculator.Calculator: java.lang.Double calculateMono(simplejavacalculator.Calculator$MonoOperatorModes,java.lang.Double)>
<simplejavacalculator.Calculator: java.lang.Double calculateMono(simplejavacalculator.Calculator$MonoOperatorModes,java.lang.Double)>/$stack42	<simplejavacalculator.Calculator: java.lang.Double calculateMono(simplejavacalculator.Calculator$MonoOperatorModes,java.lang.Double)>
<simplejavacalculator.Calculator: java.lang.Double calculateMono(simplejavacalculator.Calculator$MonoOperatorModes,java.lang.Double)>/$stack43	<simplejavacalculator.Calculator: java.lang.Double calculateMono(simplejavacalculator.Calculator$MonoOperatorModes,java.lang.Double)>
<simplejavacalculator.Calculator: java.lang.Double calculateMono(simplejavacalculator.Calculator$MonoOperatorModes,java.lang.Double)>/$stack44	<simplejavacalculator.Calculator: java.lang.Double calculateMono(simplejavacalculator.Calculator$MonoOperatorModes,java.lang.Double)>
<simplejavacalculator.Calculator: java.lang.Double calculateMono(simplejavacalculator.Calculator$MonoOperatorModes,java.lang.Double)>/$stack45	<simplejavacalculator.Calculator: java.lang.Double calculateMono(simplejavacalculator.Calculator$MonoOperatorModes,java.lang.Double)>
<simplejavacalculator.Calculator: java.lang.Double calculateMono(simplejavacalculator.Calculator$MonoOperatorModes,java.lang.Double)>/$stack46	<simplejavacalculator.Calculator: java.lang.Double calculateMono(simplejavacalculator.Calculator$MonoOperatorModes,java.lang.Double)>
<simplejavacalculator.Calculator: java.lang.Double calculateMono(simplejavacalculator.Calculator$MonoOperatorModes,java.lang.Double)>/$stack47	<simplejavacalculator.Calculator: java.lang.Double calculateMono(simplejavacalculator.Calculator$MonoOperatorModes,java.lang.Double)>
<simplejavacalculator.Calculator: java.lang.Double calculateMono(simplejavacalculator.Calculator$MonoOperatorModes,java.lang.Double)>/$stack48	<simplejavacalculator.Calculator: java.lang.Double calculateMono(simplejavacalculator.Calculator$MonoOperatorModes,java.lang.Double)>
<simplejavacalculator.Calculator: java.lang.Double calculateMono(simplejavacalculator.Calculator$MonoOperatorModes,java.lang.Double)>/$stack49	<simplejavacalculator.Calculator: java.lang.Double calculateMono(simplejavacalculator.Calculator$MonoOperatorModes,java.lang.Double)>
<simplejavacalculator.Calculator: java.lang.Double calculateMono(simplejavacalculator.Calculator$MonoOperatorModes,java.lang.Double)>/$stack50	<simplejavacalculator.Calculator: java.lang.Double calculateMono(simplejavacalculator.Calculator$MonoOperatorModes,java.lang.Double)>
<simplejavacalculator.Calculator: java.lang.Double calculateMono(simplejavacalculator.Calculator$MonoOperatorModes,java.lang.Double)>/$stack51	<simplejavacalculator.Calculator: java.lang.Double calculateMono(simplejavacalculator.Calculator$MonoOperatorModes,java.lang.Double)>
<simplejavacalculator.Calculator: java.lang.Double calculateMono(simplejavacalculator.Calculator$MonoOperatorModes,java.lang.Double)>/$stack52	<simplejavacalculator.Calculator: java.lang.Double calculateMono(simplejavacalculator.Calculator$MonoOperatorModes,java.lang.Double)>
<simplejavacalculator.Calculator: java.lang.Double calculateMono(simplejavacalculator.Calculator$MonoOperatorModes,java.lang.Double)>/$stack53	<simplejavacalculator.Calculator: java.lang.Double calculateMono(simplejavacalculator.Calculator$MonoOperatorModes,java.lang.Double)>
<simplejavacalculator.Calculator: java.lang.Double calculateMono(simplejavacalculator.Calculator$MonoOperatorModes,java.lang.Double)>/$stack54	<simplejavacalculator.Calculator: java.lang.Double calculateMono(simplejavacalculator.Calculator$MonoOperatorModes,java.lang.Double)>
<simplejavacalculator.Calculator: java.lang.Double calculateMono(simplejavacalculator.Calculator$MonoOperatorModes,java.lang.Double)>/$stack55	<simplejavacalculator.Calculator: java.lang.Double calculateMono(simplejavacalculator.Calculator$MonoOperatorModes,java.lang.Double)>
<simplejavacalculator.Calculator: java.lang.Double calculateMono(simplejavacalculator.Calculator$MonoOperatorModes,java.lang.Double)>/$stack56	<simplejavacalculator.Calculator: java.lang.Double calculateMono(simplejavacalculator.Calculator$MonoOperatorModes,java.lang.Double)>
<simplejavacalculator.Calculator: java.lang.Double calculateMono(simplejavacalculator.Calculator$MonoOperatorModes,java.lang.Double)>/this#_0	<simplejavacalculator.Calculator: java.lang.Double calculateMono(simplejavacalculator.Calculator$MonoOperatorModes,java.lang.Double)>
<simplejavacalculator.Calculator: java.lang.Double calculateMono(simplejavacalculator.Calculator$MonoOperatorModes,java.lang.Double)>/$numconstant0	<simplejavacalculator.Calculator: java.lang.Double calculateMono(simplejavacalculator.Calculator$MonoOperatorModes,java.lang.Double)>
<simplejavacalculator.Calculator$MonoOperatorModes: simplejavacalculator.Calculator$MonoOperatorModes[] values()>/$stack0	<simplejavacalculator.Calculator$MonoOperatorModes: simplejavacalculator.Calculator$MonoOperatorModes[] values()>
<simplejavacalculator.Calculator$MonoOperatorModes: simplejavacalculator.Calculator$MonoOperatorModes[] values()>/$stack1	<simplejavacalculator.Calculator$MonoOperatorModes: simplejavacalculator.Calculator$MonoOperatorModes[] values()>
<simplejavacalculator.Calculator$MonoOperatorModes: simplejavacalculator.Calculator$MonoOperatorModes[] values()>/$stack2	<simplejavacalculator.Calculator$MonoOperatorModes: simplejavacalculator.Calculator$MonoOperatorModes[] values()>
<simplejavacalculator.Calculator$MonoOperatorModes: simplejavacalculator.Calculator$MonoOperatorModes valueOf(java.lang.String)>/@parameter0	<simplejavacalculator.Calculator$MonoOperatorModes: simplejavacalculator.Calculator$MonoOperatorModes valueOf(java.lang.String)>
<simplejavacalculator.Calculator$MonoOperatorModes: simplejavacalculator.Calculator$MonoOperatorModes valueOf(java.lang.String)>/name#_0	<simplejavacalculator.Calculator$MonoOperatorModes: simplejavacalculator.Calculator$MonoOperatorModes valueOf(java.lang.String)>
<simplejavacalculator.Calculator$MonoOperatorModes: simplejavacalculator.Calculator$MonoOperatorModes valueOf(java.lang.String)>/$stack1	<simplejavacalculator.Calculator$MonoOperatorModes: simplejavacalculator.Calculator$MonoOperatorModes valueOf(java.lang.String)>
<simplejavacalculator.Calculator$MonoOperatorModes: simplejavacalculator.Calculator$MonoOperatorModes valueOf(java.lang.String)>/$stack2	<simplejavacalculator.Calculator$MonoOperatorModes: simplejavacalculator.Calculator$MonoOperatorModes valueOf(java.lang.String)>
<simplejavacalculator.Calculator$MonoOperatorModes: simplejavacalculator.Calculator$MonoOperatorModes valueOf(java.lang.String)>/$classconstant0	<simplejavacalculator.Calculator$MonoOperatorModes: simplejavacalculator.Calculator$MonoOperatorModes valueOf(java.lang.String)>
<simplejavacalculator.Calculator$MonoOperatorModes: void <init>(java.lang.String,int)>/@this	<simplejavacalculator.Calculator$MonoOperatorModes: void <init>(java.lang.String,int)>
<simplejavacalculator.Calculator$MonoOperatorModes: void <init>(java.lang.String,int)>/@parameter0	<simplejavacalculator.Calculator$MonoOperatorModes: void <init>(java.lang.String,int)>
<simplejavacalculator.Calculator$MonoOperatorModes: void <init>(java.lang.String,int)>/@parameter1	<simplejavacalculator.Calculator$MonoOperatorModes: void <init>(java.lang.String,int)>
<simplejavacalculator.Calculator$MonoOperatorModes: void <init>(java.lang.String,int)>/this#_0	<simplejavacalculator.Calculator$MonoOperatorModes: void <init>(java.lang.String,int)>
<simplejavacalculator.Calculator$MonoOperatorModes: void <init>(java.lang.String,int)>/l1#_0	<simplejavacalculator.Calculator$MonoOperatorModes: void <init>(java.lang.String,int)>
<simplejavacalculator.Calculator$MonoOperatorModes: void <init>(java.lang.String,int)>/l2#_0	<simplejavacalculator.Calculator$MonoOperatorModes: void <init>(java.lang.String,int)>
<simplejavacalculator.Calculator$MonoOperatorModes: void <clinit>()>/$stack0	<simplejavacalculator.Calculator$MonoOperatorModes: void <clinit>()>
<simplejavacalculator.Calculator$MonoOperatorModes: void <clinit>()>/$stack1	<simplejavacalculator.Calculator$MonoOperatorModes: void <clinit>()>
<simplejavacalculator.Calculator$MonoOperatorModes: void <clinit>()>/$stack2	<simplejavacalculator.Calculator$MonoOperatorModes: void <clinit>()>
<simplejavacalculator.Calculator$MonoOperatorModes: void <clinit>()>/$stack3	<simplejavacalculator.Calculator$MonoOperatorModes: void <clinit>()>
<simplejavacalculator.Calculator$MonoOperatorModes: void <clinit>()>/$stack4	<simplejavacalculator.Calculator$MonoOperatorModes: void <clinit>()>
<simplejavacalculator.Calculator$MonoOperatorModes: void <clinit>()>/$stack5	<simplejavacalculator.Calculator$MonoOperatorModes: void <clinit>()>
<simplejavacalculator.Calculator$MonoOperatorModes: void <clinit>()>/$stack6	<simplejavacalculator.Calculator$MonoOperatorModes: void <clinit>()>
<simplejavacalculator.Calculator$MonoOperatorModes: void <clinit>()>/$stack7	<simplejavacalculator.Calculator$MonoOperatorModes: void <clinit>()>
<simplejavacalculator.Calculator$MonoOperatorModes: void <clinit>()>/$stack8	<simplejavacalculator.Calculator$MonoOperatorModes: void <clinit>()>
<simplejavacalculator.Calculator$MonoOperatorModes: void <clinit>()>/$stack9	<simplejavacalculator.Calculator$MonoOperatorModes: void <clinit>()>
<simplejavacalculator.Calculator$MonoOperatorModes: void <clinit>()>/$stack10	<simplejavacalculator.Calculator$MonoOperatorModes: void <clinit>()>
<simplejavacalculator.Calculator$MonoOperatorModes: void <clinit>()>/$stack11	<simplejavacalculator.Calculator$MonoOperatorModes: void <clinit>()>
<simplejavacalculator.Calculator$MonoOperatorModes: void <clinit>()>/$stack12	<simplejavacalculator.Calculator$MonoOperatorModes: void <clinit>()>
<simplejavacalculator.Calculator$MonoOperatorModes: void <clinit>()>/$stack13	<simplejavacalculator.Calculator$MonoOperatorModes: void <clinit>()>
<simplejavacalculator.Calculator$MonoOperatorModes: void <clinit>()>/$stack14	<simplejavacalculator.Calculator$MonoOperatorModes: void <clinit>()>
<simplejavacalculator.Calculator$MonoOperatorModes: void <clinit>()>/$stack15	<simplejavacalculator.Calculator$MonoOperatorModes: void <clinit>()>
<simplejavacalculator.Calculator$MonoOperatorModes: void <clinit>()>/$stack16	<simplejavacalculator.Calculator$MonoOperatorModes: void <clinit>()>
<simplejavacalculator.Calculator$MonoOperatorModes: void <clinit>()>/$stack17	<simplejavacalculator.Calculator$MonoOperatorModes: void <clinit>()>
<simplejavacalculator.Calculator$MonoOperatorModes: void <clinit>()>/$stack18	<simplejavacalculator.Calculator$MonoOperatorModes: void <clinit>()>
<simplejavacalculator.Calculator$MonoOperatorModes: void <clinit>()>/$stringconstant0	<simplejavacalculator.Calculator$MonoOperatorModes: void <clinit>()>
<simplejavacalculator.Calculator$MonoOperatorModes: void <clinit>()>/$numconstant0	<simplejavacalculator.Calculator$MonoOperatorModes: void <clinit>()>
<simplejavacalculator.Calculator$MonoOperatorModes: void <clinit>()>/$stringconstant1	<simplejavacalculator.Calculator$MonoOperatorModes: void <clinit>()>
<simplejavacalculator.Calculator$MonoOperatorModes: void <clinit>()>/$numconstant1	<simplejavacalculator.Calculator$MonoOperatorModes: void <clinit>()>
<simplejavacalculator.Calculator$MonoOperatorModes: void <clinit>()>/$stringconstant2	<simplejavacalculator.Calculator$MonoOperatorModes: void <clinit>()>
<simplejavacalculator.Calculator$MonoOperatorModes: void <clinit>()>/$numconstant2	<simplejavacalculator.Calculator$MonoOperatorModes: void <clinit>()>
<simplejavacalculator.Calculator$MonoOperatorModes: void <clinit>()>/$stringconstant3	<simplejavacalculator.Calculator$MonoOperatorModes: void <clinit>()>
<simplejavacalculator.Calculator$MonoOperatorModes: void <clinit>()>/$numconstant3	<simplejavacalculator.Calculator$MonoOperatorModes: void <clinit>()>
<simplejavacalculator.Calculator$MonoOperatorModes: void <clinit>()>/$stringconstant4	<simplejavacalculator.Calculator$MonoOperatorModes: void <clinit>()>
<simplejavacalculator.Calculator$MonoOperatorModes: void <clinit>()>/$numconstant4	<simplejavacalculator.Calculator$MonoOperatorModes: void <clinit>()>
<simplejavacalculator.Calculator$MonoOperatorModes: void <clinit>()>/$stringconstant5	<simplejavacalculator.Calculator$MonoOperatorModes: void <clinit>()>
<simplejavacalculator.Calculator$MonoOperatorModes: void <clinit>()>/$numconstant5	<simplejavacalculator.Calculator$MonoOperatorModes: void <clinit>()>
<simplejavacalculator.Calculator$MonoOperatorModes: void <clinit>()>/$stringconstant6	<simplejavacalculator.Calculator$MonoOperatorModes: void <clinit>()>
<simplejavacalculator.Calculator$MonoOperatorModes: void <clinit>()>/$numconstant6	<simplejavacalculator.Calculator$MonoOperatorModes: void <clinit>()>
<simplejavacalculator.Calculator$MonoOperatorModes: void <clinit>()>/$stringconstant7	<simplejavacalculator.Calculator$MonoOperatorModes: void <clinit>()>
<simplejavacalculator.Calculator$MonoOperatorModes: void <clinit>()>/$numconstant7	<simplejavacalculator.Calculator$MonoOperatorModes: void <clinit>()>
<simplejavacalculator.Calculator$MonoOperatorModes: void <clinit>()>/$stringconstant8	<simplejavacalculator.Calculator$MonoOperatorModes: void <clinit>()>
<simplejavacalculator.Calculator$MonoOperatorModes: void <clinit>()>/$numconstant8	<simplejavacalculator.Calculator$MonoOperatorModes: void <clinit>()>
<simplejavacalculator.SimpleJavaCalculator: void <init>()>/@this	<simplejavacalculator.SimpleJavaCalculator: void <init>()>
<simplejavacalculator.SimpleJavaCalculator: void <init>()>/this#_0	<simplejavacalculator.SimpleJavaCalculator: void <init>()>
<simplejavacalculator.SimpleJavaCalculator: void main(java.lang.String[])>/@parameter0	<simplejavacalculator.SimpleJavaCalculator: void main(java.lang.String[])>
<simplejavacalculator.SimpleJavaCalculator: void main(java.lang.String[])>/$stack2	<simplejavacalculator.SimpleJavaCalculator: void main(java.lang.String[])>
<simplejavacalculator.SimpleJavaCalculator: void main(java.lang.String[])>/uiCal#_22	<simplejavacalculator.SimpleJavaCalculator: void main(java.lang.String[])>
<simplejavacalculator.SimpleJavaCalculator: void main(java.lang.String[])>/args#_0	<simplejavacalculator.SimpleJavaCalculator: void main(java.lang.String[])>
<simplejavacalculator.UI: void <init>()>/@this	<simplejavacalculator.UI: void <init>()>
<simplejavacalculator.UI: void <init>()>/this#_0	<simplejavacalculator.UI: void <init>()>
<simplejavacalculator.UI: void <init>()>/$stack2	<simplejavacalculator.UI: void <init>()>
<simplejavacalculator.UI: void <init>()>/$stack3	<simplejavacalculator.UI: void <init>()>
<simplejavacalculator.UI: void <init>()>/$stack4	<simplejavacalculator.UI: void <init>()>
<simplejavacalculator.UI: void <init>()>/$stack5	<simplejavacalculator.UI: void <init>()>
<simplejavacalculator.UI: void <init>()>/$stack6	<simplejavacalculator.UI: void <init>()>
<simplejavacalculator.UI: void <init>()>/$stack7	<simplejavacalculator.UI: void <init>()>
<simplejavacalculator.UI: void <init>()>/$stack8	<simplejavacalculator.UI: void <init>()>
<simplejavacalculator.UI: void <init>()>/$stack9	<simplejavacalculator.UI: void <init>()>
<simplejavacalculator.UI: void <init>()>/$stack10	<simplejavacalculator.UI: void <init>()>
<simplejavacalculator.UI: void <init>()>/$stack11	<simplejavacalculator.UI: void <init>()>
<simplejavacalculator.UI: void <init>()>/$stack12	<simplejavacalculator.UI: void <init>()>
<simplejavacalculator.UI: void <init>()>/$stack13	<simplejavacalculator.UI: void <init>()>
<simplejavacalculator.UI: void <init>()>/$stack14	<simplejavacalculator.UI: void <init>()>
<simplejavacalculator.UI: void <init>()>/$stack15	<simplejavacalculator.UI: void <init>()>
<simplejavacalculator.UI: void <init>()>/$stack16	<simplejavacalculator.UI: void <init>()>
<simplejavacalculator.UI: void <init>()>/$stack17	<simplejavacalculator.UI: void <init>()>
<simplejavacalculator.UI: void <init>()>/$stack18	<simplejavacalculator.UI: void <init>()>
<simplejavacalculator.UI: void <init>()>/$stack19	<simplejavacalculator.UI: void <init>()>
<simplejavacalculator.UI: void <init>()>/$stack20	<simplejavacalculator.UI: void <init>()>
<simplejavacalculator.UI: void <init>()>/$stack21	<simplejavacalculator.UI: void <init>()>
<simplejavacalculator.UI: void <init>()>/$stack22	<simplejavacalculator.UI: void <init>()>
<simplejavacalculator.UI: void <init>()>/$stack23	<simplejavacalculator.UI: void <init>()>
<simplejavacalculator.UI: void <init>()>/$stack24	<simplejavacalculator.UI: void <init>()>
<simplejavacalculator.UI: void <init>()>/$stack25	<simplejavacalculator.UI: void <init>()>
<simplejavacalculator.UI: void <init>()>/$stack26	<simplejavacalculator.UI: void <init>()>
<simplejavacalculator.UI: void <init>()>/$stack27	<simplejavacalculator.UI: void <init>()>
<simplejavacalculator.UI: void <init>()>/$stack28	<simplejavacalculator.UI: void <init>()>
<simplejavacalculator.UI: void <init>()>/i	<simplejavacalculator.UI: void <init>()>
<simplejavacalculator.UI: void <init>()>/$stack29	<simplejavacalculator.UI: void <init>()>
<simplejavacalculator.UI: void <init>()>/$stack30	<simplejavacalculator.UI: void <init>()>
<simplejavacalculator.UI: void <init>()>/$stack31	<simplejavacalculator.UI: void <init>()>
<simplejavacalculator.UI: void <init>()>/$stack32	<simplejavacalculator.UI: void <init>()>
<simplejavacalculator.UI: void <init>()>/$stack33	<simplejavacalculator.UI: void <init>()>
<simplejavacalculator.UI: void <init>()>/$stack34	<simplejavacalculator.UI: void <init>()>
<simplejavacalculator.UI: void <init>()>/$stack35	<simplejavacalculator.UI: void <init>()>
<simplejavacalculator.UI: void <init>()>/$stack36	<simplejavacalculator.UI: void <init>()>
<simplejavacalculator.UI: void <init>()>/$stack37	<simplejavacalculator.UI: void <init>()>
<simplejavacalculator.UI: void <init>()>/$stack38	<simplejavacalculator.UI: void <init>()>
<simplejavacalculator.UI: void <init>()>/$stack39	<simplejavacalculator.UI: void <init>()>
<simplejavacalculator.UI: void <init>()>/$stack40	<simplejavacalculator.UI: void <init>()>
<simplejavacalculator.UI: void <init>()>/$stack41	<simplejavacalculator.UI: void <init>()>
<simplejavacalculator.UI: void <init>()>/$stack42	<simplejavacalculator.UI: void <init>()>
<simplejavacalculator.UI: void <init>()>/$stack43	<simplejavacalculator.UI: void <init>()>
<simplejavacalculator.UI: void <init>()>/$stack44	<simplejavacalculator.UI: void <init>()>
<simplejavacalculator.UI: void <init>()>/$stack45	<simplejavacalculator.UI: void <init>()>
<simplejavacalculator.UI: void <init>()>/$stack46	<simplejavacalculator.UI: void <init>()>
<simplejavacalculator.UI: void <init>()>/$stack47	<simplejavacalculator.UI: void <init>()>
<simplejavacalculator.UI: void <init>()>/$stack48	<simplejavacalculator.UI: void <init>()>
<simplejavacalculator.UI: void <init>()>/$stack49	<simplejavacalculator.UI: void <init>()>
<simplejavacalculator.UI: void <init>()>/$stack50	<simplejavacalculator.UI: void <init>()>
<simplejavacalculator.UI: void <init>()>/$stack51	<simplejavacalculator.UI: void <init>()>
<simplejavacalculator.UI: void <init>()>/i_$$A_1#_86	<simplejavacalculator.UI: void <init>()>
<simplejavacalculator.UI: void <init>()>/i_$$A_1_$$A_1#_87	<simplejavacalculator.UI: void <init>()>
<simplejavacalculator.UI: void <init>()>/i_$$A_1_$$A_2#_86	<simplejavacalculator.UI: void <init>()>
<simplejavacalculator.UI: void <init>()>/$stringconstant0	<simplejavacalculator.UI: void <init>()>
<simplejavacalculator.UI: void <init>()>/$stringconstant1	<simplejavacalculator.UI: void <init>()>
<simplejavacalculator.UI: void <init>()>/$stringconstant2	<simplejavacalculator.UI: void <init>()>
<simplejavacalculator.UI: void <init>()>/$stringconstant3	<simplejavacalculator.UI: void <init>()>
<simplejavacalculator.UI: void <init>()>/$stringconstant4	<simplejavacalculator.UI: void <init>()>
<simplejavacalculator.UI: void <init>()>/$stringconstant5	<simplejavacalculator.UI: void <init>()>
<simplejavacalculator.UI: void <init>()>/$stringconstant6	<simplejavacalculator.UI: void <init>()>
<simplejavacalculator.UI: void <init>()>/$stringconstant7	<simplejavacalculator.UI: void <init>()>
<simplejavacalculator.UI: void <init>()>/$stringconstant8	<simplejavacalculator.UI: void <init>()>
<simplejavacalculator.UI: void <init>()>/$stringconstant9	<simplejavacalculator.UI: void <init>()>
<simplejavacalculator.UI: void <init>()>/$stringconstant10	<simplejavacalculator.UI: void <init>()>
<simplejavacalculator.UI: void <init>()>/$stringconstant11	<simplejavacalculator.UI: void <init>()>
<simplejavacalculator.UI: void <init>()>/$numconstant0	<simplejavacalculator.UI: void <init>()>
<simplejavacalculator.UI: void <init>()>/$stringconstant12	<simplejavacalculator.UI: void <init>()>
<simplejavacalculator.UI: void <init>()>/$numconstant1	<simplejavacalculator.UI: void <init>()>
<simplejavacalculator.UI: void <init>()>/$numconstant2	<simplejavacalculator.UI: void <init>()>
<simplejavacalculator.UI: void <init>()>/$numconstant3	<simplejavacalculator.UI: void <init>()>
<simplejavacalculator.UI: void <init>()>/$numconstant4	<simplejavacalculator.UI: void <init>()>
<simplejavacalculator.UI: void <init>()>/$stringconstant13	<simplejavacalculator.UI: void <init>()>
<simplejavacalculator.UI: void <init>()>/$numconstant5	<simplejavacalculator.UI: void <init>()>
<simplejavacalculator.UI: void <init>()>/$numconstant6	<simplejavacalculator.UI: void <init>()>
<simplejavacalculator.UI: void <init>()>/$stringconstant14	<simplejavacalculator.UI: void <init>()>
<simplejavacalculator.UI: void <init>()>/$stringconstant15	<simplejavacalculator.UI: void <init>()>
<simplejavacalculator.UI: void <init>()>/$stringconstant16	<simplejavacalculator.UI: void <init>()>
<simplejavacalculator.UI: void <init>()>/$stringconstant17	<simplejavacalculator.UI: void <init>()>
<simplejavacalculator.UI: void <init>()>/$stringconstant18	<simplejavacalculator.UI: void <init>()>
<simplejavacalculator.UI: void <init>()>/$stringconstant19	<simplejavacalculator.UI: void <init>()>
<simplejavacalculator.UI: void <init>()>/$stringconstant20	<simplejavacalculator.UI: void <init>()>
<simplejavacalculator.UI: void <init>()>/$stringconstant21	<simplejavacalculator.UI: void <init>()>
<simplejavacalculator.UI: void <init>()>/$stringconstant22	<simplejavacalculator.UI: void <init>()>
<simplejavacalculator.UI: void <init>()>/$stringconstant23	<simplejavacalculator.UI: void <init>()>
<simplejavacalculator.UI: void <init>()>/$stringconstant24	<simplejavacalculator.UI: void <init>()>
<simplejavacalculator.UI: void <init>()>/$stringconstant25	<simplejavacalculator.UI: void <init>()>
<simplejavacalculator.UI: void <init>()>/$stringconstant26	<simplejavacalculator.UI: void <init>()>
<simplejavacalculator.UI: void <init>()>/$stringconstant27	<simplejavacalculator.UI: void <init>()>
<simplejavacalculator.UI: void <init>()>/$stringconstant28	<simplejavacalculator.UI: void <init>()>
<simplejavacalculator.UI: void <init>()>/$stringconstant29	<simplejavacalculator.UI: void <init>()>
<simplejavacalculator.UI: void <init>()>/$stringconstant30	<simplejavacalculator.UI: void <init>()>
<simplejavacalculator.UI: void init()>/@this	<simplejavacalculator.UI: void init()>
<simplejavacalculator.UI: void init()>/this#_0	<simplejavacalculator.UI: void init()>
<simplejavacalculator.UI: void init()>/$stack2	<simplejavacalculator.UI: void init()>
<simplejavacalculator.UI: void init()>/$stack3	<simplejavacalculator.UI: void init()>
<simplejavacalculator.UI: void init()>/$stack4	<simplejavacalculator.UI: void init()>
<simplejavacalculator.UI: void init()>/$stack5	<simplejavacalculator.UI: void init()>
<simplejavacalculator.UI: void init()>/$stack6	<simplejavacalculator.UI: void init()>
<simplejavacalculator.UI: void init()>/$stack7	<simplejavacalculator.UI: void init()>
<simplejavacalculator.UI: void init()>/$stack8	<simplejavacalculator.UI: void init()>
<simplejavacalculator.UI: void init()>/$stack9	<simplejavacalculator.UI: void init()>
<simplejavacalculator.UI: void init()>/$stack10	<simplejavacalculator.UI: void init()>
<simplejavacalculator.UI: void init()>/$stack11	<simplejavacalculator.UI: void init()>
<simplejavacalculator.UI: void init()>/$stack12	<simplejavacalculator.UI: void init()>
<simplejavacalculator.UI: void init()>/i	<simplejavacalculator.UI: void init()>
<simplejavacalculator.UI: void init()>/$stack13	<simplejavacalculator.UI: void init()>
<simplejavacalculator.UI: void init()>/$stack14	<simplejavacalculator.UI: void init()>
<simplejavacalculator.UI: void init()>/$stack15	<simplejavacalculator.UI: void init()>
<simplejavacalculator.UI: void init()>/$stack16	<simplejavacalculator.UI: void init()>
<simplejavacalculator.UI: void init()>/$stack17	<simplejavacalculator.UI: void init()>
<simplejavacalculator.UI: void init()>/$stack18	<simplejavacalculator.UI: void init()>
<simplejavacalculator.UI: void init()>/$stack19	<simplejavacalculator.UI: void init()>
<simplejavacalculator.UI: void init()>/$stack20	<simplejavacalculator.UI: void init()>
<simplejavacalculator.UI: void init()>/$stack21	<simplejavacalculator.UI: void init()>
<simplejavacalculator.UI: void init()>/$stack22	<simplejavacalculator.UI: void init()>
<simplejavacalculator.UI: void init()>/$stack23	<simplejavacalculator.UI: void init()>
<simplejavacalculator.UI: void init()>/$stack24	<simplejavacalculator.UI: void init()>
<simplejavacalculator.UI: void init()>/$stack25	<simplejavacalculator.UI: void init()>
<simplejavacalculator.UI: void init()>/$stack26	<simplejavacalculator.UI: void init()>
<simplejavacalculator.UI: void init()>/$stack27	<simplejavacalculator.UI: void init()>
<simplejavacalculator.UI: void init()>/$stack28	<simplejavacalculator.UI: void init()>
<simplejavacalculator.UI: void init()>/$stack29	<simplejavacalculator.UI: void init()>
<simplejavacalculator.UI: void init()>/$stack30	<simplejavacalculator.UI: void init()>
<simplejavacalculator.UI: void init()>/$stack31	<simplejavacalculator.UI: void init()>
<simplejavacalculator.UI: void init()>/$stack32	<simplejavacalculator.UI: void init()>
<simplejavacalculator.UI: void init()>/$stack33	<simplejavacalculator.UI: void init()>
<simplejavacalculator.UI: void init()>/$stack34	<simplejavacalculator.UI: void init()>
<simplejavacalculator.UI: void init()>/$stack35	<simplejavacalculator.UI: void init()>
<simplejavacalculator.UI: void init()>/$stack36	<simplejavacalculator.UI: void init()>
<simplejavacalculator.UI: void init()>/$stack37	<simplejavacalculator.UI: void init()>
<simplejavacalculator.UI: void init()>/$stack38	<simplejavacalculator.UI: void init()>
<simplejavacalculator.UI: void init()>/$stack39	<simplejavacalculator.UI: void init()>
<simplejavacalculator.UI: void init()>/$stack40	<simplejavacalculator.UI: void init()>
<simplejavacalculator.UI: void init()>/$stack41	<simplejavacalculator.UI: void init()>
<simplejavacalculator.UI: void init()>/$stack42	<simplejavacalculator.UI: void init()>
<simplejavacalculator.UI: void init()>/$stack43	<simplejavacalculator.UI: void init()>
<simplejavacalculator.UI: void init()>/$stack44	<simplejavacalculator.UI: void init()>
<simplejavacalculator.UI: void init()>/$stack45	<simplejavacalculator.UI: void init()>
<simplejavacalculator.UI: void init()>/$stack46	<simplejavacalculator.UI: void init()>
<simplejavacalculator.UI: void init()>/$stack47	<simplejavacalculator.UI: void init()>
<simplejavacalculator.UI: void init()>/$stack48	<simplejavacalculator.UI: void init()>
<simplejavacalculator.UI: void init()>/$stack49	<simplejavacalculator.UI: void init()>
<simplejavacalculator.UI: void init()>/$stack50	<simplejavacalculator.UI: void init()>
<simplejavacalculator.UI: void init()>/$stack51	<simplejavacalculator.UI: void init()>
<simplejavacalculator.UI: void init()>/$stack52	<simplejavacalculator.UI: void init()>
<simplejavacalculator.UI: void init()>/$stack53	<simplejavacalculator.UI: void init()>
<simplejavacalculator.UI: void init()>/$stack54	<simplejavacalculator.UI: void init()>
<simplejavacalculator.UI: void init()>/$stack55	<simplejavacalculator.UI: void init()>
<simplejavacalculator.UI: void init()>/$stack56	<simplejavacalculator.UI: void init()>
<simplejavacalculator.UI: void init()>/$stack57	<simplejavacalculator.UI: void init()>
<simplejavacalculator.UI: void init()>/$stack58	<simplejavacalculator.UI: void init()>
<simplejavacalculator.UI: void init()>/$stack59	<simplejavacalculator.UI: void init()>
<simplejavacalculator.UI: void init()>/$stack60	<simplejavacalculator.UI: void init()>
<simplejavacalculator.UI: void init()>/$stack61	<simplejavacalculator.UI: void init()>
<simplejavacalculator.UI: void init()>/$stack62	<simplejavacalculator.UI: void init()>
<simplejavacalculator.UI: void init()>/$stack63	<simplejavacalculator.UI: void init()>
<simplejavacalculator.UI: void init()>/$stack64	<simplejavacalculator.UI: void init()>
<simplejavacalculator.UI: void init()>/$stack65	<simplejavacalculator.UI: void init()>
<simplejavacalculator.UI: void init()>/$stack66	<simplejavacalculator.UI: void init()>
<simplejavacalculator.UI: void init()>/$stack67	<simplejavacalculator.UI: void init()>
<simplejavacalculator.UI: void init()>/$stack68	<simplejavacalculator.UI: void init()>
<simplejavacalculator.UI: void init()>/$stack69	<simplejavacalculator.UI: void init()>
<simplejavacalculator.UI: void init()>/$stack70	<simplejavacalculator.UI: void init()>
<simplejavacalculator.UI: void init()>/$stack71	<simplejavacalculator.UI: void init()>
<simplejavacalculator.UI: void init()>/$stack72	<simplejavacalculator.UI: void init()>
<simplejavacalculator.UI: void init()>/$stack73	<simplejavacalculator.UI: void init()>
<simplejavacalculator.UI: void init()>/$stack74	<simplejavacalculator.UI: void init()>
<simplejavacalculator.UI: void init()>/$stack75	<simplejavacalculator.UI: void init()>
<simplejavacalculator.UI: void init()>/$stack76	<simplejavacalculator.UI: void init()>
<simplejavacalculator.UI: void init()>/$stack77	<simplejavacalculator.UI: void init()>
<simplejavacalculator.UI: void init()>/$stack78	<simplejavacalculator.UI: void init()>
<simplejavacalculator.UI: void init()>/$stack79	<simplejavacalculator.UI: void init()>
<simplejavacalculator.UI: void init()>/$stack80	<simplejavacalculator.UI: void init()>
<simplejavacalculator.UI: void init()>/$stack81	<simplejavacalculator.UI: void init()>
<simplejavacalculator.UI: void init()>/$stack82	<simplejavacalculator.UI: void init()>
<simplejavacalculator.UI: void init()>/$stack83	<simplejavacalculator.UI: void init()>
<simplejavacalculator.UI: void init()>/$stack84	<simplejavacalculator.UI: void init()>
<simplejavacalculator.UI: void init()>/$stack85	<simplejavacalculator.UI: void init()>
<simplejavacalculator.UI: void init()>/$stack86	<simplejavacalculator.UI: void init()>
<simplejavacalculator.UI: void init()>/$stack87	<simplejavacalculator.UI: void init()>
<simplejavacalculator.UI: void init()>/$stack88	<simplejavacalculator.UI: void init()>
<simplejavacalculator.UI: void init()>/$stack89	<simplejavacalculator.UI: void init()>
<simplejavacalculator.UI: void init()>/$stack90	<simplejavacalculator.UI: void init()>
<simplejavacalculator.UI: void init()>/$stack91	<simplejavacalculator.UI: void init()>
<simplejavacalculator.UI: void init()>/$stack92	<simplejavacalculator.UI: void init()>
<simplejavacalculator.UI: void init()>/$stack93	<simplejavacalculator.UI: void init()>
<simplejavacalculator.UI: void init()>/$stack94	<simplejavacalculator.UI: void init()>
<simplejavacalculator.UI: void init()>/$stack95	<simplejavacalculator.UI: void init()>
<simplejavacalculator.UI: void init()>/$stack96	<simplejavacalculator.UI: void init()>
<simplejavacalculator.UI: void init()>/$stack97	<simplejavacalculator.UI: void init()>
<simplejavacalculator.UI: void init()>/$stack98	<simplejavacalculator.UI: void init()>
<simplejavacalculator.UI: void init()>/$stack99	<simplejavacalculator.UI: void init()>
<simplejavacalculator.UI: void init()>/$stack100	<simplejavacalculator.UI: void init()>
<simplejavacalculator.UI: void init()>/$stack101	<simplejavacalculator.UI: void init()>
<simplejavacalculator.UI: void init()>/$stack102	<simplejavacalculator.UI: void init()>
<simplejavacalculator.UI: void init()>/$stack103	<simplejavacalculator.UI: void init()>
<simplejavacalculator.UI: void init()>/$stack104	<simplejavacalculator.UI: void init()>
<simplejavacalculator.UI: void init()>/$stack105	<simplejavacalculator.UI: void init()>
<simplejavacalculator.UI: void init()>/$stack106	<simplejavacalculator.UI: void init()>
<simplejavacalculator.UI: void init()>/$stack107	<simplejavacalculator.UI: void init()>
<simplejavacalculator.UI: void init()>/$stack108	<simplejavacalculator.UI: void init()>
<simplejavacalculator.UI: void init()>/$stack109	<simplejavacalculator.UI: void init()>
<simplejavacalculator.UI: void init()>/$stack110	<simplejavacalculator.UI: void init()>
<simplejavacalculator.UI: void init()>/$stack111	<simplejavacalculator.UI: void init()>
<simplejavacalculator.UI: void init()>/$stack112	<simplejavacalculator.UI: void init()>
<simplejavacalculator.UI: void init()>/$stack113	<simplejavacalculator.UI: void init()>
<simplejavacalculator.UI: void init()>/$stack114	<simplejavacalculator.UI: void init()>
<simplejavacalculator.UI: void init()>/$stack115	<simplejavacalculator.UI: void init()>
<simplejavacalculator.UI: void init()>/$stack116	<simplejavacalculator.UI: void init()>
<simplejavacalculator.UI: void init()>/$stack117	<simplejavacalculator.UI: void init()>
<simplejavacalculator.UI: void init()>/$stack118	<simplejavacalculator.UI: void init()>
<simplejavacalculator.UI: void init()>/$stack119	<simplejavacalculator.UI: void init()>
<simplejavacalculator.UI: void init()>/$stack120	<simplejavacalculator.UI: void init()>
<simplejavacalculator.UI: void init()>/$stack121	<simplejavacalculator.UI: void init()>
<simplejavacalculator.UI: void init()>/$stack122	<simplejavacalculator.UI: void init()>
<simplejavacalculator.UI: void init()>/$stack123	<simplejavacalculator.UI: void init()>
<simplejavacalculator.UI: void init()>/$stack124	<simplejavacalculator.UI: void init()>
<simplejavacalculator.UI: void init()>/$stack125	<simplejavacalculator.UI: void init()>
<simplejavacalculator.UI: void init()>/$stack126	<simplejavacalculator.UI: void init()>
<simplejavacalculator.UI: void init()>/$stack127	<simplejavacalculator.UI: void init()>
<simplejavacalculator.UI: void init()>/$stack128	<simplejavacalculator.UI: void init()>
<simplejavacalculator.UI: void init()>/$stack129	<simplejavacalculator.UI: void init()>
<simplejavacalculator.UI: void init()>/$stack130	<simplejavacalculator.UI: void init()>
<simplejavacalculator.UI: void init()>/$stack131	<simplejavacalculator.UI: void init()>
<simplejavacalculator.UI: void init()>/$stack132	<simplejavacalculator.UI: void init()>
<simplejavacalculator.UI: void init()>/$stack133	<simplejavacalculator.UI: void init()>
<simplejavacalculator.UI: void init()>/$stack134	<simplejavacalculator.UI: void init()>
<simplejavacalculator.UI: void init()>/$stack135	<simplejavacalculator.UI: void init()>
<simplejavacalculator.UI: void init()>/$stack136	<simplejavacalculator.UI: void init()>
<simplejavacalculator.UI: void init()>/$stack137	<simplejavacalculator.UI: void init()>
<simplejavacalculator.UI: void init()>/$stack138	<simplejavacalculator.UI: void init()>
<simplejavacalculator.UI: void init()>/$stack139	<simplejavacalculator.UI: void init()>
<simplejavacalculator.UI: void init()>/$stack140	<simplejavacalculator.UI: void init()>
<simplejavacalculator.UI: void init()>/$stack141	<simplejavacalculator.UI: void init()>
<simplejavacalculator.UI: void init()>/$stack142	<simplejavacalculator.UI: void init()>
<simplejavacalculator.UI: void init()>/$stack143	<simplejavacalculator.UI: void init()>
<simplejavacalculator.UI: void init()>/$stack144	<simplejavacalculator.UI: void init()>
<simplejavacalculator.UI: void init()>/$stack145	<simplejavacalculator.UI: void init()>
<simplejavacalculator.UI: void init()>/$stack146	<simplejavacalculator.UI: void init()>
<simplejavacalculator.UI: void init()>/$stack147	<simplejavacalculator.UI: void init()>
<simplejavacalculator.UI: void init()>/$stack148	<simplejavacalculator.UI: void init()>
<simplejavacalculator.UI: void init()>/$stack149	<simplejavacalculator.UI: void init()>
<simplejavacalculator.UI: void init()>/$stack150	<simplejavacalculator.UI: void init()>
<simplejavacalculator.UI: void init()>/$stack151	<simplejavacalculator.UI: void init()>
<simplejavacalculator.UI: void init()>/$stack152	<simplejavacalculator.UI: void init()>
<simplejavacalculator.UI: void init()>/$stack153	<simplejavacalculator.UI: void init()>
<simplejavacalculator.UI: void init()>/$stack154	<simplejavacalculator.UI: void init()>
<simplejavacalculator.UI: void init()>/$stack155	<simplejavacalculator.UI: void init()>
<simplejavacalculator.UI: void init()>/$stack156	<simplejavacalculator.UI: void init()>
<simplejavacalculator.UI: void init()>/$stack157	<simplejavacalculator.UI: void init()>
<simplejavacalculator.UI: void init()>/$stack158	<simplejavacalculator.UI: void init()>
<simplejavacalculator.UI: void init()>/$stack159	<simplejavacalculator.UI: void init()>
<simplejavacalculator.UI: void init()>/$stack160	<simplejavacalculator.UI: void init()>
<simplejavacalculator.UI: void init()>/$stack161	<simplejavacalculator.UI: void init()>
<simplejavacalculator.UI: void init()>/$stack162	<simplejavacalculator.UI: void init()>
<simplejavacalculator.UI: void init()>/$stack163	<simplejavacalculator.UI: void init()>
<simplejavacalculator.UI: void init()>/$stack164	<simplejavacalculator.UI: void init()>
<simplejavacalculator.UI: void init()>/$stack165	<simplejavacalculator.UI: void init()>
<simplejavacalculator.UI: void init()>/$stack166	<simplejavacalculator.UI: void init()>
<simplejavacalculator.UI: void init()>/$stack167	<simplejavacalculator.UI: void init()>
<simplejavacalculator.UI: void init()>/$stack168	<simplejavacalculator.UI: void init()>
<simplejavacalculator.UI: void init()>/$stack169	<simplejavacalculator.UI: void init()>
<simplejavacalculator.UI: void init()>/$stack170	<simplejavacalculator.UI: void init()>
<simplejavacalculator.UI: void init()>/$stack171	<simplejavacalculator.UI: void init()>
<simplejavacalculator.UI: void init()>/$stack172	<simplejavacalculator.UI: void init()>
<simplejavacalculator.UI: void init()>/$stack173	<simplejavacalculator.UI: void init()>
<simplejavacalculator.UI: void init()>/$stack174	<simplejavacalculator.UI: void init()>
<simplejavacalculator.UI: void init()>/$stack175	<simplejavacalculator.UI: void init()>
<simplejavacalculator.UI: void init()>/$stack176	<simplejavacalculator.UI: void init()>
<simplejavacalculator.UI: void init()>/$stack177	<simplejavacalculator.UI: void init()>
<simplejavacalculator.UI: void init()>/$stack178	<simplejavacalculator.UI: void init()>
<simplejavacalculator.UI: void init()>/$stack179	<simplejavacalculator.UI: void init()>
<simplejavacalculator.UI: void init()>/$stack180	<simplejavacalculator.UI: void init()>
<simplejavacalculator.UI: void init()>/$stack181	<simplejavacalculator.UI: void init()>
<simplejavacalculator.UI: void init()>/$stack182	<simplejavacalculator.UI: void init()>
<simplejavacalculator.UI: void init()>/$stack183	<simplejavacalculator.UI: void init()>
<simplejavacalculator.UI: void init()>/$stack184	<simplejavacalculator.UI: void init()>
<simplejavacalculator.UI: void init()>/$stack185	<simplejavacalculator.UI: void init()>
<simplejavacalculator.UI: void init()>/$stack186	<simplejavacalculator.UI: void init()>
<simplejavacalculator.UI: void init()>/$stack187	<simplejavacalculator.UI: void init()>
<simplejavacalculator.UI: void init()>/$stack188	<simplejavacalculator.UI: void init()>
<simplejavacalculator.UI: void init()>/$stack189	<simplejavacalculator.UI: void init()>
<simplejavacalculator.UI: void init()>/$stack190	<simplejavacalculator.UI: void init()>
<simplejavacalculator.UI: void init()>/$stack191	<simplejavacalculator.UI: void init()>
<simplejavacalculator.UI: void init()>/$stack192	<simplejavacalculator.UI: void init()>
<simplejavacalculator.UI: void init()>/$stack193	<simplejavacalculator.UI: void init()>
<simplejavacalculator.UI: void init()>/$stack194	<simplejavacalculator.UI: void init()>
<simplejavacalculator.UI: void init()>/$stack195	<simplejavacalculator.UI: void init()>
<simplejavacalculator.UI: void init()>/$stack196	<simplejavacalculator.UI: void init()>
<simplejavacalculator.UI: void init()>/$stack197	<simplejavacalculator.UI: void init()>
<simplejavacalculator.UI: void init()>/$stack198	<simplejavacalculator.UI: void init()>
<simplejavacalculator.UI: void init()>/$stack199	<simplejavacalculator.UI: void init()>
<simplejavacalculator.UI: void init()>/$stack200	<simplejavacalculator.UI: void init()>
<simplejavacalculator.UI: void init()>/$stack201	<simplejavacalculator.UI: void init()>
<simplejavacalculator.UI: void init()>/$stack202	<simplejavacalculator.UI: void init()>
<simplejavacalculator.UI: void init()>/$stack203	<simplejavacalculator.UI: void init()>
<simplejavacalculator.UI: void init()>/$stack204	<simplejavacalculator.UI: void init()>
<simplejavacalculator.UI: void init()>/$stack205	<simplejavacalculator.UI: void init()>
<simplejavacalculator.UI: void init()>/$stack206	<simplejavacalculator.UI: void init()>
<simplejavacalculator.UI: void init()>/$stack207	<simplejavacalculator.UI: void init()>
<simplejavacalculator.UI: void init()>/$stack208	<simplejavacalculator.UI: void init()>
<simplejavacalculator.UI: void init()>/$stack209	<simplejavacalculator.UI: void init()>
<simplejavacalculator.UI: void init()>/$stack210	<simplejavacalculator.UI: void init()>
<simplejavacalculator.UI: void init()>/i_$$A_1#_122	<simplejavacalculator.UI: void init()>
<simplejavacalculator.UI: void init()>/i_$$A_1_$$A_1#_123	<simplejavacalculator.UI: void init()>
<simplejavacalculator.UI: void init()>/i_$$A_1_$$A_2#_122	<simplejavacalculator.UI: void init()>
<simplejavacalculator.UI: void init()>/i_$$A_1_$$A_3#_193	<simplejavacalculator.UI: void init()>
<simplejavacalculator.UI: void init()>/i_$$A_1_$$A_4#_194	<simplejavacalculator.UI: void init()>
<simplejavacalculator.UI: void init()>/i_$$A_1_$$A_5#_193	<simplejavacalculator.UI: void init()>
<simplejavacalculator.UI: void init()>/$numconstant0	<simplejavacalculator.UI: void init()>
<simplejavacalculator.UI: void init()>/$numconstant1	<simplejavacalculator.UI: void init()>
<simplejavacalculator.UI: void init()>/$numconstant2	<simplejavacalculator.UI: void init()>
<simplejavacalculator.UI: void init()>/$null0	<simplejavacalculator.UI: void init()>
<simplejavacalculator.UI: void init()>/$numconstant3	<simplejavacalculator.UI: void init()>
<simplejavacalculator.UI: void init()>/$numconstant4	<simplejavacalculator.UI: void init()>
<simplejavacalculator.UI: void init()>/$numconstant5	<simplejavacalculator.UI: void init()>
<simplejavacalculator.UI: void init()>/$numconstant6	<simplejavacalculator.UI: void init()>
<simplejavacalculator.UI: void init()>/$numconstant7	<simplejavacalculator.UI: void init()>
<simplejavacalculator.UI: void init()>/$numconstant8	<simplejavacalculator.UI: void init()>
<simplejavacalculator.UI: void init()>/$numconstant9	<simplejavacalculator.UI: void init()>
<simplejavacalculator.UI: void init()>/$numconstant10	<simplejavacalculator.UI: void init()>
<simplejavacalculator.UI: void actionPerformed(java.awt.event.ActionEvent)>/@this	<simplejavacalculator.UI: void actionPerformed(java.awt.event.ActionEvent)>
<simplejavacalculator.UI: void actionPerformed(java.awt.event.ActionEvent)>/@parameter0	<simplejavacalculator.UI: void actionPerformed(java.awt.event.ActionEvent)>
<simplejavacalculator.UI: void actionPerformed(java.awt.event.ActionEvent)>/e#_0	<simplejavacalculator.UI: void actionPerformed(java.awt.event.ActionEvent)>
<simplejavacalculator.UI: void actionPerformed(java.awt.event.ActionEvent)>/$stack4	<simplejavacalculator.UI: void actionPerformed(java.awt.event.ActionEvent)>
<simplejavacalculator.UI: void actionPerformed(java.awt.event.ActionEvent)>/source#_220	<simplejavacalculator.UI: void actionPerformed(java.awt.event.ActionEvent)>
<simplejavacalculator.UI: void actionPerformed(java.awt.event.ActionEvent)>/i	<simplejavacalculator.UI: void actionPerformed(java.awt.event.ActionEvent)>
<simplejavacalculator.UI: void actionPerformed(java.awt.event.ActionEvent)>/this#_0	<simplejavacalculator.UI: void actionPerformed(java.awt.event.ActionEvent)>
<simplejavacalculator.UI: void actionPerformed(java.awt.event.ActionEvent)>/$stack5	<simplejavacalculator.UI: void actionPerformed(java.awt.event.ActionEvent)>
<simplejavacalculator.UI: void actionPerformed(java.awt.event.ActionEvent)>/$stack6	<simplejavacalculator.UI: void actionPerformed(java.awt.event.ActionEvent)>
<simplejavacalculator.UI: void actionPerformed(java.awt.event.ActionEvent)>/$stack7	<simplejavacalculator.UI: void actionPerformed(java.awt.event.ActionEvent)>
<simplejavacalculator.UI: void actionPerformed(java.awt.event.ActionEvent)>/$stack8	<simplejavacalculator.UI: void actionPerformed(java.awt.event.ActionEvent)>
<simplejavacalculator.UI: void actionPerformed(java.awt.event.ActionEvent)>/$stack9	<simplejavacalculator.UI: void actionPerformed(java.awt.event.ActionEvent)>
<simplejavacalculator.UI: void actionPerformed(java.awt.event.ActionEvent)>/$stack10	<simplejavacalculator.UI: void actionPerformed(java.awt.event.ActionEvent)>
<simplejavacalculator.UI: void actionPerformed(java.awt.event.ActionEvent)>/$stack11	<simplejavacalculator.UI: void actionPerformed(java.awt.event.ActionEvent)>
<simplejavacalculator.UI: void actionPerformed(java.awt.event.ActionEvent)>/$stack12	<simplejavacalculator.UI: void actionPerformed(java.awt.event.ActionEvent)>
<simplejavacalculator.UI: void actionPerformed(java.awt.event.ActionEvent)>/$stack13	<simplejavacalculator.UI: void actionPerformed(java.awt.event.ActionEvent)>
<simplejavacalculator.UI: void actionPerformed(java.awt.event.ActionEvent)>/$stack14	<simplejavacalculator.UI: void actionPerformed(java.awt.event.ActionEvent)>
<simplejavacalculator.UI: void actionPerformed(java.awt.event.ActionEvent)>/$stack15	<simplejavacalculator.UI: void actionPerformed(java.awt.event.ActionEvent)>
<simplejavacalculator.UI: void actionPerformed(java.awt.event.ActionEvent)>/$stack16	<simplejavacalculator.UI: void actionPerformed(java.awt.event.ActionEvent)>
<simplejavacalculator.UI: void actionPerformed(java.awt.event.ActionEvent)>/$stack17	<simplejavacalculator.UI: void actionPerformed(java.awt.event.ActionEvent)>
<simplejavacalculator.UI: void actionPerformed(java.awt.event.ActionEvent)>/$stack18	<simplejavacalculator.UI: void actionPerformed(java.awt.event.ActionEvent)>
<simplejavacalculator.UI: void actionPerformed(java.awt.event.ActionEvent)>/$stack19	<simplejavacalculator.UI: void actionPerformed(java.awt.event.ActionEvent)>
<simplejavacalculator.UI: void actionPerformed(java.awt.event.ActionEvent)>/$stack20	<simplejavacalculator.UI: void actionPerformed(java.awt.event.ActionEvent)>
<simplejavacalculator.UI: void actionPerformed(java.awt.event.ActionEvent)>/$stack21	<simplejavacalculator.UI: void actionPerformed(java.awt.event.ActionEvent)>
<simplejavacalculator.UI: void actionPerformed(java.awt.event.ActionEvent)>/$stack22	<simplejavacalculator.UI: void actionPerformed(java.awt.event.ActionEvent)>
<simplejavacalculator.UI: void actionPerformed(java.awt.event.ActionEvent)>/$stack23	<simplejavacalculator.UI: void actionPerformed(java.awt.event.ActionEvent)>
<simplejavacalculator.UI: void actionPerformed(java.awt.event.ActionEvent)>/$stack24	<simplejavacalculator.UI: void actionPerformed(java.awt.event.ActionEvent)>
<simplejavacalculator.UI: void actionPerformed(java.awt.event.ActionEvent)>/$stack25	<simplejavacalculator.UI: void actionPerformed(java.awt.event.ActionEvent)>
<simplejavacalculator.UI: void actionPerformed(java.awt.event.ActionEvent)>/$stack26	<simplejavacalculator.UI: void actionPerformed(java.awt.event.ActionEvent)>
<simplejavacalculator.UI: void actionPerformed(java.awt.event.ActionEvent)>/$stack27	<simplejavacalculator.UI: void actionPerformed(java.awt.event.ActionEvent)>
<simplejavacalculator.UI: void actionPerformed(java.awt.event.ActionEvent)>/$stack28	<simplejavacalculator.UI: void actionPerformed(java.awt.event.ActionEvent)>
<simplejavacalculator.UI: void actionPerformed(java.awt.event.ActionEvent)>/$stack29	<simplejavacalculator.UI: void actionPerformed(java.awt.event.ActionEvent)>
<simplejavacalculator.UI: void actionPerformed(java.awt.event.ActionEvent)>/$stack30	<simplejavacalculator.UI: void actionPerformed(java.awt.event.ActionEvent)>
<simplejavacalculator.UI: void actionPerformed(java.awt.event.ActionEvent)>/$stack31	<simplejavacalculator.UI: void actionPerformed(java.awt.event.ActionEvent)>
<simplejavacalculator.UI: void actionPerformed(java.awt.event.ActionEvent)>/$stack32	<simplejavacalculator.UI: void actionPerformed(java.awt.event.ActionEvent)>
<simplejavacalculator.UI: void actionPerformed(java.awt.event.ActionEvent)>/$stack33	<simplejavacalculator.UI: void actionPerformed(java.awt.event.ActionEvent)>
<simplejavacalculator.UI: void actionPerformed(java.awt.event.ActionEvent)>/$stack34	<simplejavacalculator.UI: void actionPerformed(java.awt.event.ActionEvent)>
<simplejavacalculator.UI: void actionPerformed(java.awt.event.ActionEvent)>/$stack35	<simplejavacalculator.UI: void actionPerformed(java.awt.event.ActionEvent)>
<simplejavacalculator.UI: void actionPerformed(java.awt.event.ActionEvent)>/$stack36	<simplejavacalculator.UI: void actionPerformed(java.awt.event.ActionEvent)>
<simplejavacalculator.UI: void actionPerformed(java.awt.event.ActionEvent)>/$stack37	<simplejavacalculator.UI: void actionPerformed(java.awt.event.ActionEvent)>
<simplejavacalculator.UI: void actionPerformed(java.awt.event.ActionEvent)>/$stack38	<simplejavacalculator.UI: void actionPerformed(java.awt.event.ActionEvent)>
<simplejavacalculator.UI: void actionPerformed(java.awt.event.ActionEvent)>/$stack39	<simplejavacalculator.UI: void actionPerformed(java.awt.event.ActionEvent)>
<simplejavacalculator.UI: void actionPerformed(java.awt.event.ActionEvent)>/$stack40	<simplejavacalculator.UI: void actionPerformed(java.awt.event.ActionEvent)>
<simplejavacalculator.UI: void actionPerformed(java.awt.event.ActionEvent)>/$stack41	<simplejavacalculator.UI: void actionPerformed(java.awt.event.ActionEvent)>
<simplejavacalculator.UI: void actionPerformed(java.awt.event.ActionEvent)>/$stack42	<simplejavacalculator.UI: void actionPerformed(java.awt.event.ActionEvent)>
<simplejavacalculator.UI: void actionPerformed(java.awt.event.ActionEvent)>/$stack43	<simplejavacalculator.UI: void actionPerformed(java.awt.event.ActionEvent)>
<simplejavacalculator.UI: void actionPerformed(java.awt.event.ActionEvent)>/$stack44	<simplejavacalculator.UI: void actionPerformed(java.awt.event.ActionEvent)>
<simplejavacalculator.UI: void actionPerformed(java.awt.event.ActionEvent)>/$stack45	<simplejavacalculator.UI: void actionPerformed(java.awt.event.ActionEvent)>
<simplejavacalculator.UI: void actionPerformed(java.awt.event.ActionEvent)>/$stack46	<simplejavacalculator.UI: void actionPerformed(java.awt.event.ActionEvent)>
<simplejavacalculator.UI: void actionPerformed(java.awt.event.ActionEvent)>/$stack47	<simplejavacalculator.UI: void actionPerformed(java.awt.event.ActionEvent)>
<simplejavacalculator.UI: void actionPerformed(java.awt.event.ActionEvent)>/$stack48	<simplejavacalculator.UI: void actionPerformed(java.awt.event.ActionEvent)>
<simplejavacalculator.UI: void actionPerformed(java.awt.event.ActionEvent)>/$stack49	<simplejavacalculator.UI: void actionPerformed(java.awt.event.ActionEvent)>
<simplejavacalculator.UI: void actionPerformed(java.awt.event.ActionEvent)>/$stack50	<simplejavacalculator.UI: void actionPerformed(java.awt.event.ActionEvent)>
<simplejavacalculator.UI: void actionPerformed(java.awt.event.ActionEvent)>/$stack51	<simplejavacalculator.UI: void actionPerformed(java.awt.event.ActionEvent)>
<simplejavacalculator.UI: void actionPerformed(java.awt.event.ActionEvent)>/$stack52	<simplejavacalculator.UI: void actionPerformed(java.awt.event.ActionEvent)>
<simplejavacalculator.UI: void actionPerformed(java.awt.event.ActionEvent)>/$stack53	<simplejavacalculator.UI: void actionPerformed(java.awt.event.ActionEvent)>
<simplejavacalculator.UI: void actionPerformed(java.awt.event.ActionEvent)>/$stack54	<simplejavacalculator.UI: void actionPerformed(java.awt.event.ActionEvent)>
<simplejavacalculator.UI: void actionPerformed(java.awt.event.ActionEvent)>/$stack55	<simplejavacalculator.UI: void actionPerformed(java.awt.event.ActionEvent)>
<simplejavacalculator.UI: void actionPerformed(java.awt.event.ActionEvent)>/$stack56	<simplejavacalculator.UI: void actionPerformed(java.awt.event.ActionEvent)>
<simplejavacalculator.UI: void actionPerformed(java.awt.event.ActionEvent)>/$stack57	<simplejavacalculator.UI: void actionPerformed(java.awt.event.ActionEvent)>
<simplejavacalculator.UI: void actionPerformed(java.awt.event.ActionEvent)>/$stack58	<simplejavacalculator.UI: void actionPerformed(java.awt.event.ActionEvent)>
<simplejavacalculator.UI: void actionPerformed(java.awt.event.ActionEvent)>/$stack59	<simplejavacalculator.UI: void actionPerformed(java.awt.event.ActionEvent)>
<simplejavacalculator.UI: void actionPerformed(java.awt.event.ActionEvent)>/$stack60	<simplejavacalculator.UI: void actionPerformed(java.awt.event.ActionEvent)>
<simplejavacalculator.UI: void actionPerformed(java.awt.event.ActionEvent)>/$stack61	<simplejavacalculator.UI: void actionPerformed(java.awt.event.ActionEvent)>
<simplejavacalculator.UI: void actionPerformed(java.awt.event.ActionEvent)>/$stack62	<simplejavacalculator.UI: void actionPerformed(java.awt.event.ActionEvent)>
<simplejavacalculator.UI: void actionPerformed(java.awt.event.ActionEvent)>/$stack63	<simplejavacalculator.UI: void actionPerformed(java.awt.event.ActionEvent)>
<simplejavacalculator.UI: void actionPerformed(java.awt.event.ActionEvent)>/$stack64	<simplejavacalculator.UI: void actionPerformed(java.awt.event.ActionEvent)>
<simplejavacalculator.UI: void actionPerformed(java.awt.event.ActionEvent)>/$stack65	<simplejavacalculator.UI: void actionPerformed(java.awt.event.ActionEvent)>
<simplejavacalculator.UI: void actionPerformed(java.awt.event.ActionEvent)>/$stack66	<simplejavacalculator.UI: void actionPerformed(java.awt.event.ActionEvent)>
<simplejavacalculator.UI: void actionPerformed(java.awt.event.ActionEvent)>/$stack67	<simplejavacalculator.UI: void actionPerformed(java.awt.event.ActionEvent)>
<simplejavacalculator.UI: void actionPerformed(java.awt.event.ActionEvent)>/$stack68	<simplejavacalculator.UI: void actionPerformed(java.awt.event.ActionEvent)>
<simplejavacalculator.UI: void actionPerformed(java.awt.event.ActionEvent)>/$stack69	<simplejavacalculator.UI: void actionPerformed(java.awt.event.ActionEvent)>
<simplejavacalculator.UI: void actionPerformed(java.awt.event.ActionEvent)>/$stack70	<simplejavacalculator.UI: void actionPerformed(java.awt.event.ActionEvent)>
<simplejavacalculator.UI: void actionPerformed(java.awt.event.ActionEvent)>/$stack71	<simplejavacalculator.UI: void actionPerformed(java.awt.event.ActionEvent)>
<simplejavacalculator.UI: void actionPerformed(java.awt.event.ActionEvent)>/$stack72	<simplejavacalculator.UI: void actionPerformed(java.awt.event.ActionEvent)>
<simplejavacalculator.UI: void actionPerformed(java.awt.event.ActionEvent)>/$stack73	<simplejavacalculator.UI: void actionPerformed(java.awt.event.ActionEvent)>
<simplejavacalculator.UI: void actionPerformed(java.awt.event.ActionEvent)>/$stack74	<simplejavacalculator.UI: void actionPerformed(java.awt.event.ActionEvent)>
<simplejavacalculator.UI: void actionPerformed(java.awt.event.ActionEvent)>/$stack75	<simplejavacalculator.UI: void actionPerformed(java.awt.event.ActionEvent)>
<simplejavacalculator.UI: void actionPerformed(java.awt.event.ActionEvent)>/$stack76	<simplejavacalculator.UI: void actionPerformed(java.awt.event.ActionEvent)>
<simplejavacalculator.UI: void actionPerformed(java.awt.event.ActionEvent)>/$stack77	<simplejavacalculator.UI: void actionPerformed(java.awt.event.ActionEvent)>
<simplejavacalculator.UI: void actionPerformed(java.awt.event.ActionEvent)>/$stack78	<simplejavacalculator.UI: void actionPerformed(java.awt.event.ActionEvent)>
<simplejavacalculator.UI: void actionPerformed(java.awt.event.ActionEvent)>/$stack79	<simplejavacalculator.UI: void actionPerformed(java.awt.event.ActionEvent)>
<simplejavacalculator.UI: void actionPerformed(java.awt.event.ActionEvent)>/$stack80	<simplejavacalculator.UI: void actionPerformed(java.awt.event.ActionEvent)>
<simplejavacalculator.UI: void actionPerformed(java.awt.event.ActionEvent)>/$stack81	<simplejavacalculator.UI: void actionPerformed(java.awt.event.ActionEvent)>
<simplejavacalculator.UI: void actionPerformed(java.awt.event.ActionEvent)>/$stack82	<simplejavacalculator.UI: void actionPerformed(java.awt.event.ActionEvent)>
<simplejavacalculator.UI: void actionPerformed(java.awt.event.ActionEvent)>/$stack83	<simplejavacalculator.UI: void actionPerformed(java.awt.event.ActionEvent)>
<simplejavacalculator.UI: void actionPerformed(java.awt.event.ActionEvent)>/$stack84	<simplejavacalculator.UI: void actionPerformed(java.awt.event.ActionEvent)>
<simplejavacalculator.UI: void actionPerformed(java.awt.event.ActionEvent)>/$stack85	<simplejavacalculator.UI: void actionPerformed(java.awt.event.ActionEvent)>
<simplejavacalculator.UI: void actionPerformed(java.awt.event.ActionEvent)>/$stack86	<simplejavacalculator.UI: void actionPerformed(java.awt.event.ActionEvent)>
<simplejavacalculator.UI: void actionPerformed(java.awt.event.ActionEvent)>/$stack87	<simplejavacalculator.UI: void actionPerformed(java.awt.event.ActionEvent)>
<simplejavacalculator.UI: void actionPerformed(java.awt.event.ActionEvent)>/$stack88	<simplejavacalculator.UI: void actionPerformed(java.awt.event.ActionEvent)>
<simplejavacalculator.UI: void actionPerformed(java.awt.event.ActionEvent)>/$stack89	<simplejavacalculator.UI: void actionPerformed(java.awt.event.ActionEvent)>
<simplejavacalculator.UI: void actionPerformed(java.awt.event.ActionEvent)>/$stack90	<simplejavacalculator.UI: void actionPerformed(java.awt.event.ActionEvent)>
<simplejavacalculator.UI: void actionPerformed(java.awt.event.ActionEvent)>/$stack91	<simplejavacalculator.UI: void actionPerformed(java.awt.event.ActionEvent)>
<simplejavacalculator.UI: void actionPerformed(java.awt.event.ActionEvent)>/$stack92	<simplejavacalculator.UI: void actionPerformed(java.awt.event.ActionEvent)>
<simplejavacalculator.UI: void actionPerformed(java.awt.event.ActionEvent)>/$stack93	<simplejavacalculator.UI: void actionPerformed(java.awt.event.ActionEvent)>
<simplejavacalculator.UI: void actionPerformed(java.awt.event.ActionEvent)>/$stack94	<simplejavacalculator.UI: void actionPerformed(java.awt.event.ActionEvent)>
<simplejavacalculator.UI: void actionPerformed(java.awt.event.ActionEvent)>/$stack95	<simplejavacalculator.UI: void actionPerformed(java.awt.event.ActionEvent)>
<simplejavacalculator.UI: void actionPerformed(java.awt.event.ActionEvent)>/$stack96	<simplejavacalculator.UI: void actionPerformed(java.awt.event.ActionEvent)>
<simplejavacalculator.UI: void actionPerformed(java.awt.event.ActionEvent)>/$stack97	<simplejavacalculator.UI: void actionPerformed(java.awt.event.ActionEvent)>
<simplejavacalculator.UI: void actionPerformed(java.awt.event.ActionEvent)>/$stack98	<simplejavacalculator.UI: void actionPerformed(java.awt.event.ActionEvent)>
<simplejavacalculator.UI: void actionPerformed(java.awt.event.ActionEvent)>/$stack99	<simplejavacalculator.UI: void actionPerformed(java.awt.event.ActionEvent)>
<simplejavacalculator.UI: void actionPerformed(java.awt.event.ActionEvent)>/$stack100	<simplejavacalculator.UI: void actionPerformed(java.awt.event.ActionEvent)>
<simplejavacalculator.UI: void actionPerformed(java.awt.event.ActionEvent)>/$stack101	<simplejavacalculator.UI: void actionPerformed(java.awt.event.ActionEvent)>
<simplejavacalculator.UI: void actionPerformed(java.awt.event.ActionEvent)>/$stack102	<simplejavacalculator.UI: void actionPerformed(java.awt.event.ActionEvent)>
<simplejavacalculator.UI: void actionPerformed(java.awt.event.ActionEvent)>/$stack103	<simplejavacalculator.UI: void actionPerformed(java.awt.event.ActionEvent)>
<simplejavacalculator.UI: void actionPerformed(java.awt.event.ActionEvent)>/$stack104	<simplejavacalculator.UI: void actionPerformed(java.awt.event.ActionEvent)>
<simplejavacalculator.UI: void actionPerformed(java.awt.event.ActionEvent)>/$stack105	<simplejavacalculator.UI: void actionPerformed(java.awt.event.ActionEvent)>
<simplejavacalculator.UI: void actionPerformed(java.awt.event.ActionEvent)>/$stack106	<simplejavacalculator.UI: void actionPerformed(java.awt.event.ActionEvent)>
<simplejavacalculator.UI: void actionPerformed(java.awt.event.ActionEvent)>/$stack107	<simplejavacalculator.UI: void actionPerformed(java.awt.event.ActionEvent)>
<simplejavacalculator.UI: void actionPerformed(java.awt.event.ActionEvent)>/$stack108	<simplejavacalculator.UI: void actionPerformed(java.awt.event.ActionEvent)>
<simplejavacalculator.UI: void actionPerformed(java.awt.event.ActionEvent)>/$stack109	<simplejavacalculator.UI: void actionPerformed(java.awt.event.ActionEvent)>
<simplejavacalculator.UI: void actionPerformed(java.awt.event.ActionEvent)>/$stack110	<simplejavacalculator.UI: void actionPerformed(java.awt.event.ActionEvent)>
<simplejavacalculator.UI: void actionPerformed(java.awt.event.ActionEvent)>/$stack111	<simplejavacalculator.UI: void actionPerformed(java.awt.event.ActionEvent)>
<simplejavacalculator.UI: void actionPerformed(java.awt.event.ActionEvent)>/$stack112	<simplejavacalculator.UI: void actionPerformed(java.awt.event.ActionEvent)>
<simplejavacalculator.UI: void actionPerformed(java.awt.event.ActionEvent)>/$stack113	<simplejavacalculator.UI: void actionPerformed(java.awt.event.ActionEvent)>
<simplejavacalculator.UI: void actionPerformed(java.awt.event.ActionEvent)>/$stack114	<simplejavacalculator.UI: void actionPerformed(java.awt.event.ActionEvent)>
<simplejavacalculator.UI: void actionPerformed(java.awt.event.ActionEvent)>/$stack115	<simplejavacalculator.UI: void actionPerformed(java.awt.event.ActionEvent)>
<simplejavacalculator.UI: void actionPerformed(java.awt.event.ActionEvent)>/$stack116	<simplejavacalculator.UI: void actionPerformed(java.awt.event.ActionEvent)>
<simplejavacalculator.UI: void actionPerformed(java.awt.event.ActionEvent)>/$stack117	<simplejavacalculator.UI: void actionPerformed(java.awt.event.ActionEvent)>
<simplejavacalculator.UI: void actionPerformed(java.awt.event.ActionEvent)>/$stack118	<simplejavacalculator.UI: void actionPerformed(java.awt.event.ActionEvent)>
<simplejavacalculator.UI: void actionPerformed(java.awt.event.ActionEvent)>/$stack119	<simplejavacalculator.UI: void actionPerformed(java.awt.event.ActionEvent)>
<simplejavacalculator.UI: void actionPerformed(java.awt.event.ActionEvent)>/$stack120	<simplejavacalculator.UI: void actionPerformed(java.awt.event.ActionEvent)>
<simplejavacalculator.UI: void actionPerformed(java.awt.event.ActionEvent)>/$stack121	<simplejavacalculator.UI: void actionPerformed(java.awt.event.ActionEvent)>
<simplejavacalculator.UI: void actionPerformed(java.awt.event.ActionEvent)>/$stack122	<simplejavacalculator.UI: void actionPerformed(java.awt.event.ActionEvent)>
<simplejavacalculator.UI: void actionPerformed(java.awt.event.ActionEvent)>/$stack123	<simplejavacalculator.UI: void actionPerformed(java.awt.event.ActionEvent)>
<simplejavacalculator.UI: void actionPerformed(java.awt.event.ActionEvent)>/i_$$A_1#_222	<simplejavacalculator.UI: void actionPerformed(java.awt.event.ActionEvent)>
<simplejavacalculator.UI: void actionPerformed(java.awt.event.ActionEvent)>/i_$$A_1_$$A_1#_223	<simplejavacalculator.UI: void actionPerformed(java.awt.event.ActionEvent)>
<simplejavacalculator.UI: void actionPerformed(java.awt.event.ActionEvent)>/i_$$A_1_$$A_2#_222	<simplejavacalculator.UI: void actionPerformed(java.awt.event.ActionEvent)>
<simplejavacalculator.UI: void parsetoBinary()>/@this	<simplejavacalculator.UI: void parsetoBinary()>
<simplejavacalculator.UI: void parsetoBinary()>/this#_0	<simplejavacalculator.UI: void parsetoBinary()>
<simplejavacalculator.UI: void parsetoBinary()>/$stack2	<simplejavacalculator.UI: void parsetoBinary()>
<simplejavacalculator.UI: void parsetoBinary()>/$stack3	<simplejavacalculator.UI: void parsetoBinary()>
<simplejavacalculator.UI: void parsetoBinary()>/$stack4	<simplejavacalculator.UI: void parsetoBinary()>
<simplejavacalculator.UI: void parsetoBinary()>/$stack5	<simplejavacalculator.UI: void parsetoBinary()>
<simplejavacalculator.UI: void parsetoBinary()>/$stack6	<simplejavacalculator.UI: void parsetoBinary()>
<simplejavacalculator.UI: void parsetoBinary()>/$stack7	<simplejavacalculator.UI: void parsetoBinary()>
<simplejavacalculator.UI: void parsetoBinary()>/$stack8	<simplejavacalculator.UI: void parsetoBinary()>
<simplejavacalculator.UI: void parsetoBinary()>/$stack9	<simplejavacalculator.UI: void parsetoBinary()>
<simplejavacalculator.UI: void parsetoBinary()>/$stack10	<simplejavacalculator.UI: void parsetoBinary()>
<simplejavacalculator.UI: void parsetoBinary()>/$stack11	<simplejavacalculator.UI: void parsetoBinary()>
<simplejavacalculator.UI: void parsetoBinary()>/ex#_310	<simplejavacalculator.UI: void parsetoBinary()>
<simplejavacalculator.UI: void parsetoBinary()>/$stack12	<simplejavacalculator.UI: void parsetoBinary()>
<simplejavacalculator.UI: void parsetoBinary()>/$stack13	<simplejavacalculator.UI: void parsetoBinary()>
<simplejavacalculator.UI: void parsetoBinary()>/$stack14	<simplejavacalculator.UI: void parsetoBinary()>
<simplejavacalculator.UI: void parsetoBinary()>/$stack15	<simplejavacalculator.UI: void parsetoBinary()>
<simplejavacalculator.UI: void parsetoBinary()>/$stack16	<simplejavacalculator.UI: void parsetoBinary()>
<simplejavacalculator.UI: void parsetoBinary()>/$stack17	<simplejavacalculator.UI: void parsetoBinary()>
<simplejavacalculator.UI: void parsetoBinary()>/$stringconstant0	<simplejavacalculator.UI: void parsetoBinary()>
<simplejavacalculator.UI: void parsetoBinary()>/$stringconstant1	<simplejavacalculator.UI: void parsetoBinary()>
<simplejavacalculator.UI: java.lang.Double reader()>/@this	<simplejavacalculator.UI: java.lang.Double reader()>
<simplejavacalculator.UI: java.lang.Double reader()>/this#_0	<simplejavacalculator.UI: java.lang.Double reader()>
<simplejavacalculator.UI: java.lang.Double reader()>/$stack3	<simplejavacalculator.UI: java.lang.Double reader()>
<simplejavacalculator.UI: java.lang.Double reader()>/$stack4	<simplejavacalculator.UI: java.lang.Double reader()>
<simplejavacalculator.UI: java.lang.Double reader()>/str#_318	<simplejavacalculator.UI: java.lang.Double reader()>
<simplejavacalculator.UI: java.lang.Double reader()>/$stack5	<simplejavacalculator.UI: java.lang.Double reader()>
<simplejavacalculator.UI: java.lang.Double reader()>/num#_319	<simplejavacalculator.UI: java.lang.Double reader()>
<simplejavacalculator.UI: void writer(java.lang.Double)>/@this	<simplejavacalculator.UI: void writer(java.lang.Double)>
<simplejavacalculator.UI: void writer(java.lang.Double)>/@parameter0	<simplejavacalculator.UI: void writer(java.lang.Double)>
<simplejavacalculator.UI: void writer(java.lang.Double)>/num#_0	<simplejavacalculator.UI: void writer(java.lang.Double)>
<simplejavacalculator.UI: void writer(java.lang.Double)>/$stack2	<simplejavacalculator.UI: void writer(java.lang.Double)>
<simplejavacalculator.UI: void writer(java.lang.Double)>/$stack3	<simplejavacalculator.UI: void writer(java.lang.Double)>
<simplejavacalculator.UI: void writer(java.lang.Double)>/this#_0	<simplejavacalculator.UI: void writer(java.lang.Double)>
<simplejavacalculator.UI: void writer(java.lang.Double)>/$stack4	<simplejavacalculator.UI: void writer(java.lang.Double)>
<simplejavacalculator.UI: void writer(java.lang.Double)>/$stack5	<simplejavacalculator.UI: void writer(java.lang.Double)>
<simplejavacalculator.UI: void writer(java.lang.Double)>/$stack6	<simplejavacalculator.UI: void writer(java.lang.Double)>
<simplejavacalculator.UI: void writer(java.lang.Double)>/$stack7	<simplejavacalculator.UI: void writer(java.lang.Double)>
<simplejavacalculator.UI: void writer(java.lang.Double)>/$stringconstant0	<simplejavacalculator.UI: void writer(java.lang.Double)>
