<simplejavacalculator.UI: javax.swing.JButton butDivide>	simplejavacalculator.UI	butDivide	javax.swing.JButton
<simplejavacalculator.Calculator$MonoOperatorModes: simplejavacalculator.Calculator$MonoOperatorModes tan>	simplejavacalculator.Calculator$MonoOperatorModes	tan	simplejavacalculator.Calculator$MonoOperatorModes
<simplejavacalculator.Calculator: java.lang.Double num1>	simplejavacalculator.Calculator	num1	java.lang.Double
<simplejavacalculator.Calculator$MonoOperatorModes: simplejavacalculator.Calculator$MonoOperatorModes abs>	simplejavacalculator.Calculator$MonoOperatorModes	abs	simplejavacalculator.Calculator$MonoOperatorModes
<simplejavacalculator.UI: javax.swing.JButton[] but>	simplejavacalculator.UI	but	javax.swing.JButton[]
<simplejavacalculator.Calculator$MonoOperatorModes: simplejavacalculator.Calculator$MonoOperatorModes oneDevidedBy>	simplejavacalculator.Calculator$MonoOperatorModes	oneDevidedBy	simplejavacalculator.Calculator$MonoOperatorModes
<simplejavacalculator.Calculator$MonoOperatorModes: simplejavacalculator.Calculator$MonoOperatorModes square>	simplejavacalculator.Calculator$MonoOperatorModes	square	simplejavacalculator.Calculator$MonoOperatorModes
<simplejavacalculator.UI: javax.swing.JButton butlog>	simplejavacalculator.UI	butlog	javax.swing.JButton
<simplejavacalculator.Calculator$MonoOperatorModes: simplejavacalculator.Calculator$MonoOperatorModes cos>	simplejavacalculator.Calculator$MonoOperatorModes	cos	simplejavacalculator.Calculator$MonoOperatorModes
<simplejavacalculator.UI: javax.swing.JButton butMultiply>	simplejavacalculator.UI	butMultiply	javax.swing.JButton
<simplejavacalculator.UI: javax.swing.JPanel panelSub6>	simplejavacalculator.UI	panelSub6	javax.swing.JPanel
<simplejavacalculator.Calculator$BiOperatorModes: simplejavacalculator.Calculator$BiOperatorModes divide>	simplejavacalculator.Calculator$BiOperatorModes	divide	simplejavacalculator.Calculator$BiOperatorModes
<simplejavacalculator.Calculator$MonoOperatorModes: simplejavacalculator.Calculator$MonoOperatorModes log>	simplejavacalculator.Calculator$MonoOperatorModes	log	simplejavacalculator.Calculator$MonoOperatorModes
<simplejavacalculator.UI: javax.swing.JPanel panelSub2>	simplejavacalculator.UI	panelSub2	javax.swing.JPanel
<simplejavacalculator.UI: javax.swing.JPanel panelSub4>	simplejavacalculator.UI	panelSub4	javax.swing.JPanel
<simplejavacalculator.UI: javax.swing.JButton butEqual>	simplejavacalculator.UI	butEqual	javax.swing.JButton
<simplejavacalculator.UI: javax.swing.JButton butrate>	simplejavacalculator.UI	butrate	javax.swing.JButton
<simplejavacalculator.UI: javax.swing.JButton butTan>	simplejavacalculator.UI	butTan	javax.swing.JButton
<simplejavacalculator.UI: java.awt.Font textFont>	simplejavacalculator.UI	textFont	java.awt.Font
<simplejavacalculator.Calculator$BiOperatorModes: simplejavacalculator.Calculator$BiOperatorModes normal>	simplejavacalculator.Calculator$BiOperatorModes	normal	simplejavacalculator.Calculator$BiOperatorModes
<simplejavacalculator.UI: javax.swing.JButton butCos>	simplejavacalculator.UI	butCos	javax.swing.JButton
<simplejavacalculator.UI: java.awt.Font font>	simplejavacalculator.UI	font	java.awt.Font
<simplejavacalculator.Calculator$MonoOperatorModes: simplejavacalculator.Calculator$MonoOperatorModes squareRoot>	simplejavacalculator.Calculator$MonoOperatorModes	squareRoot	simplejavacalculator.Calculator$MonoOperatorModes
<simplejavacalculator.UI: javax.swing.JPanel panelSub3>	simplejavacalculator.UI	panelSub3	javax.swing.JPanel
<simplejavacalculator.Calculator$BiOperatorModes: simplejavacalculator.Calculator$BiOperatorModes multiply>	simplejavacalculator.Calculator$BiOperatorModes	multiply	simplejavacalculator.Calculator$BiOperatorModes
<simplejavacalculator.UI: simplejavacalculator.Calculator calc>	simplejavacalculator.UI	calc	simplejavacalculator.Calculator
<simplejavacalculator.Calculator: java.lang.Double num2>	simplejavacalculator.Calculator	num2	java.lang.Double
<simplejavacalculator.UI: javax.swing.ImageIcon image>	simplejavacalculator.UI	image	javax.swing.ImageIcon
<simplejavacalculator.UI: javax.swing.JPanel panel>	simplejavacalculator.UI	panel	javax.swing.JPanel
<simplejavacalculator.UI: javax.swing.JButton butCancel>	simplejavacalculator.UI	butCancel	javax.swing.JButton
<simplejavacalculator.Calculator$BiOperatorModes: simplejavacalculator.Calculator$BiOperatorModes minus>	simplejavacalculator.Calculator$BiOperatorModes	minus	simplejavacalculator.Calculator$BiOperatorModes
<simplejavacalculator.Calculator: simplejavacalculator.Calculator$BiOperatorModes mode>	simplejavacalculator.Calculator	mode	simplejavacalculator.Calculator$BiOperatorModes
<simplejavacalculator.Calculator$BiOperatorModes: simplejavacalculator.Calculator$BiOperatorModes xpowerofy>	simplejavacalculator.Calculator$BiOperatorModes	xpowerofy	simplejavacalculator.Calculator$BiOperatorModes
<simplejavacalculator.UI: javax.swing.JButton butSquare>	simplejavacalculator.UI	butSquare	javax.swing.JButton
<simplejavacalculator.Calculator$BiOperatorModes: simplejavacalculator.Calculator$BiOperatorModes[] $VALUES>	simplejavacalculator.Calculator$BiOperatorModes	$VALUES	simplejavacalculator.Calculator$BiOperatorModes[]
<simplejavacalculator.Calculator$MonoOperatorModes: simplejavacalculator.Calculator$MonoOperatorModes sin>	simplejavacalculator.Calculator$MonoOperatorModes	sin	simplejavacalculator.Calculator$MonoOperatorModes
<simplejavacalculator.UI: javax.swing.JPanel panelSub5>	simplejavacalculator.UI	panelSub5	javax.swing.JPanel
<simplejavacalculator.UI: javax.swing.JPanel panelSub7>	simplejavacalculator.UI	panelSub7	javax.swing.JPanel
<simplejavacalculator.UI: javax.swing.JButton butAdd>	simplejavacalculator.UI	butAdd	javax.swing.JButton
<simplejavacalculator.UI: javax.swing.JPanel panelSub1>	simplejavacalculator.UI	panelSub1	javax.swing.JPanel
<simplejavacalculator.UI: javax.swing.JFrame frame>	simplejavacalculator.UI	frame	javax.swing.JFrame
<simplejavacalculator.Calculator$MonoOperatorModes: simplejavacalculator.Calculator$MonoOperatorModes rate>	simplejavacalculator.Calculator$MonoOperatorModes	rate	simplejavacalculator.Calculator$MonoOperatorModes
<simplejavacalculator.UI: javax.swing.JButton butSquareRoot>	simplejavacalculator.UI	butSquareRoot	javax.swing.JButton
<simplejavacalculator.UI: javax.swing.JButton butxpowerofy>	simplejavacalculator.UI	butxpowerofy	javax.swing.JButton
<simplejavacalculator.UI: javax.swing.JTextArea text>	simplejavacalculator.UI	text	javax.swing.JTextArea
<simplejavacalculator.UI: javax.swing.JButton butSin>	simplejavacalculator.UI	butSin	javax.swing.JButton
<simplejavacalculator.UI: javax.swing.JPanel panelSub8>	simplejavacalculator.UI	panelSub8	javax.swing.JPanel
<simplejavacalculator.UI: javax.swing.JButton butabs>	simplejavacalculator.UI	butabs	javax.swing.JButton
<simplejavacalculator.UI: javax.swing.JButton butOneDevidedBy>	simplejavacalculator.UI	butOneDevidedBy	javax.swing.JButton
<simplejavacalculator.Calculator$BiOperatorModes: simplejavacalculator.Calculator$BiOperatorModes add>	simplejavacalculator.Calculator$BiOperatorModes	add	simplejavacalculator.Calculator$BiOperatorModes
<java.lang.System: java.io.PrintStream err>	java.lang.System	err	java.io.PrintStream
<simplejavacalculator.Calculator$MonoOperatorModes: simplejavacalculator.Calculator$MonoOperatorModes[] $VALUES>	simplejavacalculator.Calculator$MonoOperatorModes	$VALUES	simplejavacalculator.Calculator$MonoOperatorModes[]
<simplejavacalculator.UI: javax.swing.JButton butMinus>	simplejavacalculator.UI	butMinus	javax.swing.JButton
<simplejavacalculator.UI: java.lang.String[] buttonValue>	simplejavacalculator.UI	buttonValue	java.lang.String[]
<simplejavacalculator.UI: javax.swing.JButton butBinary>	simplejavacalculator.UI	butBinary	javax.swing.JButton
