<simplejavacalculator.UI: void init()>/assign/55	<simplejavacalculator.UI: void init()>/i_$$A_1_$$A_4#_194
<simplejavacalculator.UI: void actionPerformed(java.awt.event.ActionEvent)>/assign/28	<simplejavacalculator.UI: void actionPerformed(java.awt.event.ActionEvent)>/this#_0
<simplejavacalculator.UI: void actionPerformed(java.awt.event.ActionEvent)>/assign/3	<simplejavacalculator.UI: void actionPerformed(java.awt.event.ActionEvent)>/$stack4
<simplejavacalculator.UI: java.lang.Double reader()>/assign/4	<simplejavacalculator.UI: java.lang.Double reader()>/$stack5
<simplejavacalculator.UI: void actionPerformed(java.awt.event.ActionEvent)>/assign/59	<simplejavacalculator.UI: void actionPerformed(java.awt.event.ActionEvent)>/source#_220
<simplejavacalculator.UI: void actionPerformed(java.awt.event.ActionEvent)>/assign/20	<simplejavacalculator.UI: void actionPerformed(java.awt.event.ActionEvent)>/this#_0
<simplejavacalculator.UI: void actionPerformed(java.awt.event.ActionEvent)>/assign/11	<simplejavacalculator.UI: void actionPerformed(java.awt.event.ActionEvent)>/source#_220
<simplejavacalculator.UI: void actionPerformed(java.awt.event.ActionEvent)>/assign/72	<simplejavacalculator.UI: void actionPerformed(java.awt.event.ActionEvent)>/this#_0
<simplejavacalculator.UI: void actionPerformed(java.awt.event.ActionEvent)>/assign/24	<simplejavacalculator.UI: void actionPerformed(java.awt.event.ActionEvent)>/this#_0
<simplejavacalculator.UI: void parsetoBinary()>/assign/0	<simplejavacalculator.UI: void parsetoBinary()>/@this
<simplejavacalculator.UI: void actionPerformed(java.awt.event.ActionEvent)>/assign/48	<simplejavacalculator.UI: void actionPerformed(java.awt.event.ActionEvent)>/this#_0
<simplejavacalculator.UI: void actionPerformed(java.awt.event.ActionEvent)>/assign/15	<simplejavacalculator.UI: void actionPerformed(java.awt.event.ActionEvent)>/source#_220
<simplejavacalculator.UI: void actionPerformed(java.awt.event.ActionEvent)>/assign/12	<simplejavacalculator.UI: void actionPerformed(java.awt.event.ActionEvent)>/this#_0
<simplejavacalculator.UI: void actionPerformed(java.awt.event.ActionEvent)>/assign/52	<simplejavacalculator.UI: void actionPerformed(java.awt.event.ActionEvent)>/this#_0
<simplejavacalculator.UI: void actionPerformed(java.awt.event.ActionEvent)>/assign/55	<simplejavacalculator.UI: void actionPerformed(java.awt.event.ActionEvent)>/source#_220
<simplejavacalculator.UI: void actionPerformed(java.awt.event.ActionEvent)>/assign/19	<simplejavacalculator.UI: void actionPerformed(java.awt.event.ActionEvent)>/source#_220
<simplejavacalculator.UI: void actionPerformed(java.awt.event.ActionEvent)>/assign/71	<simplejavacalculator.UI: void actionPerformed(java.awt.event.ActionEvent)>/this#_0
<simplejavacalculator.UI: void actionPerformed(java.awt.event.ActionEvent)>/assign/67	<simplejavacalculator.UI: void actionPerformed(java.awt.event.ActionEvent)>/source#_220
<simplejavacalculator.UI: void actionPerformed(java.awt.event.ActionEvent)>/phi-assign/0	<simplejavacalculator.UI: void actionPerformed(java.awt.event.ActionEvent)>/i_$$A_1#_222
<simplejavacalculator.UI: void actionPerformed(java.awt.event.ActionEvent)>/assign/27	<simplejavacalculator.UI: void actionPerformed(java.awt.event.ActionEvent)>/source#_220
<simplejavacalculator.UI: void actionPerformed(java.awt.event.ActionEvent)>/assign/44	<simplejavacalculator.UI: void actionPerformed(java.awt.event.ActionEvent)>/this#_0
<simplejavacalculator.Calculator: java.lang.Double calculateEqual(java.lang.Double)>/assign/0	<simplejavacalculator.Calculator: java.lang.Double calculateEqual(java.lang.Double)>/@this
<simplejavacalculator.UI: void actionPerformed(java.awt.event.ActionEvent)>/assign/31	<simplejavacalculator.UI: void actionPerformed(java.awt.event.ActionEvent)>/source#_220
<simplejavacalculator.UI: void actionPerformed(java.awt.event.ActionEvent)>/assign/23	<simplejavacalculator.UI: void actionPerformed(java.awt.event.ActionEvent)>/source#_220
<simplejavacalculator.UI: void init()>/assign/0	<simplejavacalculator.UI: void init()>/@this
<simplejavacalculator.Calculator: java.lang.Double calculateBi(simplejavacalculator.Calculator$BiOperatorModes,java.lang.Double)>/assign/2	<simplejavacalculator.Calculator: java.lang.Double calculateBi(simplejavacalculator.Calculator$BiOperatorModes,java.lang.Double)>/@parameter1
<simplejavacalculator.Calculator$MonoOperatorModes: void <init>(java.lang.String,int)>/assign/2	<simplejavacalculator.Calculator$MonoOperatorModes: void <init>(java.lang.String,int)>/@parameter1
<simplejavacalculator.UI: void actionPerformed(java.awt.event.ActionEvent)>/assign/36	<simplejavacalculator.UI: void actionPerformed(java.awt.event.ActionEvent)>/this#_0
<simplejavacalculator.Calculator: void <init>()>/assign/0	<simplejavacalculator.Calculator: void <init>()>/@this
<simplejavacalculator.UI: void actionPerformed(java.awt.event.ActionEvent)>/assign/70	<simplejavacalculator.UI: void actionPerformed(java.awt.event.ActionEvent)>/source#_220
<simplejavacalculator.UI: void actionPerformed(java.awt.event.ActionEvent)>/assign/68	<simplejavacalculator.UI: void actionPerformed(java.awt.event.ActionEvent)>/this#_0
<simplejavacalculator.UI: void actionPerformed(java.awt.event.ActionEvent)>/assign/60	<simplejavacalculator.UI: void actionPerformed(java.awt.event.ActionEvent)>/this#_0
<simplejavacalculator.Calculator: java.lang.Double calculateMono(simplejavacalculator.Calculator$MonoOperatorModes,java.lang.Double)>/assign/0	<simplejavacalculator.Calculator: java.lang.Double calculateMono(simplejavacalculator.Calculator$MonoOperatorModes,java.lang.Double)>/@this
<simplejavacalculator.UI: void actionPerformed(java.awt.event.ActionEvent)>/assign/1	<simplejavacalculator.UI: void actionPerformed(java.awt.event.ActionEvent)>/@parameter0
<simplejavacalculator.Calculator$BiOperatorModes: void <init>(java.lang.String,int)>/assign/2	<simplejavacalculator.Calculator$BiOperatorModes: void <init>(java.lang.String,int)>/@parameter1
<simplejavacalculator.UI: void init()>/phi-assign/1	<simplejavacalculator.UI: void init()>/i_$$A_1_$$A_2#_122
<simplejavacalculator.UI: void parsetoBinary()>/assign/9	<simplejavacalculator.UI: void parsetoBinary()>/$stack11
<simplejavacalculator.UI: void actionPerformed(java.awt.event.ActionEvent)>/assign/51	<simplejavacalculator.UI: void actionPerformed(java.awt.event.ActionEvent)>/source#_220
<simplejavacalculator.UI: void actionPerformed(java.awt.event.ActionEvent)>/assign/35	<simplejavacalculator.UI: void actionPerformed(java.awt.event.ActionEvent)>/source#_220
<simplejavacalculator.UI: void init()>/assign/4	<simplejavacalculator.UI: void init()>/i_$$A_1_$$A_1#_123
<simplejavacalculator.UI: void actionPerformed(java.awt.event.ActionEvent)>/assign/64	<simplejavacalculator.UI: void actionPerformed(java.awt.event.ActionEvent)>/this#_0
<simplejavacalculator.UI: void init()>/phi-assign/0	<simplejavacalculator.UI: void init()>/i_$$A_1#_122
<simplejavacalculator.UI: void <init>()>/assign/0	<simplejavacalculator.UI: void <init>()>/@this
<simplejavacalculator.Calculator: java.lang.Double reset()>/assign/0	<simplejavacalculator.Calculator: java.lang.Double reset()>/@this
<simplejavacalculator.Calculator: java.lang.Double calculateBi(simplejavacalculator.Calculator$BiOperatorModes,java.lang.Double)>/assign/0	<simplejavacalculator.Calculator: java.lang.Double calculateBi(simplejavacalculator.Calculator$BiOperatorModes,java.lang.Double)>/@this
<simplejavacalculator.UI: void actionPerformed(java.awt.event.ActionEvent)>/assign/40	<simplejavacalculator.UI: void actionPerformed(java.awt.event.ActionEvent)>/this#_0
<simplejavacalculator.UI: void actionPerformed(java.awt.event.ActionEvent)>/assign/0	<simplejavacalculator.UI: void actionPerformed(java.awt.event.ActionEvent)>/@this
<simplejavacalculator.Calculator$BiOperatorModes: simplejavacalculator.Calculator$BiOperatorModes valueOf(java.lang.String)>/assign/0	<simplejavacalculator.Calculator$BiOperatorModes: simplejavacalculator.Calculator$BiOperatorModes valueOf(java.lang.String)>/@parameter0
<simplejavacalculator.UI: void actionPerformed(java.awt.event.ActionEvent)>/assign/63	<simplejavacalculator.UI: void actionPerformed(java.awt.event.ActionEvent)>/source#_220
<simplejavacalculator.UI: void actionPerformed(java.awt.event.ActionEvent)>/assign/39	<simplejavacalculator.UI: void actionPerformed(java.awt.event.ActionEvent)>/source#_220
<simplejavacalculator.UI: void init()>/phi-assign/3	<simplejavacalculator.UI: void init()>/i_$$A_1_$$A_5#_193
<simplejavacalculator.Calculator: java.lang.Double calculateMono(simplejavacalculator.Calculator$MonoOperatorModes,java.lang.Double)>/assign/2	<simplejavacalculator.Calculator: java.lang.Double calculateMono(simplejavacalculator.Calculator$MonoOperatorModes,java.lang.Double)>/@parameter1
<simplejavacalculator.Calculator$MonoOperatorModes: simplejavacalculator.Calculator$MonoOperatorModes valueOf(java.lang.String)>/assign/0	<simplejavacalculator.Calculator$MonoOperatorModes: simplejavacalculator.Calculator$MonoOperatorModes valueOf(java.lang.String)>/@parameter0
<simplejavacalculator.UI: void actionPerformed(java.awt.event.ActionEvent)>/assign/16	<simplejavacalculator.UI: void actionPerformed(java.awt.event.ActionEvent)>/this#_0
<simplejavacalculator.UI: void actionPerformed(java.awt.event.ActionEvent)>/assign/32	<simplejavacalculator.UI: void actionPerformed(java.awt.event.ActionEvent)>/this#_0
<simplejavacalculator.Calculator: java.lang.Double calculateBi(simplejavacalculator.Calculator$BiOperatorModes,java.lang.Double)>/assign/1	<simplejavacalculator.Calculator: java.lang.Double calculateBi(simplejavacalculator.Calculator$BiOperatorModes,java.lang.Double)>/@parameter0
<simplejavacalculator.UI: void actionPerformed(java.awt.event.ActionEvent)>/assign/43	<simplejavacalculator.UI: void actionPerformed(java.awt.event.ActionEvent)>/source#_220
<simplejavacalculator.Calculator$BiOperatorModes: void <init>(java.lang.String,int)>/assign/0	<simplejavacalculator.Calculator$BiOperatorModes: void <init>(java.lang.String,int)>/@this
<simplejavacalculator.Calculator: java.lang.Double calculateMono(simplejavacalculator.Calculator$MonoOperatorModes,java.lang.Double)>/assign/34	<simplejavacalculator.Calculator: java.lang.Double calculateMono(simplejavacalculator.Calculator$MonoOperatorModes,java.lang.Double)>/num#_0
<simplejavacalculator.Calculator: java.lang.Double calculateEqual(java.lang.Double)>/assign/1	<simplejavacalculator.Calculator: java.lang.Double calculateEqual(java.lang.Double)>/@parameter0
<simplejavacalculator.UI: void actionPerformed(java.awt.event.ActionEvent)>/assign/56	<simplejavacalculator.UI: void actionPerformed(java.awt.event.ActionEvent)>/this#_0
<simplejavacalculator.UI: void init()>/phi-assign/2	<simplejavacalculator.UI: void init()>/i_$$A_1_$$A_3#_193
<simplejavacalculator.Calculator: java.lang.Double calculateBiImpl()>/assign/0	<simplejavacalculator.Calculator: java.lang.Double calculateBiImpl()>/@this
<simplejavacalculator.SimpleJavaCalculator: void <init>()>/assign/0	<simplejavacalculator.SimpleJavaCalculator: void <init>()>/@this
<simplejavacalculator.Calculator$MonoOperatorModes: void <init>(java.lang.String,int)>/assign/0	<simplejavacalculator.Calculator$MonoOperatorModes: void <init>(java.lang.String,int)>/@this
<simplejavacalculator.SimpleJavaCalculator: void main(java.lang.String[])>/assign/2	<simplejavacalculator.SimpleJavaCalculator: void main(java.lang.String[])>/$stack2
<simplejavacalculator.UI: java.lang.Double reader()>/assign/0	<simplejavacalculator.UI: java.lang.Double reader()>/@this
<simplejavacalculator.UI: void actionPerformed(java.awt.event.ActionEvent)>/assign/6	<simplejavacalculator.UI: void actionPerformed(java.awt.event.ActionEvent)>/i_$$A_1_$$A_1#_223
<simplejavacalculator.Calculator$BiOperatorModes: void <init>(java.lang.String,int)>/assign/1	<simplejavacalculator.Calculator$BiOperatorModes: void <init>(java.lang.String,int)>/@parameter0
<simplejavacalculator.UI: void actionPerformed(java.awt.event.ActionEvent)>/phi-assign/1	<simplejavacalculator.UI: void actionPerformed(java.awt.event.ActionEvent)>/i_$$A_1_$$A_2#_222
<simplejavacalculator.UI: void <init>()>/assign/28	<simplejavacalculator.UI: void <init>()>/i_$$A_1_$$A_1#_87
<simplejavacalculator.UI: void <init>()>/phi-assign/1	<simplejavacalculator.UI: void <init>()>/i_$$A_1_$$A_2#_86
<simplejavacalculator.Calculator$MonoOperatorModes: void <init>(java.lang.String,int)>/assign/1	<simplejavacalculator.Calculator$MonoOperatorModes: void <init>(java.lang.String,int)>/@parameter0
<simplejavacalculator.UI: void <init>()>/phi-assign/0	<simplejavacalculator.UI: void <init>()>/i_$$A_1#_86
<simplejavacalculator.UI: java.lang.Double reader()>/assign/2	<simplejavacalculator.UI: java.lang.Double reader()>/$stack4
<simplejavacalculator.UI: void actionPerformed(java.awt.event.ActionEvent)>/assign/47	<simplejavacalculator.UI: void actionPerformed(java.awt.event.ActionEvent)>/source#_220
<simplejavacalculator.UI: void writer(java.lang.Double)>/assign/0	<simplejavacalculator.UI: void writer(java.lang.Double)>/@this
<simplejavacalculator.UI: void writer(java.lang.Double)>/assign/1	<simplejavacalculator.UI: void writer(java.lang.Double)>/@parameter0
<simplejavacalculator.SimpleJavaCalculator: void main(java.lang.String[])>/assign/0	<simplejavacalculator.SimpleJavaCalculator: void main(java.lang.String[])>/@parameter0
<simplejavacalculator.Calculator: java.lang.Double calculateMono(simplejavacalculator.Calculator$MonoOperatorModes,java.lang.Double)>/assign/1	<simplejavacalculator.Calculator: java.lang.Double calculateMono(simplejavacalculator.Calculator$MonoOperatorModes,java.lang.Double)>/@parameter0
