<simplejavacalculator.UI: void init()>/read-field-font/2	<simplejavacalculator.UI: void init()>/$stack15
<simplejavacalculator.UI: void init()>/read-field-butEqual/1	<simplejavacalculator.UI: void init()>/$stack119
<simplejavacalculator.UI: void init()>/read-field-panelSub3/2	<simplejavacalculator.UI: void init()>/$stack90
<simplejavacalculator.UI: void init()>/read-field-butabs/1	<simplejavacalculator.UI: void init()>/$stack171
<simplejavacalculator.UI: void init()>/read-field-panelSub3/4	<simplejavacalculator.UI: void init()>/$stack96
<simplejavacalculator.UI: void init()>/read-field-panelSub4/4	<simplejavacalculator.UI: void init()>/$stack120
<simplejavacalculator.UI: void init()>/read-field-butDivide/0	<simplejavacalculator.UI: void init()>/$stack20
<simplejavacalculator.UI: void init()>/read-field-font/15	<simplejavacalculator.UI: void init()>/$stack41
<simplejavacalculator.UI: void actionPerformed(java.awt.event.ActionEvent)>/read-field-butMinus/0	<simplejavacalculator.UI: void actionPerformed(java.awt.event.ActionEvent)>/$stack6
<simplejavacalculator.UI: void init()>/read-field-frame/6	<simplejavacalculator.UI: void init()>/$stack200
<simplejavacalculator.UI: void actionPerformed(java.awt.event.ActionEvent)>/read-field-butCancel/0	<simplejavacalculator.UI: void actionPerformed(java.awt.event.ActionEvent)>/$stack20
<simplejavacalculator.UI: void init()>/read-field-butTan/0	<simplejavacalculator.UI: void init()>/$stack34
<simplejavacalculator.UI: void actionPerformed(java.awt.event.ActionEvent)>/read-field-calc/3	<simplejavacalculator.UI: void actionPerformed(java.awt.event.ActionEvent)>/$stack93
<simplejavacalculator.UI: void init()>/read-field-butAdd/0	<simplejavacalculator.UI: void init()>/$stack14
<simplejavacalculator.UI: void init()>/read-field-font/12	<simplejavacalculator.UI: void init()>/$stack35
<simplejavacalculator.UI: void init()>/read-field-panelSub2/1	<simplejavacalculator.UI: void init()>/$stack62
<simplejavacalculator.UI: void init()>/read-field-frame/3	<simplejavacalculator.UI: void init()>/$stack5
<simplejavacalculator.UI: void init()>/read-field-panel/7	<simplejavacalculator.UI: void init()>/$stack163
<simplejavacalculator.UI: void init()>/read-field-panelSub3/6	<simplejavacalculator.UI: void init()>/$stack101
<simplejavacalculator.UI: void init()>/read-field-frame/5	<simplejavacalculator.UI: void init()>/$stack8
<simplejavacalculator.UI: void init()>/read-field-frame/2	<simplejavacalculator.UI: void init()>/$stack4
<simplejavacalculator.UI: void init()>/read-field-panel/4	<simplejavacalculator.UI: void init()>/$stack126
<simplejavacalculator.UI: void init()>/read-field-panelSub4/5	<simplejavacalculator.UI: void init()>/$stack123
<simplejavacalculator.UI: void init()>/read-field-butrate/1	<simplejavacalculator.UI: void init()>/$stack168
<simplejavacalculator.UI: void init()>/read-field-frame/4	<simplejavacalculator.UI: void init()>/$stack6
<simplejavacalculator.UI: void init()>/read-field-butBinary/0	<simplejavacalculator.UI: void init()>/$stack46
<simplejavacalculator.UI: void actionPerformed(java.awt.event.ActionEvent)>/read-field-but/0	<simplejavacalculator.UI: void actionPerformed(java.awt.event.ActionEvent)>/$stack117
<simplejavacalculator.UI: void init()>/read-field-font/4	<simplejavacalculator.UI: void init()>/$stack19
<simplejavacalculator.Calculator: java.lang.Double calculateBi(simplejavacalculator.Calculator$BiOperatorModes,java.lang.Double)>/read-field-num1/0	<simplejavacalculator.Calculator: java.lang.Double calculateBi(simplejavacalculator.Calculator$BiOperatorModes,java.lang.Double)>/$stack6
<simplejavacalculator.UI: void init()>/read-field-font/9	<simplejavacalculator.UI: void init()>/$stack29
<simplejavacalculator.UI: void init()>/read-field-panel/8	<simplejavacalculator.UI: void init()>/$stack178
<simplejavacalculator.UI: void init()>/read-field-but/10	<simplejavacalculator.UI: void init()>/$stack128
<simplejavacalculator.UI: void init()>/read-field-but/11	<simplejavacalculator.UI: void init()>/$stack180
<simplejavacalculator.UI: void init()>/read-field-panelSub4/0	<simplejavacalculator.UI: void init()>/$stack106
<simplejavacalculator.UI: void init()>/read-field-panelSub5/0	<simplejavacalculator.UI: void init()>/$stack130
<simplejavacalculator.UI: void init()>/read-field-panel/6	<simplejavacalculator.UI: void init()>/$stack151
<simplejavacalculator.UI: void init()>/read-field-panelSub2/4	<simplejavacalculator.UI: void init()>/$stack72
<simplejavacalculator.UI: void init()>/read-field-panelSub8/1	<simplejavacalculator.UI: void init()>/$stack169
<simplejavacalculator.UI: void actionPerformed(java.awt.event.ActionEvent)>/read-field-buttonValue/0	<simplejavacalculator.UI: void actionPerformed(java.awt.event.ActionEvent)>/$stack121
<simplejavacalculator.UI: void init()>/read-field-panelSub4/6	<simplejavacalculator.UI: void init()>/$stack125
<simplejavacalculator.UI: void actionPerformed(java.awt.event.ActionEvent)>/read-field-calc/13	<simplejavacalculator.UI: void actionPerformed(java.awt.event.ActionEvent)>/$stack33
<simplejavacalculator.UI: void actionPerformed(java.awt.event.ActionEvent)>/read-field-butxpowerofy/0	<simplejavacalculator.UI: void actionPerformed(java.awt.event.ActionEvent)>/$stack9
<simplejavacalculator.UI: void init()>/read-field-panel/3	<simplejavacalculator.UI: void init()>/$stack102
<simplejavacalculator.UI: void init()>/read-field-panelSub6/3	<simplejavacalculator.UI: void init()>/$stack148
<simplejavacalculator.UI: void init()>/read-field-butAdd/2	<simplejavacalculator.UI: void init()>/$stack182
<simplejavacalculator.UI: void actionPerformed(java.awt.event.ActionEvent)>/read-field-butabs/0	<simplejavacalculator.UI: void actionPerformed(java.awt.event.ActionEvent)>/$stack18
<simplejavacalculator.UI: void init()>/read-field-panelSub3/3	<simplejavacalculator.UI: void init()>/$stack92
<simplejavacalculator.UI: void init()>/read-field-but/4	<simplejavacalculator.UI: void init()>/$stack80
<simplejavacalculator.UI: void init()>/read-field-butCancel/1	<simplejavacalculator.UI: void init()>/$stack122
<simplejavacalculator.UI: void init()>/read-field-butMinus/1	<simplejavacalculator.UI: void init()>/$stack74
<simplejavacalculator.UI: void init()>/read-field-but/8	<simplejavacalculator.UI: void init()>/$stack108
<simplejavacalculator.UI: void init()>/read-field-font/1	<simplejavacalculator.UI: void init()>/$stack13
<simplejavacalculator.UI: void init()>/read-field-panelSub3/1	<simplejavacalculator.UI: void init()>/$stack86
<simplejavacalculator.UI: void init()>/read-field-butSquareRoot/1	<simplejavacalculator.UI: void init()>/$stack141
<simplejavacalculator.UI: void actionPerformed(java.awt.event.ActionEvent)>/read-field-calc/15	<simplejavacalculator.UI: void actionPerformed(java.awt.event.ActionEvent)>/$stack24
<simplejavacalculator.UI: void init()>/read-field-panelSub3/5	<simplejavacalculator.UI: void init()>/$stack99
<simplejavacalculator.UI: void init()>/read-field-font/8	<simplejavacalculator.UI: void init()>/$stack27
<simplejavacalculator.UI: void init()>/read-field-butMultiply/1	<simplejavacalculator.UI: void init()>/$stack95
<simplejavacalculator.UI: void init()>/read-field-but/0	<simplejavacalculator.UI: void init()>/$stack206
<simplejavacalculator.UI: void actionPerformed(java.awt.event.ActionEvent)>/read-field-butMultiply/0	<simplejavacalculator.UI: void actionPerformed(java.awt.event.ActionEvent)>/$stack7
<simplejavacalculator.UI: void init()>/read-field-but/12	<simplejavacalculator.UI: void init()>/$stack202
<simplejavacalculator.UI: void init()>/read-field-butDivide/1	<simplejavacalculator.UI: void init()>/$stack98
<simplejavacalculator.UI: void init()>/read-field-font/10	<simplejavacalculator.UI: void init()>/$stack31
<simplejavacalculator.UI: void init()>/read-field-butlog/0	<simplejavacalculator.UI: void init()>/$stack38
<simplejavacalculator.UI: void actionPerformed(java.awt.event.ActionEvent)>/read-field-calc/12	<simplejavacalculator.UI: void actionPerformed(java.awt.event.ActionEvent)>/$stack39
<simplejavacalculator.UI: void actionPerformed(java.awt.event.ActionEvent)>/read-field-calc/4	<simplejavacalculator.UI: void actionPerformed(java.awt.event.ActionEvent)>/$stack87
<simplejavacalculator.UI: void actionPerformed(java.awt.event.ActionEvent)>/read-field-calc/14	<simplejavacalculator.UI: void actionPerformed(java.awt.event.ActionEvent)>/$stack28
<simplejavacalculator.UI: void init()>/read-field-panel/9	<simplejavacalculator.UI: void init()>/$stack199
<simplejavacalculator.UI: void actionPerformed(java.awt.event.ActionEvent)>/read-field-calc/10	<simplejavacalculator.UI: void actionPerformed(java.awt.event.ActionEvent)>/$stack51
<simplejavacalculator.UI: void <init>()>/read-field-but/0	<simplejavacalculator.UI: void <init>()>/$stack48
<simplejavacalculator.UI: void actionPerformed(java.awt.event.ActionEvent)>/read-field-calc/11	<simplejavacalculator.UI: void actionPerformed(java.awt.event.ActionEvent)>/$stack45
<simplejavacalculator.UI: void init()>/read-field-but/9	<simplejavacalculator.UI: void init()>/$stack112
<simplejavacalculator.UI: void init()>/read-field-butAdd/1	<simplejavacalculator.UI: void init()>/$stack71
<simplejavacalculator.UI: void init()>/read-field-butTan/1	<simplejavacalculator.UI: void init()>/$stack159
<simplejavacalculator.UI: void init()>/read-field-panelSub8/0	<simplejavacalculator.UI: void init()>/$stack166
<simplejavacalculator.UI: void init()>/read-field-but/6	<simplejavacalculator.UI: void init()>/$stack88
<simplejavacalculator.UI: void init()>/read-field-panelSub2/6	<simplejavacalculator.UI: void init()>/$stack77
<simplejavacalculator.UI: void init()>/read-field-panelSub6/4	<simplejavacalculator.UI: void init()>/$stack150
<simplejavacalculator.UI: void init()>/read-field-butCancel/0	<simplejavacalculator.UI: void init()>/$stack44
<simplejavacalculator.UI: void actionPerformed(java.awt.event.ActionEvent)>/read-field-butrate/0	<simplejavacalculator.UI: void actionPerformed(java.awt.event.ActionEvent)>/$stack17
<simplejavacalculator.UI: void init()>/read-field-font/3	<simplejavacalculator.UI: void init()>/$stack17
<simplejavacalculator.UI: void init()>/read-field-panelSub8/4	<simplejavacalculator.UI: void init()>/$stack177
<simplejavacalculator.UI: void init()>/read-field-frame/0	<simplejavacalculator.UI: void init()>/$stack2
<simplejavacalculator.UI: void init()>/read-field-panelSub2/0	<simplejavacalculator.UI: void init()>/$stack58
<simplejavacalculator.UI: void init()>/read-field-panelSub4/2	<simplejavacalculator.UI: void init()>/$stack114
<simplejavacalculator.UI: void actionPerformed(java.awt.event.ActionEvent)>/read-field-calc/2	<simplejavacalculator.UI: void actionPerformed(java.awt.event.ActionEvent)>/$stack99
<simplejavacalculator.UI: void init()>/read-field-panelSub4/3	<simplejavacalculator.UI: void init()>/$stack116
<simplejavacalculator.UI: void init()>/read-field-but/5	<simplejavacalculator.UI: void init()>/$stack84
<simplejavacalculator.UI: void init()>/read-field-butEqual/0	<simplejavacalculator.UI: void init()>/$stack22
<simplejavacalculator.UI: void init()>/read-field-butlog/1	<simplejavacalculator.UI: void init()>/$stack165
<simplejavacalculator.UI: void actionPerformed(java.awt.event.ActionEvent)>/read-field-calc/6	<simplejavacalculator.UI: void actionPerformed(java.awt.event.ActionEvent)>/$stack75
<simplejavacalculator.UI: void init()>/read-field-panel/2	<simplejavacalculator.UI: void init()>/$stack78
<simplejavacalculator.UI: void actionPerformed(java.awt.event.ActionEvent)>/read-field-butEqual/0	<simplejavacalculator.UI: void actionPerformed(java.awt.event.ActionEvent)>/$stack19
<simplejavacalculator.UI: void actionPerformed(java.awt.event.ActionEvent)>/read-field-calc/1	<simplejavacalculator.UI: void actionPerformed(java.awt.event.ActionEvent)>/$stack105
<simplejavacalculator.UI: void init()>/read-field-butxpowerofy/1	<simplejavacalculator.UI: void init()>/$stack147
<simplejavacalculator.UI: void init()>/read-field-butCancel/2	<simplejavacalculator.UI: void init()>/$stack198
<simplejavacalculator.UI: void init()>/read-field-butCos/2	<simplejavacalculator.UI: void init()>/$stack189
<simplejavacalculator.UI: void init()>/read-field-font/16	<simplejavacalculator.UI: void init()>/$stack43
<simplejavacalculator.UI: void init()>/read-field-font/14	<simplejavacalculator.UI: void init()>/$stack39
<simplejavacalculator.UI: void init()>/read-field-panelSub7/2	<simplejavacalculator.UI: void init()>/$stack160
<simplejavacalculator.UI: void init()>/read-field-butSin/1	<simplejavacalculator.UI: void init()>/$stack156
<simplejavacalculator.UI: void init()>/read-field-font/17	<simplejavacalculator.UI: void init()>/$stack45
<simplejavacalculator.UI: void init()>/read-field-butMultiply/2	<simplejavacalculator.UI: void init()>/$stack184
<simplejavacalculator.UI: void actionPerformed(java.awt.event.ActionEvent)>/read-field-butBinary/0	<simplejavacalculator.UI: void actionPerformed(java.awt.event.ActionEvent)>/$stack21
<simplejavacalculator.Calculator: java.lang.Double calculateBiImpl()>/read-field-mode/5	<simplejavacalculator.Calculator: java.lang.Double calculateBiImpl()>/$stack12
<simplejavacalculator.Calculator: java.lang.Double calculateBiImpl()>/read-field-num2/6	<simplejavacalculator.Calculator: java.lang.Double calculateBiImpl()>/$stack16
<simplejavacalculator.UI: void actionPerformed(java.awt.event.ActionEvent)>/read-field-butlog/0	<simplejavacalculator.UI: void actionPerformed(java.awt.event.ActionEvent)>/$stack16
<simplejavacalculator.UI: void actionPerformed(java.awt.event.ActionEvent)>/read-field-calc/9	<simplejavacalculator.UI: void actionPerformed(java.awt.event.ActionEvent)>/$stack57
<simplejavacalculator.UI: void init()>/read-field-butTan/2	<simplejavacalculator.UI: void init()>/$stack191
<simplejavacalculator.Calculator: java.lang.Double calculateBiImpl()>/read-field-num1/3	<simplejavacalculator.Calculator: java.lang.Double calculateBiImpl()>/$stack26
<simplejavacalculator.UI: void init()>/read-field-font/5	<simplejavacalculator.UI: void init()>/$stack21
<simplejavacalculator.UI: void init()>/read-field-panelSub2/3	<simplejavacalculator.UI: void init()>/$stack68
<simplejavacalculator.Calculator: java.lang.Double calculateBiImpl()>/read-field-num2/5	<simplejavacalculator.Calculator: java.lang.Double calculateBiImpl()>/$stack22
<simplejavacalculator.UI: void actionPerformed(java.awt.event.ActionEvent)>/read-field-text/0	<simplejavacalculator.UI: void actionPerformed(java.awt.event.ActionEvent)>/$stack123
<simplejavacalculator.UI: void init()>/read-field-image/0	<simplejavacalculator.UI: void init()>/$stack7
<simplejavacalculator.UI: void init()>/read-field-panelSub8/3	<simplejavacalculator.UI: void init()>/$stack175
<simplejavacalculator.UI: void actionPerformed(java.awt.event.ActionEvent)>/read-field-butSin/0	<simplejavacalculator.UI: void actionPerformed(java.awt.event.ActionEvent)>/$stack14
<simplejavacalculator.UI: void actionPerformed(java.awt.event.ActionEvent)>/read-field-butSquareRoot/0	<simplejavacalculator.UI: void actionPerformed(java.awt.event.ActionEvent)>/$stack11
<simplejavacalculator.UI: void init()>/read-field-butSquare/1	<simplejavacalculator.UI: void init()>/$stack138
<simplejavacalculator.UI: void actionPerformed(java.awt.event.ActionEvent)>/read-field-butSquare/0	<simplejavacalculator.UI: void actionPerformed(java.awt.event.ActionEvent)>/$stack10
<simplejavacalculator.UI: void init()>/read-field-panelSub5/2	<simplejavacalculator.UI: void init()>/$stack135
<simplejavacalculator.UI: void init()>/read-field-panelSub7/1	<simplejavacalculator.UI: void init()>/$stack157
<simplejavacalculator.UI: void init()>/read-field-panelSub2/2	<simplejavacalculator.UI: void init()>/$stack66
<simplejavacalculator.UI: void init()>/read-field-but/3	<simplejavacalculator.UI: void init()>/$stack64
<simplejavacalculator.UI: void actionPerformed(java.awt.event.ActionEvent)>/read-field-butTan/0	<simplejavacalculator.UI: void actionPerformed(java.awt.event.ActionEvent)>/$stack15
<simplejavacalculator.Calculator: java.lang.Double calculateBiImpl()>/read-field-num1/2	<simplejavacalculator.Calculator: java.lang.Double calculateBiImpl()>/$stack32
<simplejavacalculator.UI: void init()>/read-field-butOneDevidedBy/0	<simplejavacalculator.UI: void init()>/$stack28
<simplejavacalculator.UI: void init()>/read-field-butSin/2	<simplejavacalculator.UI: void init()>/$stack190
<simplejavacalculator.Calculator: java.lang.Double calculateBiImpl()>/read-field-num1/5	<simplejavacalculator.Calculator: java.lang.Double calculateBiImpl()>/$stack14
<simplejavacalculator.Calculator: java.lang.Double calculateBiImpl()>/read-field-num2/3	<simplejavacalculator.Calculator: java.lang.Double calculateBiImpl()>/$stack34
<simplejavacalculator.UI: void parsetoBinary()>/read-field-text/1	<simplejavacalculator.UI: void parsetoBinary()>/$stack5
<simplejavacalculator.UI: void init()>/read-field-panelSub1/0	<simplejavacalculator.UI: void init()>/$stack51
<simplejavacalculator.Calculator: java.lang.Double calculateBiImpl()>/read-field-mode/0	<simplejavacalculator.Calculator: java.lang.Double calculateBiImpl()>/$stack2
<simplejavacalculator.UI: void init()>/read-field-butSquare/0	<simplejavacalculator.UI: void init()>/$stack26
<simplejavacalculator.UI: void init()>/read-field-panelSub5/1	<simplejavacalculator.UI: void init()>/$stack132
<simplejavacalculator.UI: void init()>/read-field-butlog/2	<simplejavacalculator.UI: void init()>/$stack193
<simplejavacalculator.UI: void init()>/read-field-text/0	<simplejavacalculator.UI: void init()>/$stack11
<simplejavacalculator.UI: void init()>/read-field-but/2	<simplejavacalculator.UI: void init()>/$stack60
<simplejavacalculator.UI: void writer(java.lang.Double)>/read-field-text/1	<simplejavacalculator.UI: void writer(java.lang.Double)>/$stack4
<simplejavacalculator.UI: void init()>/read-field-butCos/1	<simplejavacalculator.UI: void init()>/$stack153
<simplejavacalculator.UI: void init()>/read-field-font/6	<simplejavacalculator.UI: void init()>/$stack23
<simplejavacalculator.Calculator: java.lang.Double calculateBiImpl()>/read-field-num2/4	<simplejavacalculator.Calculator: java.lang.Double calculateBiImpl()>/$stack28
<simplejavacalculator.UI: void init()>/read-field-panelSub4/1	<simplejavacalculator.UI: void init()>/$stack110
<simplejavacalculator.UI: void init()>/read-field-panelSub2/5	<simplejavacalculator.UI: void init()>/$stack75
<simplejavacalculator.UI: void init()>/read-field-panelSub7/0	<simplejavacalculator.UI: void init()>/$stack154
<simplejavacalculator.UI: void init()>/read-field-font/13	<simplejavacalculator.UI: void init()>/$stack37
<simplejavacalculator.UI: void actionPerformed(java.awt.event.ActionEvent)>/read-field-butAdd/0	<simplejavacalculator.UI: void actionPerformed(java.awt.event.ActionEvent)>/$stack5
<simplejavacalculator.Calculator: java.lang.Double calculateBiImpl()>/read-field-num2/0	<simplejavacalculator.Calculator: java.lang.Double calculateBiImpl()>/$stack48
<simplejavacalculator.UI: void init()>/read-field-butSquareRoot/0	<simplejavacalculator.UI: void init()>/$stack24
<simplejavacalculator.Calculator: java.lang.Double calculateBi(simplejavacalculator.Calculator$BiOperatorModes,java.lang.Double)>/read-field-mode/0	<simplejavacalculator.Calculator: java.lang.Double calculateBi(simplejavacalculator.Calculator$BiOperatorModes,java.lang.Double)>/$stack4
<simplejavacalculator.UI: void init()>/read-field-butBinary/1	<simplejavacalculator.UI: void init()>/$stack174
<simplejavacalculator.UI: void init()>/read-field-butMinus/2	<simplejavacalculator.UI: void init()>/$stack183
<simplejavacalculator.Calculator: java.lang.Double calculateBiImpl()>/read-field-mode/4	<simplejavacalculator.Calculator: java.lang.Double calculateBiImpl()>/$stack10
<simplejavacalculator.Calculator: java.lang.Double calculateBiImpl()>/read-field-mode/3	<simplejavacalculator.Calculator: java.lang.Double calculateBiImpl()>/$stack8
<simplejavacalculator.UI: void init()>/read-field-butBinary/2	<simplejavacalculator.UI: void init()>/$stack196
<simplejavacalculator.UI: void init()>/read-field-butMinus/0	<simplejavacalculator.UI: void init()>/$stack16
<simplejavacalculator.UI: void init()>/read-field-butabs/2	<simplejavacalculator.UI: void init()>/$stack195
<simplejavacalculator.UI: void init()>/read-field-text/2	<simplejavacalculator.UI: void init()>/$stack50
<simplejavacalculator.UI: void init()>/read-field-panelSub3/0	<simplejavacalculator.UI: void init()>/$stack82
<simplejavacalculator.UI: void init()>/read-field-font/11	<simplejavacalculator.UI: void init()>/$stack33
<simplejavacalculator.UI: void init()>/read-field-panelSub6/0	<simplejavacalculator.UI: void init()>/$stack139
<simplejavacalculator.UI: void init()>/read-field-butabs/0	<simplejavacalculator.UI: void init()>/$stack42
<simplejavacalculator.UI: void init()>/read-field-but/1	<simplejavacalculator.UI: void init()>/$stack56
<simplejavacalculator.Calculator: java.lang.Double calculateBiImpl()>/read-field-mode/1	<simplejavacalculator.Calculator: java.lang.Double calculateBiImpl()>/$stack4
<simplejavacalculator.UI: void init()>/read-field-but/7	<simplejavacalculator.UI: void init()>/$stack104
<simplejavacalculator.UI: void init()>/read-field-text/1	<simplejavacalculator.UI: void init()>/$stack12
<simplejavacalculator.UI: void writer(java.lang.Double)>/read-field-text/0	<simplejavacalculator.UI: void writer(java.lang.Double)>/$stack7
<simplejavacalculator.UI: void actionPerformed(java.awt.event.ActionEvent)>/read-field-calc/7	<simplejavacalculator.UI: void actionPerformed(java.awt.event.ActionEvent)>/$stack69
<simplejavacalculator.UI: void init()>/read-field-butEqual/2	<simplejavacalculator.UI: void init()>/$stack197
<simplejavacalculator.UI: void init()>/read-field-butrate/0	<simplejavacalculator.UI: void init()>/$stack40
<simplejavacalculator.Calculator: java.lang.Double calculateBiImpl()>/read-field-num1/4	<simplejavacalculator.Calculator: java.lang.Double calculateBiImpl()>/$stack20
<simplejavacalculator.UI: void init()>/read-field-panel/0	<simplejavacalculator.UI: void init()>/$stack47
<simplejavacalculator.UI: void init()>/read-field-panel/5	<simplejavacalculator.UI: void init()>/$stack136
<simplejavacalculator.UI: void init()>/read-field-panel/1	<simplejavacalculator.UI: void init()>/$stack54
<simplejavacalculator.UI: void init()>/read-field-butxpowerofy/2	<simplejavacalculator.UI: void init()>/$stack192
<simplejavacalculator.UI: void actionPerformed(java.awt.event.ActionEvent)>/read-field-calc/8	<simplejavacalculator.UI: void actionPerformed(java.awt.event.ActionEvent)>/$stack63
<simplejavacalculator.Calculator: java.lang.Double calculateBiImpl()>/read-field-num1/0	<simplejavacalculator.Calculator: java.lang.Double calculateBiImpl()>/$stack42
<simplejavacalculator.UI: void init()>/read-field-panelSub7/3	<simplejavacalculator.UI: void init()>/$stack162
<simplejavacalculator.UI: void actionPerformed(java.awt.event.ActionEvent)>/read-field-text/1	<simplejavacalculator.UI: void actionPerformed(java.awt.event.ActionEvent)>/$stack22
<simplejavacalculator.UI: void init()>/read-field-textFont/0	<simplejavacalculator.UI: void init()>/$stack10
<simplejavacalculator.UI: void <init>()>/read-field-panel/1	<simplejavacalculator.UI: void <init>()>/$stack7
<simplejavacalculator.UI: void init()>/read-field-frame/1	<simplejavacalculator.UI: void init()>/$stack3
<simplejavacalculator.UI: void init()>/read-field-panelSub6/2	<simplejavacalculator.UI: void init()>/$stack145
<simplejavacalculator.UI: void init()>/read-field-panelSub6/1	<simplejavacalculator.UI: void init()>/$stack142
<simplejavacalculator.UI: void init()>/read-field-panelSub8/2	<simplejavacalculator.UI: void init()>/$stack172
<simplejavacalculator.UI: java.lang.Double reader()>/read-field-text/0	<simplejavacalculator.UI: java.lang.Double reader()>/$stack3
<simplejavacalculator.UI: void init()>/read-field-butCos/0	<simplejavacalculator.UI: void init()>/$stack30
<simplejavacalculator.Calculator: java.lang.Double calculateBiImpl()>/read-field-num2/1	<simplejavacalculator.Calculator: java.lang.Double calculateBiImpl()>/$stack38
<simplejavacalculator.UI: void init()>/read-field-butSquareRoot/2	<simplejavacalculator.UI: void init()>/$stack187
<simplejavacalculator.UI: void actionPerformed(java.awt.event.ActionEvent)>/read-field-butDivide/0	<simplejavacalculator.UI: void actionPerformed(java.awt.event.ActionEvent)>/$stack8
<simplejavacalculator.UI: void init()>/read-field-butSin/0	<simplejavacalculator.UI: void init()>/$stack32
<simplejavacalculator.UI: void actionPerformed(java.awt.event.ActionEvent)>/read-field-butCos/0	<simplejavacalculator.UI: void actionPerformed(java.awt.event.ActionEvent)>/$stack13
<simplejavacalculator.UI: void init()>/read-field-panelSub1/1	<simplejavacalculator.UI: void init()>/$stack53
<simplejavacalculator.UI: void init()>/read-field-butSquare/2	<simplejavacalculator.UI: void init()>/$stack186
<simplejavacalculator.UI: void init()>/read-field-font/0	<simplejavacalculator.UI: void init()>/$stack207
<simplejavacalculator.UI: void init()>/read-field-butMultiply/0	<simplejavacalculator.UI: void init()>/$stack18
<simplejavacalculator.Calculator: java.lang.Double calculateBiImpl()>/read-field-num1/1	<simplejavacalculator.Calculator: java.lang.Double calculateBiImpl()>/$stack41
<simplejavacalculator.Calculator: java.lang.Double calculateBiImpl()>/read-field-mode/2	<simplejavacalculator.Calculator: java.lang.Double calculateBiImpl()>/$stack6
<simplejavacalculator.UI: void init()>/read-field-font/7	<simplejavacalculator.UI: void init()>/$stack25
<simplejavacalculator.Calculator: java.lang.Double calculateBiImpl()>/read-field-num2/2	<simplejavacalculator.Calculator: java.lang.Double calculateBiImpl()>/$stack44
<simplejavacalculator.UI: void init()>/read-field-butDivide/2	<simplejavacalculator.UI: void init()>/$stack185
<simplejavacalculator.UI: void actionPerformed(java.awt.event.ActionEvent)>/read-field-butOneDevidedBy/0	<simplejavacalculator.UI: void actionPerformed(java.awt.event.ActionEvent)>/$stack12
<simplejavacalculator.UI: void init()>/read-field-butOneDevidedBy/2	<simplejavacalculator.UI: void init()>/$stack188
<simplejavacalculator.UI: void actionPerformed(java.awt.event.ActionEvent)>/read-field-calc/0	<simplejavacalculator.UI: void actionPerformed(java.awt.event.ActionEvent)>/$stack111
<simplejavacalculator.UI: void actionPerformed(java.awt.event.ActionEvent)>/read-field-calc/5	<simplejavacalculator.UI: void actionPerformed(java.awt.event.ActionEvent)>/$stack81
<simplejavacalculator.UI: void <init>()>/read-field-panel/0	<simplejavacalculator.UI: void <init>()>/$stack8
<simplejavacalculator.UI: void init()>/read-field-butrate/2	<simplejavacalculator.UI: void init()>/$stack194
<simplejavacalculator.UI: void parsetoBinary()>/read-field-text/0	<simplejavacalculator.UI: void parsetoBinary()>/$stack3
<simplejavacalculator.UI: void init()>/read-field-butOneDevidedBy/1	<simplejavacalculator.UI: void init()>/$stack144
<simplejavacalculator.UI: void init()>/read-field-butxpowerofy/0	<simplejavacalculator.UI: void init()>/$stack36
