<simplejavacalculator.UI: void <init>()>/$stack44	<simplejavacalculator.UI: void <init>()>/this#_0	<simplejavacalculator.UI: javax.swing.JButton butCancel>	<simplejavacalculator.UI: void <init>()>
<simplejavacalculator.UI: void <init>()>/$stack35	<simplejavacalculator.UI: void <init>()>/this#_0	<simplejavacalculator.UI: javax.swing.JButton butSquare>	<simplejavacalculator.UI: void <init>()>
<simplejavacalculator.UI: void <init>()>/$stack29	<simplejavacalculator.UI: void <init>()>/this#_0	<simplejavacalculator.UI: javax.swing.JButton butAdd>	<simplejavacalculator.UI: void <init>()>
<simplejavacalculator.UI: void <init>()>/$stack2	<simplejavacalculator.UI: void <init>()>/this#_0	<simplejavacalculator.UI: java.lang.String[] buttonValue>	<simplejavacalculator.UI: void <init>()>
<simplejavacalculator.UI: void <init>()>/$stack31	<simplejavacalculator.UI: void <init>()>/this#_0	<simplejavacalculator.UI: javax.swing.JButton butMultiply>	<simplejavacalculator.UI: void <init>()>
<simplejavacalculator.UI: void <init>()>/$stack25	<simplejavacalculator.UI: void <init>()>/this#_0	<simplejavacalculator.UI: java.awt.Font font>	<simplejavacalculator.UI: void <init>()>
<simplejavacalculator.UI: void <init>()>/$stack26	<simplejavacalculator.UI: void <init>()>/this#_0	<simplejavacalculator.UI: javax.swing.JTextArea text>	<simplejavacalculator.UI: void <init>()>
<simplejavacalculator.UI: void <init>()>/$stack21	<simplejavacalculator.UI: void <init>()>/this#_0	<simplejavacalculator.UI: javax.swing.JPanel panelSub7>	<simplejavacalculator.UI: void <init>()>
<simplejavacalculator.UI: void <init>()>/$stack13	<simplejavacalculator.UI: void <init>()>/this#_0	<simplejavacalculator.UI: javax.swing.JPanel panelSub3>	<simplejavacalculator.UI: void <init>()>
<simplejavacalculator.UI: void <init>()>/$stack19	<simplejavacalculator.UI: void <init>()>/this#_0	<simplejavacalculator.UI: javax.swing.JPanel panelSub6>	<simplejavacalculator.UI: void <init>()>
<simplejavacalculator.UI: void <init>()>/$stack32	<simplejavacalculator.UI: void <init>()>/this#_0	<simplejavacalculator.UI: javax.swing.JButton butDivide>	<simplejavacalculator.UI: void <init>()>
<simplejavacalculator.Calculator: java.lang.Double calculateBi(simplejavacalculator.Calculator$BiOperatorModes,java.lang.Double)>/num#_0	<simplejavacalculator.Calculator: java.lang.Double calculateBi(simplejavacalculator.Calculator$BiOperatorModes,java.lang.Double)>/this#_0	<simplejavacalculator.Calculator: java.lang.Double num2>	<simplejavacalculator.Calculator: java.lang.Double calculateBi(simplejavacalculator.Calculator$BiOperatorModes,java.lang.Double)>
<simplejavacalculator.Calculator: java.lang.Double calculateBi(simplejavacalculator.Calculator$BiOperatorModes,java.lang.Double)>/num#_0	<simplejavacalculator.Calculator: java.lang.Double calculateBi(simplejavacalculator.Calculator$BiOperatorModes,java.lang.Double)>/this#_0	<simplejavacalculator.Calculator: java.lang.Double num1>	<simplejavacalculator.Calculator: java.lang.Double calculateBi(simplejavacalculator.Calculator$BiOperatorModes,java.lang.Double)>
<simplejavacalculator.Calculator: void <init>()>/$stack1	<simplejavacalculator.Calculator: void <init>()>/this#_0	<simplejavacalculator.Calculator: simplejavacalculator.Calculator$BiOperatorModes mode>	<simplejavacalculator.Calculator: void <init>()>
<simplejavacalculator.UI: void <init>()>/$stack45	<simplejavacalculator.UI: void <init>()>/this#_0	<simplejavacalculator.UI: javax.swing.JButton butBinary>	<simplejavacalculator.UI: void <init>()>
<simplejavacalculator.UI: void <init>()>/$stack30	<simplejavacalculator.UI: void <init>()>/this#_0	<simplejavacalculator.UI: javax.swing.JButton butMinus>	<simplejavacalculator.UI: void <init>()>
<simplejavacalculator.UI: void <init>()>/$stack17	<simplejavacalculator.UI: void <init>()>/this#_0	<simplejavacalculator.UI: javax.swing.JPanel panelSub5>	<simplejavacalculator.UI: void <init>()>
<simplejavacalculator.UI: void <init>()>/$stack41	<simplejavacalculator.UI: void <init>()>/this#_0	<simplejavacalculator.UI: javax.swing.JButton butlog>	<simplejavacalculator.UI: void <init>()>
<simplejavacalculator.Calculator: java.lang.Double reset()>/$stack2	<simplejavacalculator.Calculator: java.lang.Double reset()>/this#_0	<simplejavacalculator.Calculator: java.lang.Double num1>	<simplejavacalculator.Calculator: java.lang.Double reset()>
<simplejavacalculator.UI: void <init>()>/$stack11	<simplejavacalculator.UI: void <init>()>/this#_0	<simplejavacalculator.UI: javax.swing.JPanel panelSub2>	<simplejavacalculator.UI: void <init>()>
<simplejavacalculator.UI: void <init>()>/$stack28	<simplejavacalculator.UI: void <init>()>/this#_0	<simplejavacalculator.UI: javax.swing.JButton[] but>	<simplejavacalculator.UI: void <init>()>
<simplejavacalculator.UI: void <init>()>/$stack37	<simplejavacalculator.UI: void <init>()>/this#_0	<simplejavacalculator.UI: javax.swing.JButton butCos>	<simplejavacalculator.UI: void <init>()>
<simplejavacalculator.Calculator: java.lang.Double calculateBi(simplejavacalculator.Calculator$BiOperatorModes,java.lang.Double)>/$stack5	<simplejavacalculator.Calculator: java.lang.Double calculateBi(simplejavacalculator.Calculator$BiOperatorModes,java.lang.Double)>/this#_0	<simplejavacalculator.Calculator: java.lang.Double num1>	<simplejavacalculator.Calculator: java.lang.Double calculateBi(simplejavacalculator.Calculator$BiOperatorModes,java.lang.Double)>
<simplejavacalculator.UI: void <init>()>/$stack40	<simplejavacalculator.UI: void <init>()>/this#_0	<simplejavacalculator.UI: javax.swing.JButton butxpowerofy>	<simplejavacalculator.UI: void <init>()>
<simplejavacalculator.UI: void <init>()>/$stack33	<simplejavacalculator.UI: void <init>()>/this#_0	<simplejavacalculator.UI: javax.swing.JButton butEqual>	<simplejavacalculator.UI: void <init>()>
<simplejavacalculator.UI: void <init>()>/$stack15	<simplejavacalculator.UI: void <init>()>/this#_0	<simplejavacalculator.UI: javax.swing.JPanel panelSub4>	<simplejavacalculator.UI: void <init>()>
<simplejavacalculator.UI: void <init>()>/$stack4	<simplejavacalculator.UI: void <init>()>/this#_0	<simplejavacalculator.UI: javax.swing.ImageIcon image>	<simplejavacalculator.UI: void <init>()>
<simplejavacalculator.UI: void <init>()>/$stack3	<simplejavacalculator.UI: void <init>()>/this#_0	<simplejavacalculator.UI: javax.swing.JFrame frame>	<simplejavacalculator.UI: void <init>()>
<simplejavacalculator.UI: void <init>()>/$stack39	<simplejavacalculator.UI: void <init>()>/this#_0	<simplejavacalculator.UI: javax.swing.JButton butTan>	<simplejavacalculator.UI: void <init>()>
<simplejavacalculator.Calculator: java.lang.Double calculateBi(simplejavacalculator.Calculator$BiOperatorModes,java.lang.Double)>/newMode#_0	<simplejavacalculator.Calculator: java.lang.Double calculateBi(simplejavacalculator.Calculator$BiOperatorModes,java.lang.Double)>/this#_0	<simplejavacalculator.Calculator: simplejavacalculator.Calculator$BiOperatorModes mode>	<simplejavacalculator.Calculator: java.lang.Double calculateBi(simplejavacalculator.Calculator$BiOperatorModes,java.lang.Double)>
<simplejavacalculator.UI: void <init>()>/$stack9	<simplejavacalculator.UI: void <init>()>/this#_0	<simplejavacalculator.UI: javax.swing.JPanel panelSub1>	<simplejavacalculator.UI: void <init>()>
<simplejavacalculator.UI: void <init>()>/$stack46	<simplejavacalculator.UI: void <init>()>/this#_0	<simplejavacalculator.UI: simplejavacalculator.Calculator calc>	<simplejavacalculator.UI: void <init>()>
<simplejavacalculator.UI: void <init>()>/$stack43	<simplejavacalculator.UI: void <init>()>/this#_0	<simplejavacalculator.UI: javax.swing.JButton butabs>	<simplejavacalculator.UI: void <init>()>
<simplejavacalculator.Calculator: java.lang.Double reset()>/$stack3	<simplejavacalculator.Calculator: java.lang.Double reset()>/this#_0	<simplejavacalculator.Calculator: simplejavacalculator.Calculator$BiOperatorModes mode>	<simplejavacalculator.Calculator: java.lang.Double reset()>
<simplejavacalculator.UI: void <init>()>/$stack27	<simplejavacalculator.UI: void <init>()>/this#_0	<simplejavacalculator.UI: java.awt.Font textFont>	<simplejavacalculator.UI: void <init>()>
<simplejavacalculator.UI: void <init>()>/$stack23	<simplejavacalculator.UI: void <init>()>/this#_0	<simplejavacalculator.UI: javax.swing.JPanel panelSub8>	<simplejavacalculator.UI: void <init>()>
<simplejavacalculator.UI: void <init>()>/$stack34	<simplejavacalculator.UI: void <init>()>/this#_0	<simplejavacalculator.UI: javax.swing.JButton butSquareRoot>	<simplejavacalculator.UI: void <init>()>
<simplejavacalculator.UI: void <init>()>/$stack42	<simplejavacalculator.UI: void <init>()>/this#_0	<simplejavacalculator.UI: javax.swing.JButton butrate>	<simplejavacalculator.UI: void <init>()>
<simplejavacalculator.Calculator: java.lang.Double reset()>/$stack1	<simplejavacalculator.Calculator: java.lang.Double reset()>/this#_0	<simplejavacalculator.Calculator: java.lang.Double num2>	<simplejavacalculator.Calculator: java.lang.Double reset()>
<simplejavacalculator.UI: void <init>()>/$stack38	<simplejavacalculator.UI: void <init>()>/this#_0	<simplejavacalculator.UI: javax.swing.JButton butSin>	<simplejavacalculator.UI: void <init>()>
<simplejavacalculator.Calculator: java.lang.Double calculateBi(simplejavacalculator.Calculator$BiOperatorModes,java.lang.Double)>/$stack7	<simplejavacalculator.Calculator: java.lang.Double calculateBi(simplejavacalculator.Calculator$BiOperatorModes,java.lang.Double)>/this#_0	<simplejavacalculator.Calculator: java.lang.Double num2>	<simplejavacalculator.Calculator: java.lang.Double calculateBi(simplejavacalculator.Calculator$BiOperatorModes,java.lang.Double)>
<simplejavacalculator.UI: void <init>()>/$stack36	<simplejavacalculator.UI: void <init>()>/this#_0	<simplejavacalculator.UI: javax.swing.JButton butOneDevidedBy>	<simplejavacalculator.UI: void <init>()>
<simplejavacalculator.UI: void <init>()>/$stack5	<simplejavacalculator.UI: void <init>()>/this#_0	<simplejavacalculator.UI: javax.swing.JPanel panel>	<simplejavacalculator.UI: void <init>()>
