<simplejavacalculator.UI: void actionPerformed(java.awt.event.ActionEvent)>/simplejavacalculator.UI.reader/14	<simplejavacalculator.UI: void actionPerformed(java.awt.event.ActionEvent)>/this#_0
<simplejavacalculator.UI: void parsetoBinary()>/java.io.PrintStream.println/0	<simplejavacalculator.UI: void parsetoBinary()>/$stack13
<simplejavacalculator.UI: void parsetoBinary()>/javax.swing.JTextArea.getText/0	<simplejavacalculator.UI: void parsetoBinary()>/$stack5
<simplejavacalculator.UI: void init()>/javax.swing.JFrame.setDefaultCloseOperation/0	<simplejavacalculator.UI: void init()>/$stack6
<simplejavacalculator.UI: void init()>/javax.swing.JButton.addActionListener/2	<simplejavacalculator.UI: void init()>/$stack182
<simplejavacalculator.UI: void actionPerformed(java.awt.event.ActionEvent)>/simplejavacalculator.UI.writer/15	<simplejavacalculator.UI: void actionPerformed(java.awt.event.ActionEvent)>/this#_0
<simplejavacalculator.UI: void actionPerformed(java.awt.event.ActionEvent)>/javax.swing.JTextArea.selectAll/0	<simplejavacalculator.UI: void actionPerformed(java.awt.event.ActionEvent)>/$stack22
<simplejavacalculator.UI: void actionPerformed(java.awt.event.ActionEvent)>/simplejavacalculator.UI.writer/9	<simplejavacalculator.UI: void actionPerformed(java.awt.event.ActionEvent)>/this#_0
<simplejavacalculator.UI: void init()>/javax.swing.JFrame.setLocationRelativeTo/0	<simplejavacalculator.UI: void init()>/$stack4
<simplejavacalculator.UI: void init()>/javax.swing.JButton.setFont/0	<simplejavacalculator.UI: void init()>/$stack208
<simplejavacalculator.UI: void actionPerformed(java.awt.event.ActionEvent)>/simplejavacalculator.UI.writer/11	<simplejavacalculator.UI: void actionPerformed(java.awt.event.ActionEvent)>/this#_0
<simplejavacalculator.Calculator$MonoOperatorModes: simplejavacalculator.Calculator$MonoOperatorModes[] values()>/java.lang.Object.clone/0	<simplejavacalculator.Calculator$MonoOperatorModes: simplejavacalculator.Calculator$MonoOperatorModes[] values()>/$stack0
<simplejavacalculator.UI: void actionPerformed(java.awt.event.ActionEvent)>/simplejavacalculator.UI.writer/13	<simplejavacalculator.UI: void actionPerformed(java.awt.event.ActionEvent)>/this#_0
<simplejavacalculator.UI: void actionPerformed(java.awt.event.ActionEvent)>/simplejavacalculator.UI.reader/1	<simplejavacalculator.UI: void actionPerformed(java.awt.event.ActionEvent)>/this#_0
<simplejavacalculator.UI: void actionPerformed(java.awt.event.ActionEvent)>/simplejavacalculator.UI.writer/1	<simplejavacalculator.UI: void actionPerformed(java.awt.event.ActionEvent)>/this#_0
<simplejavacalculator.UI: void init()>/javax.swing.JFrame.add/0	<simplejavacalculator.UI: void init()>/$stack200
<simplejavacalculator.Calculator$BiOperatorModes: simplejavacalculator.Calculator$BiOperatorModes[] values()>/java.lang.Object.clone/0	<simplejavacalculator.Calculator$BiOperatorModes: simplejavacalculator.Calculator$BiOperatorModes[] values()>/$stack0
<simplejavacalculator.UI: void actionPerformed(java.awt.event.ActionEvent)>/simplejavacalculator.UI.reader/5	<simplejavacalculator.UI: void actionPerformed(java.awt.event.ActionEvent)>/this#_0
<simplejavacalculator.UI: void actionPerformed(java.awt.event.ActionEvent)>/simplejavacalculator.Calculator.reset/0	<simplejavacalculator.UI: void actionPerformed(java.awt.event.ActionEvent)>/$stack24
<simplejavacalculator.UI: void init()>/javax.swing.JButton.setFont/8	<simplejavacalculator.UI: void init()>/$stack28
<simplejavacalculator.UI: void init()>/javax.swing.JPanel.add/13	<simplejavacalculator.UI: void init()>/$stack92
<simplejavacalculator.UI: void init()>/javax.swing.JButton.addActionListener/6	<simplejavacalculator.UI: void init()>/$stack186
<simplejavacalculator.UI: void actionPerformed(java.awt.event.ActionEvent)>/simplejavacalculator.UI.writer/4	<simplejavacalculator.UI: void actionPerformed(java.awt.event.ActionEvent)>/this#_0
<simplejavacalculator.UI: void actionPerformed(java.awt.event.ActionEvent)>/java.awt.event.ActionEvent.getSource/0	<simplejavacalculator.UI: void actionPerformed(java.awt.event.ActionEvent)>/e#_0
<simplejavacalculator.UI: void actionPerformed(java.awt.event.ActionEvent)>/simplejavacalculator.UI.reader/4	<simplejavacalculator.UI: void actionPerformed(java.awt.event.ActionEvent)>/this#_0
<simplejavacalculator.UI: void init()>/javax.swing.JPanel.add/39	<simplejavacalculator.UI: void init()>/$stack175
<simplejavacalculator.UI: void init()>/javax.swing.JButton.addActionListener/18	<simplejavacalculator.UI: void init()>/$stack198
<simplejavacalculator.UI: void init()>/javax.swing.JFrame.setIconImage/0	<simplejavacalculator.UI: void init()>/$stack8
<simplejavacalculator.UI: void actionPerformed(java.awt.event.ActionEvent)>/simplejavacalculator.Calculator.calculateMono/6	<simplejavacalculator.UI: void actionPerformed(java.awt.event.ActionEvent)>/$stack45
<simplejavacalculator.UI: void actionPerformed(java.awt.event.ActionEvent)>/simplejavacalculator.UI.writer/12	<simplejavacalculator.UI: void actionPerformed(java.awt.event.ActionEvent)>/this#_0
<simplejavacalculator.UI: void init()>/javax.swing.JButton.addActionListener/8	<simplejavacalculator.UI: void init()>/$stack188
<simplejavacalculator.UI: void actionPerformed(java.awt.event.ActionEvent)>/simplejavacalculator.Calculator.calculateBi/3	<simplejavacalculator.UI: void actionPerformed(java.awt.event.ActionEvent)>/$stack93
<simplejavacalculator.UI: void actionPerformed(java.awt.event.ActionEvent)>/simplejavacalculator.UI.reader/0	<simplejavacalculator.UI: void actionPerformed(java.awt.event.ActionEvent)>/this#_0
<simplejavacalculator.UI: void actionPerformed(java.awt.event.ActionEvent)>/simplejavacalculator.UI.writer/5	<simplejavacalculator.UI: void actionPerformed(java.awt.event.ActionEvent)>/this#_0
<simplejavacalculator.UI: void init()>/javax.swing.JButton.addActionListener/5	<simplejavacalculator.UI: void init()>/$stack185
<simplejavacalculator.UI: void actionPerformed(java.awt.event.ActionEvent)>/simplejavacalculator.UI.reader/10	<simplejavacalculator.UI: void actionPerformed(java.awt.event.ActionEvent)>/this#_0
<simplejavacalculator.SimpleJavaCalculator: void main(java.lang.String[])>/simplejavacalculator.UI.init/0	<simplejavacalculator.SimpleJavaCalculator: void main(java.lang.String[])>/uiCal#_22
<simplejavacalculator.UI: void init()>/javax.swing.JPanel.add/34	<simplejavacalculator.UI: void init()>/$stack160
<simplejavacalculator.UI: java.lang.Double reader()>/javax.swing.JTextArea.getText/0	<simplejavacalculator.UI: java.lang.Double reader()>/$stack3
<simplejavacalculator.UI: void init()>/javax.swing.JButton.setFont/10	<simplejavacalculator.UI: void init()>/$stack32
<simplejavacalculator.UI: void parsetoBinary()>/java.lang.NumberFormatException.toString/0	<simplejavacalculator.UI: void parsetoBinary()>/ex#_310
<simplejavacalculator.UI: void parsetoBinary()>/java.lang.StringBuilder.append/3	<simplejavacalculator.UI: void parsetoBinary()>/$stack14
<simplejavacalculator.UI: void actionPerformed(java.awt.event.ActionEvent)>/simplejavacalculator.Calculator.calculateBi/1	<simplejavacalculator.UI: void actionPerformed(java.awt.event.ActionEvent)>/$stack105
<simplejavacalculator.UI: void init()>/javax.swing.JButton.addActionListener/14	<simplejavacalculator.UI: void init()>/$stack194
<simplejavacalculator.UI: void init()>/javax.swing.JButton.addActionListener/17	<simplejavacalculator.UI: void init()>/$stack197
<simplejavacalculator.UI: void init()>/javax.swing.JPanel.add/33	<simplejavacalculator.UI: void init()>/$stack157
<simplejavacalculator.UI: void init()>/javax.swing.JFrame.setResizable/0	<simplejavacalculator.UI: void init()>/$stack5
<simplejavacalculator.UI: void actionPerformed(java.awt.event.ActionEvent)>/simplejavacalculator.Calculator.calculateBi/4	<simplejavacalculator.UI: void actionPerformed(java.awt.event.ActionEvent)>/$stack87
<simplejavacalculator.Calculator: java.lang.Double calculateEqual(java.lang.Double)>/simplejavacalculator.Calculator.calculateBi/0	<simplejavacalculator.Calculator: java.lang.Double calculateEqual(java.lang.Double)>/this#_0
<simplejavacalculator.UI: void parsetoBinary()>/java.lang.StringBuilder.toString/1	<simplejavacalculator.UI: void parsetoBinary()>/$stack16
<simplejavacalculator.UI: void actionPerformed(java.awt.event.ActionEvent)>/simplejavacalculator.Calculator.calculateMono/8	<simplejavacalculator.UI: void actionPerformed(java.awt.event.ActionEvent)>/$stack33
<simplejavacalculator.UI: void parsetoBinary()>/java.lang.StringBuilder.append/2	<simplejavacalculator.UI: void parsetoBinary()>/$stack12
<simplejavacalculator.UI: void actionPerformed(java.awt.event.ActionEvent)>/simplejavacalculator.Calculator.calculateEqual/0	<simplejavacalculator.UI: void actionPerformed(java.awt.event.ActionEvent)>/$stack28
<simplejavacalculator.UI: void parsetoBinary()>/java.lang.StringBuilder.append/1	<simplejavacalculator.UI: void parsetoBinary()>/$stack4
<simplejavacalculator.UI: void init()>/javax.swing.JPanel.add/40	<simplejavacalculator.UI: void init()>/$stack178
<simplejavacalculator.UI: void actionPerformed(java.awt.event.ActionEvent)>/simplejavacalculator.UI.reader/13	<simplejavacalculator.UI: void actionPerformed(java.awt.event.ActionEvent)>/this#_0
<simplejavacalculator.UI: void init()>/javax.swing.JPanel.add/20	<simplejavacalculator.UI: void init()>/$stack116
<simplejavacalculator.UI: void actionPerformed(java.awt.event.ActionEvent)>/simplejavacalculator.Calculator.calculateMono/7	<simplejavacalculator.UI: void actionPerformed(java.awt.event.ActionEvent)>/$stack39
<simplejavacalculator.UI: void actionPerformed(java.awt.event.ActionEvent)>/simplejavacalculator.UI.writer/10	<simplejavacalculator.UI: void actionPerformed(java.awt.event.ActionEvent)>/this#_0
<simplejavacalculator.UI: void init()>/javax.swing.JPanel.add/38	<simplejavacalculator.UI: void init()>/$stack172
<simplejavacalculator.UI: void init()>/javax.swing.JButton.addActionListener/0	<simplejavacalculator.UI: void init()>/$stack181
<simplejavacalculator.UI: void actionPerformed(java.awt.event.ActionEvent)>/simplejavacalculator.UI.writer/0	<simplejavacalculator.UI: void actionPerformed(java.awt.event.ActionEvent)>/this#_0
<simplejavacalculator.UI: void init()>/javax.swing.JPanel.add/31	<simplejavacalculator.UI: void init()>/$stack151
<simplejavacalculator.UI: void actionPerformed(java.awt.event.ActionEvent)>/simplejavacalculator.UI.writer/2	<simplejavacalculator.UI: void actionPerformed(java.awt.event.ActionEvent)>/this#_0
<simplejavacalculator.UI: void actionPerformed(java.awt.event.ActionEvent)>/simplejavacalculator.UI.reader/11	<simplejavacalculator.UI: void actionPerformed(java.awt.event.ActionEvent)>/this#_0
<simplejavacalculator.UI: void init()>/javax.swing.JPanel.add/29	<simplejavacalculator.UI: void init()>/$stack145
<simplejavacalculator.UI: void init()>/javax.swing.JPanel.add/30	<simplejavacalculator.UI: void init()>/$stack148
<simplejavacalculator.UI: void actionPerformed(java.awt.event.ActionEvent)>/simplejavacalculator.UI.reader/2	<simplejavacalculator.UI: void actionPerformed(java.awt.event.ActionEvent)>/this#_0
<simplejavacalculator.UI: void init()>/javax.swing.JButton.addActionListener/16	<simplejavacalculator.UI: void init()>/$stack196
<simplejavacalculator.UI: void init()>/javax.swing.JPanel.add/28	<simplejavacalculator.UI: void init()>/$stack142
<simplejavacalculator.UI: void init()>/javax.swing.JPanel.add/12	<simplejavacalculator.UI: void init()>/$stack90
<simplejavacalculator.UI: void init()>/javax.swing.JFrame.setSize/0	<simplejavacalculator.UI: void init()>/$stack2
<simplejavacalculator.UI: void init()>/javax.swing.JPanel.add/35	<simplejavacalculator.UI: void init()>/$stack163
<simplejavacalculator.UI: void init()>/javax.swing.JPanel.add/37	<simplejavacalculator.UI: void init()>/$stack169
<simplejavacalculator.UI: void init()>/javax.swing.JButton.addActionListener/1	<simplejavacalculator.UI: void init()>/$stack203
<simplejavacalculator.UI: void actionPerformed(java.awt.event.ActionEvent)>/simplejavacalculator.UI.writer/8	<simplejavacalculator.UI: void actionPerformed(java.awt.event.ActionEvent)>/this#_0
<simplejavacalculator.UI: void init()>/javax.swing.JButton.setFont/4	<simplejavacalculator.UI: void init()>/$stack20
<simplejavacalculator.UI: void init()>/javax.swing.JTextArea.setEditable/0	<simplejavacalculator.UI: void init()>/$stack12
<simplejavacalculator.UI: void actionPerformed(java.awt.event.ActionEvent)>/simplejavacalculator.UI.writer/3	<simplejavacalculator.UI: void actionPerformed(java.awt.event.ActionEvent)>/this#_0
<simplejavacalculator.UI: void actionPerformed(java.awt.event.ActionEvent)>/simplejavacalculator.Calculator.calculateBi/2	<simplejavacalculator.UI: void actionPerformed(java.awt.event.ActionEvent)>/$stack99
<simplejavacalculator.UI: void init()>/javax.swing.JTextArea.setFont/0	<simplejavacalculator.UI: void init()>/$stack11
<simplejavacalculator.UI: void actionPerformed(java.awt.event.ActionEvent)>/simplejavacalculator.UI.reader/12	<simplejavacalculator.UI: void actionPerformed(java.awt.event.ActionEvent)>/this#_0
<simplejavacalculator.UI: void init()>/javax.swing.JPanel.add/25	<simplejavacalculator.UI: void init()>/$stack132
<simplejavacalculator.UI: void init()>/javax.swing.JPanel.add/27	<simplejavacalculator.UI: void init()>/$stack139
<simplejavacalculator.Calculator: java.lang.Double calculateBiImpl()>/java.lang.Double.doubleValue/7	<simplejavacalculator.Calculator: java.lang.Double calculateBiImpl()>/$stack20
<simplejavacalculator.UI: void init()>/javax.swing.JButton.setFont/17	<simplejavacalculator.UI: void init()>/$stack46
<simplejavacalculator.Calculator: java.lang.Double calculateMono(simplejavacalculator.Calculator$MonoOperatorModes,java.lang.Double)>/java.lang.Double.doubleValue/4	<simplejavacalculator.Calculator: java.lang.Double calculateMono(simplejavacalculator.Calculator$MonoOperatorModes,java.lang.Double)>/num#_0
<simplejavacalculator.UI: void actionPerformed(java.awt.event.ActionEvent)>/simplejavacalculator.Calculator.calculateMono/4	<simplejavacalculator.UI: void actionPerformed(java.awt.event.ActionEvent)>/$stack57
<simplejavacalculator.UI: void actionPerformed(java.awt.event.ActionEvent)>/simplejavacalculator.Calculator.calculateBi/0	<simplejavacalculator.UI: void actionPerformed(java.awt.event.ActionEvent)>/$stack111
<simplejavacalculator.UI: void init()>/javax.swing.JButton.setFont/5	<simplejavacalculator.UI: void init()>/$stack22
<simplejavacalculator.UI: void writer(java.lang.Double)>/javax.swing.JTextArea.setText/1	<simplejavacalculator.UI: void writer(java.lang.Double)>/$stack4
<simplejavacalculator.UI: void init()>/javax.swing.JPanel.add/24	<simplejavacalculator.UI: void init()>/$stack130
<simplejavacalculator.UI: void init()>/javax.swing.JFrame.setVisible/0	<simplejavacalculator.UI: void init()>/$stack3
<simplejavacalculator.UI: void init()>/javax.swing.JButton.addActionListener/3	<simplejavacalculator.UI: void init()>/$stack183
<simplejavacalculator.UI: void init()>/javax.swing.JPanel.add/4	<simplejavacalculator.UI: void init()>/$stack62
<simplejavacalculator.UI: void init()>/javax.swing.JButton.addActionListener/12	<simplejavacalculator.UI: void init()>/$stack192
<simplejavacalculator.UI: void init()>/javax.swing.JPanel.add/21	<simplejavacalculator.UI: void init()>/$stack120
<simplejavacalculator.UI: void init()>/javax.swing.JPanel.add/26	<simplejavacalculator.UI: void init()>/$stack136
<simplejavacalculator.UI: void init()>/javax.swing.JPanel.add/10	<simplejavacalculator.UI: void init()>/$stack82
<simplejavacalculator.UI: void init()>/javax.swing.JPanel.add/8	<simplejavacalculator.UI: void init()>/$stack75
<simplejavacalculator.UI: void actionPerformed(java.awt.event.ActionEvent)>/simplejavacalculator.UI.writer/6	<simplejavacalculator.UI: void actionPerformed(java.awt.event.ActionEvent)>/this#_0
<simplejavacalculator.UI: void init()>/javax.swing.JButton.addActionListener/11	<simplejavacalculator.UI: void init()>/$stack191
<simplejavacalculator.UI: void init()>/javax.swing.JButton.addActionListener/9	<simplejavacalculator.UI: void init()>/$stack189
<simplejavacalculator.Calculator: java.lang.Double calculateMono(simplejavacalculator.Calculator$MonoOperatorModes,java.lang.Double)>/java.lang.Double.doubleValue/6	<simplejavacalculator.Calculator: java.lang.Double calculateMono(simplejavacalculator.Calculator$MonoOperatorModes,java.lang.Double)>/num#_0
<simplejavacalculator.UI: void init()>/javax.swing.JPanel.add/9	<simplejavacalculator.UI: void init()>/$stack78
<simplejavacalculator.UI: void init()>/javax.swing.JPanel.add/14	<simplejavacalculator.UI: void init()>/$stack96
<simplejavacalculator.Calculator: java.lang.Double calculateBiImpl()>/java.lang.Double.doubleValue/10	<simplejavacalculator.Calculator: java.lang.Double calculateBiImpl()>/$stack16
<simplejavacalculator.UI: void init()>/javax.swing.JButton.setFont/1	<simplejavacalculator.UI: void init()>/$stack14
<simplejavacalculator.UI: void init()>/javax.swing.JButton.setFont/12	<simplejavacalculator.UI: void init()>/$stack36
<simplejavacalculator.UI: void init()>/javax.swing.JButton.addActionListener/4	<simplejavacalculator.UI: void init()>/$stack184
<simplejavacalculator.UI: void init()>/javax.swing.JPanel.add/32	<simplejavacalculator.UI: void init()>/$stack154
<simplejavacalculator.UI: void actionPerformed(java.awt.event.ActionEvent)>/simplejavacalculator.Calculator.calculateMono/0	<simplejavacalculator.UI: void actionPerformed(java.awt.event.ActionEvent)>/$stack81
<simplejavacalculator.UI: void init()>/javax.swing.JButton.setFont/9	<simplejavacalculator.UI: void init()>/$stack30
<simplejavacalculator.UI: void init()>/javax.swing.JPanel.add/15	<simplejavacalculator.UI: void init()>/$stack99
<simplejavacalculator.UI: void init()>/javax.swing.JButton.setFont/3	<simplejavacalculator.UI: void init()>/$stack18
<simplejavacalculator.Calculator: java.lang.Double calculateBiImpl()>/java.lang.Double.doubleValue/0	<simplejavacalculator.Calculator: java.lang.Double calculateBiImpl()>/$stack38
<simplejavacalculator.Calculator: java.lang.Double calculateBiImpl()>/java.lang.Double.doubleValue/2	<simplejavacalculator.Calculator: java.lang.Double calculateBiImpl()>/$stack44
<simplejavacalculator.Calculator: java.lang.Double calculateBiImpl()>/java.lang.Double.doubleValue/4	<simplejavacalculator.Calculator: java.lang.Double calculateBiImpl()>/$stack34
<simplejavacalculator.Calculator: java.lang.Double calculateMono(simplejavacalculator.Calculator$MonoOperatorModes,java.lang.Double)>/java.lang.Double.doubleValue/11	<simplejavacalculator.Calculator: java.lang.Double calculateMono(simplejavacalculator.Calculator$MonoOperatorModes,java.lang.Double)>/num#_0
<simplejavacalculator.Calculator: java.lang.Double calculateMono(simplejavacalculator.Calculator$MonoOperatorModes,java.lang.Double)>/java.lang.Double.doubleValue/2	<simplejavacalculator.Calculator: java.lang.Double calculateMono(simplejavacalculator.Calculator$MonoOperatorModes,java.lang.Double)>/num#_0
<simplejavacalculator.Calculator: java.lang.Double calculateMono(simplejavacalculator.Calculator$MonoOperatorModes,java.lang.Double)>/java.lang.Double.doubleValue/5	<simplejavacalculator.Calculator: java.lang.Double calculateMono(simplejavacalculator.Calculator$MonoOperatorModes,java.lang.Double)>/num#_0
<simplejavacalculator.UI: void init()>/javax.swing.JPanel.add/19	<simplejavacalculator.UI: void init()>/$stack114
<simplejavacalculator.Calculator: java.lang.Double calculateMono(simplejavacalculator.Calculator$MonoOperatorModes,java.lang.Double)>/java.lang.Double.doubleValue/3	<simplejavacalculator.Calculator: java.lang.Double calculateMono(simplejavacalculator.Calculator$MonoOperatorModes,java.lang.Double)>/num#_0
<simplejavacalculator.UI: void init()>/javax.swing.JPanel.add/36	<simplejavacalculator.UI: void init()>/$stack166
<simplejavacalculator.UI: void init()>/javax.swing.JButton.setFont/7	<simplejavacalculator.UI: void init()>/$stack26
<simplejavacalculator.UI: void init()>/javax.swing.JButton.setFont/11	<simplejavacalculator.UI: void init()>/$stack34
<simplejavacalculator.UI: void parsetoBinary()>/java.lang.StringBuilder.append/0	<simplejavacalculator.UI: void parsetoBinary()>/$stack2
<simplejavacalculator.UI: void init()>/javax.swing.JButton.setFont/15	<simplejavacalculator.UI: void init()>/$stack42
<simplejavacalculator.Calculator: java.lang.Double calculateMono(simplejavacalculator.Calculator$MonoOperatorModes,java.lang.Double)>/java.lang.Double.doubleValue/10	<simplejavacalculator.Calculator: java.lang.Double calculateMono(simplejavacalculator.Calculator$MonoOperatorModes,java.lang.Double)>/$stack37
<simplejavacalculator.UI: void init()>/javax.swing.JPanel.add/23	<simplejavacalculator.UI: void init()>/$stack126
<simplejavacalculator.UI: void actionPerformed(java.awt.event.ActionEvent)>/simplejavacalculator.UI.writer/14	<simplejavacalculator.UI: void actionPerformed(java.awt.event.ActionEvent)>/this#_0
<simplejavacalculator.Calculator: java.lang.Double calculateMono(simplejavacalculator.Calculator$MonoOperatorModes,java.lang.Double)>/java.lang.Double.doubleValue/1	<simplejavacalculator.Calculator: java.lang.Double calculateMono(simplejavacalculator.Calculator$MonoOperatorModes,java.lang.Double)>/num#_0
<simplejavacalculator.UI: void init()>/javax.swing.JPanel.add/16	<simplejavacalculator.UI: void init()>/$stack102
<simplejavacalculator.UI: void init()>/javax.swing.JButton.addActionListener/15	<simplejavacalculator.UI: void init()>/$stack195
<simplejavacalculator.UI: void parsetoBinary()>/javax.swing.JTextArea.setText/0	<simplejavacalculator.UI: void parsetoBinary()>/$stack3
<simplejavacalculator.Calculator: java.lang.Double calculateMono(simplejavacalculator.Calculator$MonoOperatorModes,java.lang.Double)>/java.lang.Double.doubleValue/9	<simplejavacalculator.Calculator: java.lang.Double calculateMono(simplejavacalculator.Calculator$MonoOperatorModes,java.lang.Double)>/num#_0
<simplejavacalculator.UI: void actionPerformed(java.awt.event.ActionEvent)>/simplejavacalculator.Calculator.calculateMono/3	<simplejavacalculator.UI: void actionPerformed(java.awt.event.ActionEvent)>/$stack63
<simplejavacalculator.UI: void init()>/javax.swing.JPanel.add/1	<simplejavacalculator.UI: void init()>/$stack51
<simplejavacalculator.UI: void init()>/javax.swing.JPanel.add/17	<simplejavacalculator.UI: void init()>/$stack106
<simplejavacalculator.UI: void parsetoBinary()>/java.lang.StringBuilder.toString/0	<simplejavacalculator.UI: void parsetoBinary()>/$stack9
<simplejavacalculator.UI: void init()>/javax.swing.JButton.addActionListener/7	<simplejavacalculator.UI: void init()>/$stack187
<simplejavacalculator.UI: void init()>/javax.swing.ImageIcon.getImage/0	<simplejavacalculator.UI: void init()>/$stack7
<simplejavacalculator.Calculator: java.lang.Double calculateMono(simplejavacalculator.Calculator$MonoOperatorModes,java.lang.Double)>/java.lang.Double.doubleValue/12	<simplejavacalculator.Calculator: java.lang.Double calculateMono(simplejavacalculator.Calculator$MonoOperatorModes,java.lang.Double)>/num#_0
<simplejavacalculator.UI: void actionPerformed(java.awt.event.ActionEvent)>/simplejavacalculator.UI.reader/9	<simplejavacalculator.UI: void actionPerformed(java.awt.event.ActionEvent)>/this#_0
<simplejavacalculator.UI: void init()>/javax.swing.JButton.setFont/2	<simplejavacalculator.UI: void init()>/$stack16
<simplejavacalculator.UI: void init()>/javax.swing.JPanel.add/18	<simplejavacalculator.UI: void init()>/$stack110
<simplejavacalculator.UI: void init()>/javax.swing.JPanel.add/0	<simplejavacalculator.UI: void init()>/$stack47
<simplejavacalculator.Calculator: java.lang.Double calculateBiImpl()>/java.lang.Double.doubleValue/1	<simplejavacalculator.Calculator: java.lang.Double calculateBiImpl()>/$stack42
<simplejavacalculator.UI: void init()>/javax.swing.JPanel.add/5	<simplejavacalculator.UI: void init()>/$stack66
<simplejavacalculator.UI: void init()>/javax.swing.JPanel.add/3	<simplejavacalculator.UI: void init()>/$stack58
<simplejavacalculator.UI: void init()>/javax.swing.JButton.addActionListener/10	<simplejavacalculator.UI: void init()>/$stack190
<simplejavacalculator.Calculator: java.lang.Double calculateMono(simplejavacalculator.Calculator$MonoOperatorModes,java.lang.Double)>/java.lang.Double.doubleValue/8	<simplejavacalculator.Calculator: java.lang.Double calculateMono(simplejavacalculator.Calculator$MonoOperatorModes,java.lang.Double)>/num#_0
<simplejavacalculator.Calculator: java.lang.Double calculateBiImpl()>/java.lang.Double.doubleValue/8	<simplejavacalculator.Calculator: java.lang.Double calculateBiImpl()>/$stack22
<simplejavacalculator.UI: void actionPerformed(java.awt.event.ActionEvent)>/simplejavacalculator.UI.reader/6	<simplejavacalculator.UI: void actionPerformed(java.awt.event.ActionEvent)>/this#_0
<simplejavacalculator.UI: void actionPerformed(java.awt.event.ActionEvent)>/simplejavacalculator.UI.writer/7	<simplejavacalculator.UI: void actionPerformed(java.awt.event.ActionEvent)>/this#_0
<simplejavacalculator.Calculator: java.lang.Double calculateMono(simplejavacalculator.Calculator$MonoOperatorModes,java.lang.Double)>/java.lang.Double.doubleValue/13	<simplejavacalculator.Calculator: java.lang.Double calculateMono(simplejavacalculator.Calculator$MonoOperatorModes,java.lang.Double)>/num#_0
<simplejavacalculator.Calculator: java.lang.Double calculateBiImpl()>/java.lang.Double.doubleValue/5	<simplejavacalculator.Calculator: java.lang.Double calculateBiImpl()>/$stack26
<simplejavacalculator.UI: void init()>/javax.swing.JPanel.add/11	<simplejavacalculator.UI: void init()>/$stack86
<simplejavacalculator.UI: void init()>/javax.swing.JButton.setFont/16	<simplejavacalculator.UI: void init()>/$stack44
<simplejavacalculator.UI: void init()>/javax.swing.JButton.setFont/14	<simplejavacalculator.UI: void init()>/$stack40
<simplejavacalculator.UI: void actionPerformed(java.awt.event.ActionEvent)>/simplejavacalculator.UI.reader/7	<simplejavacalculator.UI: void actionPerformed(java.awt.event.ActionEvent)>/this#_0
<simplejavacalculator.UI: void init()>/javax.swing.JPanel.add/7	<simplejavacalculator.UI: void init()>/$stack72
<simplejavacalculator.UI: void writer(java.lang.Double)>/javax.swing.JTextArea.setText/0	<simplejavacalculator.UI: void writer(java.lang.Double)>/$stack7
<simplejavacalculator.Calculator: java.lang.Double calculateBiImpl()>/java.lang.Double.doubleValue/6	<simplejavacalculator.Calculator: java.lang.Double calculateBiImpl()>/$stack28
<simplejavacalculator.UI: void writer(java.lang.Double)>/java.lang.Double.doubleValue/0	<simplejavacalculator.UI: void writer(java.lang.Double)>/num#_0
<simplejavacalculator.UI: void init()>/javax.swing.JPanel.add/22	<simplejavacalculator.UI: void init()>/$stack123
<simplejavacalculator.UI: void init()>/javax.swing.JButton.addActionListener/13	<simplejavacalculator.UI: void init()>/$stack193
<simplejavacalculator.UI: void actionPerformed(java.awt.event.ActionEvent)>/simplejavacalculator.Calculator.calculateMono/1	<simplejavacalculator.UI: void actionPerformed(java.awt.event.ActionEvent)>/$stack75
<simplejavacalculator.UI: void actionPerformed(java.awt.event.ActionEvent)>/simplejavacalculator.UI.reader/8	<simplejavacalculator.UI: void actionPerformed(java.awt.event.ActionEvent)>/this#_0
<simplejavacalculator.UI: void actionPerformed(java.awt.event.ActionEvent)>/simplejavacalculator.Calculator.calculateMono/5	<simplejavacalculator.UI: void actionPerformed(java.awt.event.ActionEvent)>/$stack51
<simplejavacalculator.UI: void init()>/javax.swing.JPanel.add/2	<simplejavacalculator.UI: void init()>/$stack54
<simplejavacalculator.UI: void actionPerformed(java.awt.event.ActionEvent)>/javax.swing.JTextArea.replaceSelection/0	<simplejavacalculator.UI: void actionPerformed(java.awt.event.ActionEvent)>/$stack123
<simplejavacalculator.Calculator: java.lang.Double calculateMono(simplejavacalculator.Calculator$MonoOperatorModes,java.lang.Double)>/java.lang.Double.doubleValue/7	<simplejavacalculator.Calculator: java.lang.Double calculateMono(simplejavacalculator.Calculator$MonoOperatorModes,java.lang.Double)>/num#_0
<simplejavacalculator.UI: void <init>()>/javax.swing.JPanel.setLayout/0	<simplejavacalculator.UI: void <init>()>/$stack8
<simplejavacalculator.UI: void actionPerformed(java.awt.event.ActionEvent)>/simplejavacalculator.UI.reader/3	<simplejavacalculator.UI: void actionPerformed(java.awt.event.ActionEvent)>/this#_0
<simplejavacalculator.UI: void actionPerformed(java.awt.event.ActionEvent)>/simplejavacalculator.Calculator.calculateMono/2	<simplejavacalculator.UI: void actionPerformed(java.awt.event.ActionEvent)>/$stack69
<simplejavacalculator.UI: void init()>/javax.swing.JButton.setFont/6	<simplejavacalculator.UI: void init()>/$stack24
<simplejavacalculator.Calculator: java.lang.Double calculateBiImpl()>/java.lang.Double.doubleValue/3	<simplejavacalculator.Calculator: java.lang.Double calculateBiImpl()>/$stack32
<simplejavacalculator.UI: void init()>/javax.swing.JPanel.add/6	<simplejavacalculator.UI: void init()>/$stack68
<simplejavacalculator.Calculator: java.lang.Double calculateBiImpl()>/java.lang.Double.doubleValue/9	<simplejavacalculator.Calculator: java.lang.Double calculateBiImpl()>/$stack14
<simplejavacalculator.Calculator: java.lang.Double calculateMono(simplejavacalculator.Calculator$MonoOperatorModes,java.lang.Double)>/java.lang.Double.doubleValue/0	<simplejavacalculator.Calculator: java.lang.Double calculateMono(simplejavacalculator.Calculator$MonoOperatorModes,java.lang.Double)>/num#_0
<simplejavacalculator.UI: void writer(java.lang.Double)>/java.lang.Double.doubleValue/1	<simplejavacalculator.UI: void writer(java.lang.Double)>/num#_0
<simplejavacalculator.UI: void init()>/javax.swing.JButton.setFont/13	<simplejavacalculator.UI: void init()>/$stack38
