2	<simplejavacalculator.UI: void <init>()>/$stringconstant2	<simplejavacalculator.UI: void <init>()>
1	<simplejavacalculator.UI: void <init>()>/$stringconstant1	<simplejavacalculator.UI: void <init>()>
0	<simplejavacalculator.UI: void <init>()>/$stringconstant0	<simplejavacalculator.UI: void <init>()>
<simplejavacalculator.Calculator$MonoOperatorModes: void <clinit>()>/new simplejavacalculator.Calculator$MonoOperatorModes/6	<simplejavacalculator.Calculator$MonoOperatorModes: void <clinit>()>/$stack6	<simplejavacalculator.Calculator$MonoOperatorModes: void <clinit>()>
<simplejavacalculator.Calculator$MonoOperatorModes: void <clinit>()>/new simplejavacalculator.Calculator$MonoOperatorModes/8	<simplejavacalculator.Calculator$MonoOperatorModes: void <clinit>()>/$stack8	<simplejavacalculator.Calculator$MonoOperatorModes: void <clinit>()>
<simplejavacalculator.UI: void <init>()>/new javax.swing.ImageIcon/0	<simplejavacalculator.UI: void <init>()>/$stack4	<simplejavacalculator.UI: void <init>()>
<simplejavacalculator.Calculator: java.lang.Double calculateBiImpl()>/new java.lang.Error/0	<simplejavacalculator.Calculator: java.lang.Double calculateBiImpl()>/$stack13	<simplejavacalculator.Calculator: java.lang.Double calculateBiImpl()>
<simplejavacalculator.UI: void <init>()>/new javax.swing.JButton/0	<simplejavacalculator.UI: void <init>()>/$stack47	<simplejavacalculator.UI: void <init>()>
<simplejavacalculator.UI: void <init>()>/new javax.swing.JPanel/3	<simplejavacalculator.UI: void <init>()>/$stack13	<simplejavacalculator.UI: void <init>()>
<simplejavacalculator.UI: void <init>()>/new java.awt.FlowLayout/0	<simplejavacalculator.UI: void <init>()>/$stack10	<simplejavacalculator.UI: void <init>()>
<simplejavacalculator.UI: void <init>()>/new javax.swing.JButton/14	<simplejavacalculator.UI: void <init>()>/$stack42	<simplejavacalculator.UI: void <init>()>
<simplejavacalculator.UI: void <init>()>/new javax.swing.JButton/9	<simplejavacalculator.UI: void <init>()>/$stack37	<simplejavacalculator.UI: void <init>()>
<simplejavacalculator.Calculator$MonoOperatorModes: void <clinit>()>/new simplejavacalculator.Calculator$MonoOperatorModes/4	<simplejavacalculator.Calculator$MonoOperatorModes: void <clinit>()>/$stack4	<simplejavacalculator.Calculator$MonoOperatorModes: void <clinit>()>
<simplejavacalculator.Calculator$BiOperatorModes: void <clinit>()>/new simplejavacalculator.Calculator$BiOperatorModes/3	<simplejavacalculator.Calculator$BiOperatorModes: void <clinit>()>/$stack3	<simplejavacalculator.Calculator$BiOperatorModes: void <clinit>()>
<simplejavacalculator.UI: void <init>()>/new java.awt.FlowLayout/7	<simplejavacalculator.UI: void <init>()>/$stack24	<simplejavacalculator.UI: void <init>()>
<simplejavacalculator.UI: void <init>()>/new javax.swing.JButton/6	<simplejavacalculator.UI: void <init>()>/$stack34	<simplejavacalculator.UI: void <init>()>
<simplejavacalculator.Calculator$MonoOperatorModes: void <clinit>()>/new simplejavacalculator.Calculator$MonoOperatorModes/2	<simplejavacalculator.Calculator$MonoOperatorModes: void <clinit>()>/$stack2	<simplejavacalculator.Calculator$MonoOperatorModes: void <clinit>()>
<simplejavacalculator.Calculator$MonoOperatorModes: void <clinit>()>/new simplejavacalculator.Calculator$MonoOperatorModes/5	<simplejavacalculator.Calculator$MonoOperatorModes: void <clinit>()>/$stack5	<simplejavacalculator.Calculator$MonoOperatorModes: void <clinit>()>
<simplejavacalculator.Calculator$BiOperatorModes: void <clinit>()>/new simplejavacalculator.Calculator$BiOperatorModes[]/0	<simplejavacalculator.Calculator$BiOperatorModes: void <clinit>()>/$stack6	<simplejavacalculator.Calculator$BiOperatorModes: void <clinit>()>
<simplejavacalculator.Calculator$BiOperatorModes: void <clinit>()>/new simplejavacalculator.Calculator$BiOperatorModes/4	<simplejavacalculator.Calculator$BiOperatorModes: void <clinit>()>/$stack4	<simplejavacalculator.Calculator$BiOperatorModes: void <clinit>()>
<simplejavacalculator.UI: void <init>()>/new javax.swing.JTextArea/0	<simplejavacalculator.UI: void <init>()>/$stack26	<simplejavacalculator.UI: void <init>()>
<simplejavacalculator.Calculator$MonoOperatorModes: void <clinit>()>/new simplejavacalculator.Calculator$MonoOperatorModes[]/0	<simplejavacalculator.Calculator$MonoOperatorModes: void <clinit>()>/$stack9	<simplejavacalculator.Calculator$MonoOperatorModes: void <clinit>()>
<simplejavacalculator.Calculator$MonoOperatorModes: void <clinit>()>/new simplejavacalculator.Calculator$MonoOperatorModes/7	<simplejavacalculator.Calculator$MonoOperatorModes: void <clinit>()>/$stack7	<simplejavacalculator.Calculator$MonoOperatorModes: void <clinit>()>
<simplejavacalculator.UI: void <init>()>/new javax.swing.JButton/2	<simplejavacalculator.UI: void <init>()>/$stack30	<simplejavacalculator.UI: void <init>()>
<simplejavacalculator.UI: void <init>()>/new javax.swing.JButton/5	<simplejavacalculator.UI: void <init>()>/$stack33	<simplejavacalculator.UI: void <init>()>
<simplejavacalculator.UI: void <init>()>/new javax.swing.JButton/4	<simplejavacalculator.UI: void <init>()>/$stack32	<simplejavacalculator.UI: void <init>()>
<simplejavacalculator.Calculator$BiOperatorModes: void <clinit>()>/new simplejavacalculator.Calculator$BiOperatorModes/5	<simplejavacalculator.Calculator$BiOperatorModes: void <clinit>()>/$stack5	<simplejavacalculator.Calculator$BiOperatorModes: void <clinit>()>
<simplejavacalculator.UI: void <init>()>/new simplejavacalculator.Calculator/0	<simplejavacalculator.UI: void <init>()>/$stack46	<simplejavacalculator.UI: void <init>()>
<simplejavacalculator.UI: void <init>()>/new javax.swing.JButton/17	<simplejavacalculator.UI: void <init>()>/$stack45	<simplejavacalculator.UI: void <init>()>
<simplejavacalculator.Calculator$BiOperatorModes: void <clinit>()>/new simplejavacalculator.Calculator$BiOperatorModes/2	<simplejavacalculator.Calculator$BiOperatorModes: void <clinit>()>/$stack2	<simplejavacalculator.Calculator$BiOperatorModes: void <clinit>()>
<simplejavacalculator.Calculator$BiOperatorModes: void <clinit>()>/new simplejavacalculator.Calculator$BiOperatorModes/0	<simplejavacalculator.Calculator$BiOperatorModes: void <clinit>()>/$stack0	<simplejavacalculator.Calculator$BiOperatorModes: void <clinit>()>
<simplejavacalculator.UI: void <init>()>/new javax.swing.JButton/7	<simplejavacalculator.UI: void <init>()>/$stack35	<simplejavacalculator.UI: void <init>()>
<simplejavacalculator.UI: void <init>()>/new javax.swing.JButton/12	<simplejavacalculator.UI: void <init>()>/$stack40	<simplejavacalculator.UI: void <init>()>
<simplejavacalculator.Calculator$MonoOperatorModes: void <clinit>()>/new simplejavacalculator.Calculator$MonoOperatorModes/0	<simplejavacalculator.Calculator$MonoOperatorModes: void <clinit>()>/$stack0	<simplejavacalculator.Calculator$MonoOperatorModes: void <clinit>()>
<simplejavacalculator.UI: void <init>()>/new javax.swing.JButton/16	<simplejavacalculator.UI: void <init>()>/$stack44	<simplejavacalculator.UI: void <init>()>
<simplejavacalculator.UI: void <init>()>/new javax.swing.JFrame/0	<simplejavacalculator.UI: void <init>()>/$stack3	<simplejavacalculator.UI: void <init>()>
<simplejavacalculator.UI: void <init>()>/new java.lang.String[]/0	<simplejavacalculator.UI: void <init>()>/$stack2	<simplejavacalculator.UI: void <init>()>
<simplejavacalculator.Calculator: java.lang.Double calculateMono(simplejavacalculator.Calculator$MonoOperatorModes,java.lang.Double)>/new java.lang.Error/0	<simplejavacalculator.Calculator: java.lang.Double calculateMono(simplejavacalculator.Calculator$MonoOperatorModes,java.lang.Double)>/$stack12	<simplejavacalculator.Calculator: java.lang.Double calculateMono(simplejavacalculator.Calculator$MonoOperatorModes,java.lang.Double)>
<simplejavacalculator.UI: void <init>()>/new java.awt.Font/1	<simplejavacalculator.UI: void <init>()>/$stack27	<simplejavacalculator.UI: void <init>()>
<simplejavacalculator.UI: void <init>()>/new javax.swing.JButton/13	<simplejavacalculator.UI: void <init>()>/$stack41	<simplejavacalculator.UI: void <init>()>
<simplejavacalculator.UI: void <init>()>/new javax.swing.JButton/8	<simplejavacalculator.UI: void <init>()>/$stack36	<simplejavacalculator.UI: void <init>()>
<simplejavacalculator.UI: void <init>()>/new javax.swing.JButton/15	<simplejavacalculator.UI: void <init>()>/$stack43	<simplejavacalculator.UI: void <init>()>
<simplejavacalculator.Calculator$MonoOperatorModes: void <clinit>()>/new simplejavacalculator.Calculator$MonoOperatorModes/3	<simplejavacalculator.Calculator$MonoOperatorModes: void <clinit>()>/$stack3	<simplejavacalculator.Calculator$MonoOperatorModes: void <clinit>()>
<simplejavacalculator.UI: void <init>()>/new javax.swing.JButton/1	<simplejavacalculator.UI: void <init>()>/$stack29	<simplejavacalculator.UI: void <init>()>
<simplejavacalculator.UI: void <init>()>/new javax.swing.JButton/11	<simplejavacalculator.UI: void <init>()>/$stack39	<simplejavacalculator.UI: void <init>()>
<simplejavacalculator.UI: void parsetoBinary()>/new java.lang.StringBuilder/1	<simplejavacalculator.UI: void parsetoBinary()>/$stack12	<simplejavacalculator.UI: void parsetoBinary()>
<simplejavacalculator.UI: void <init>()>/new javax.swing.JButton/10	<simplejavacalculator.UI: void <init>()>/$stack38	<simplejavacalculator.UI: void <init>()>
<simplejavacalculator.SimpleJavaCalculator: void main(java.lang.String[])>/new simplejavacalculator.UI/0	<simplejavacalculator.SimpleJavaCalculator: void main(java.lang.String[])>/$stack2	<simplejavacalculator.SimpleJavaCalculator: void main(java.lang.String[])>
<simplejavacalculator.UI: void <init>()>/new javax.swing.JButton/3	<simplejavacalculator.UI: void <init>()>/$stack31	<simplejavacalculator.UI: void <init>()>
<simplejavacalculator.Calculator$MonoOperatorModes: void <clinit>()>/new simplejavacalculator.Calculator$MonoOperatorModes/1	<simplejavacalculator.Calculator$MonoOperatorModes: void <clinit>()>/$stack1	<simplejavacalculator.Calculator$MonoOperatorModes: void <clinit>()>
<simplejavacalculator.Calculator$BiOperatorModes: void <clinit>()>/new simplejavacalculator.Calculator$BiOperatorModes/1	<simplejavacalculator.Calculator$BiOperatorModes: void <clinit>()>/$stack1	<simplejavacalculator.Calculator$BiOperatorModes: void <clinit>()>
<simplejavacalculator.UI: void parsetoBinary()>/new java.lang.StringBuilder/0	<simplejavacalculator.UI: void parsetoBinary()>/$stack2	<simplejavacalculator.UI: void parsetoBinary()>
<simplejavacalculator.UI: void <init>()>/new java.awt.Font/0	<simplejavacalculator.UI: void <init>()>/$stack25	<simplejavacalculator.UI: void <init>()>
<simplejavacalculator.UI: void <init>()>/new javax.swing.JPanel/0	<simplejavacalculator.UI: void <init>()>/$stack5	<simplejavacalculator.UI: void <init>()>
<simplejavacalculator.UI: void <init>()>/new javax.swing.JPanel/1	<simplejavacalculator.UI: void <init>()>/$stack9	<simplejavacalculator.UI: void <init>()>
<simplejavacalculator.UI: void <init>()>/new javax.swing.JPanel/5	<simplejavacalculator.UI: void <init>()>/$stack17	<simplejavacalculator.UI: void <init>()>
<simplejavacalculator.UI: void <init>()>/new javax.swing.JPanel/4	<simplejavacalculator.UI: void <init>()>/$stack15	<simplejavacalculator.UI: void <init>()>
<simplejavacalculator.UI: void <init>()>/new javax.swing.JPanel/8	<simplejavacalculator.UI: void <init>()>/$stack23	<simplejavacalculator.UI: void <init>()>
<simplejavacalculator.UI: void <init>()>/new java.awt.FlowLayout/4	<simplejavacalculator.UI: void <init>()>/$stack18	<simplejavacalculator.UI: void <init>()>
<simplejavacalculator.UI: void <init>()>/new javax.swing.JPanel/6	<simplejavacalculator.UI: void <init>()>/$stack19	<simplejavacalculator.UI: void <init>()>
<simplejavacalculator.UI: void <init>()>/new java.awt.FlowLayout/6	<simplejavacalculator.UI: void <init>()>/$stack22	<simplejavacalculator.UI: void <init>()>
<simplejavacalculator.UI: void <init>()>/new java.awt.FlowLayout/3	<simplejavacalculator.UI: void <init>()>/$stack16	<simplejavacalculator.UI: void <init>()>
<simplejavacalculator.UI: void <init>()>/new javax.swing.JButton[]/0	<simplejavacalculator.UI: void <init>()>/$stack28	<simplejavacalculator.UI: void <init>()>
<simplejavacalculator.UI: void <init>()>/new java.awt.FlowLayout/2	<simplejavacalculator.UI: void <init>()>/$stack14	<simplejavacalculator.UI: void <init>()>
<simplejavacalculator.UI: void <init>()>/new java.awt.FlowLayout/1	<simplejavacalculator.UI: void <init>()>/$stack12	<simplejavacalculator.UI: void <init>()>
<simplejavacalculator.UI: void <init>()>/new javax.swing.BoxLayout/0	<simplejavacalculator.UI: void <init>()>/$stack6	<simplejavacalculator.UI: void <init>()>
<simplejavacalculator.UI: void <init>()>/new javax.swing.JPanel/7	<simplejavacalculator.UI: void <init>()>/$stack21	<simplejavacalculator.UI: void <init>()>
<simplejavacalculator.UI: void <init>()>/new java.awt.FlowLayout/5	<simplejavacalculator.UI: void <init>()>/$stack20	<simplejavacalculator.UI: void <init>()>
<simplejavacalculator.UI: void <init>()>/new javax.swing.JPanel/2	<simplejavacalculator.UI: void <init>()>/$stack11	<simplejavacalculator.UI: void <init>()>
/	<simplejavacalculator.UI: void <init>()>/$stringconstant17	<simplejavacalculator.UI: void <init>()>
Sin	<simplejavacalculator.UI: void <init>()>/$stringconstant23	<simplejavacalculator.UI: void <init>()>
multiply	<simplejavacalculator.Calculator$BiOperatorModes: void <clinit>()>/$stringconstant3	<simplejavacalculator.Calculator$BiOperatorModes: void <clinit>()>
4	<simplejavacalculator.UI: void <init>()>/$stringconstant4	<simplejavacalculator.UI: void <init>()>
7	<simplejavacalculator.UI: void <init>()>/$stringconstant7	<simplejavacalculator.UI: void <init>()>
cos	<simplejavacalculator.Calculator$MonoOperatorModes: void <clinit>()>/$stringconstant3	<simplejavacalculator.Calculator$MonoOperatorModes: void <clinit>()>
Tan	<simplejavacalculator.UI: void <init>()>/$stringconstant24	<simplejavacalculator.UI: void <init>()>
log	<simplejavacalculator.Calculator$MonoOperatorModes: void <clinit>()>/$stringconstant6	<simplejavacalculator.Calculator$MonoOperatorModes: void <clinit>()>
5	<simplejavacalculator.UI: void <init>()>/$stringconstant5	<simplejavacalculator.UI: void <init>()>
x^y	<simplejavacalculator.UI: void <init>()>/$stringconstant25	<simplejavacalculator.UI: void <init>()>
divide	<simplejavacalculator.Calculator$BiOperatorModes: void <clinit>()>/$stringconstant4	<simplejavacalculator.Calculator$BiOperatorModes: void <clinit>()>
6	<simplejavacalculator.UI: void <init>()>/$stringconstant6	<simplejavacalculator.UI: void <init>()>
minus	<simplejavacalculator.Calculator$BiOperatorModes: void <clinit>()>/$stringconstant2	<simplejavacalculator.Calculator$BiOperatorModes: void <clinit>()>
C	<simplejavacalculator.UI: void <init>()>/$stringconstant29	<simplejavacalculator.UI: void <init>()>
oneDevidedBy	<simplejavacalculator.Calculator$MonoOperatorModes: void <clinit>()>/$stringconstant2	<simplejavacalculator.Calculator$MonoOperatorModes: void <clinit>()>
tan	<simplejavacalculator.Calculator$MonoOperatorModes: void <clinit>()>/$stringconstant5	<simplejavacalculator.Calculator$MonoOperatorModes: void <clinit>()>
1/x	<simplejavacalculator.UI: void <init>()>/$stringconstant21	<simplejavacalculator.UI: void <init>()>
abs	<simplejavacalculator.Calculator$MonoOperatorModes: void <clinit>()>/$stringconstant8	<simplejavacalculator.Calculator$MonoOperatorModes: void <clinit>()>
log10(x)	<simplejavacalculator.UI: void <init>()>/$stringconstant26	<simplejavacalculator.UI: void <init>()>
squareRoot	<simplejavacalculator.Calculator$MonoOperatorModes: void <clinit>()>/$stringconstant1	<simplejavacalculator.Calculator$MonoOperatorModes: void <clinit>()>
xpowerofy	<simplejavacalculator.Calculator$BiOperatorModes: void <clinit>()>/$stringconstant5	<simplejavacalculator.Calculator$BiOperatorModes: void <clinit>()>
sqrt	<simplejavacalculator.UI: void <init>()>/$stringconstant19	<simplejavacalculator.UI: void <init>()>
icon/icon.png	<simplejavacalculator.UI: void <init>()>/$stringconstant11	<simplejavacalculator.UI: void <init>()>
*	<simplejavacalculator.UI: void <init>()>/$stringconstant16	<simplejavacalculator.UI: void <init>()>
=	<simplejavacalculator.UI: void <init>()>/$stringconstant18	<simplejavacalculator.UI: void <init>()>
abs(x)	<simplejavacalculator.UI: void <init>()>/$stringconstant28	<simplejavacalculator.UI: void <init>()>
normal	<simplejavacalculator.Calculator$BiOperatorModes: void <clinit>()>/$stringconstant0	<simplejavacalculator.Calculator$BiOperatorModes: void <clinit>()>
Error while parse to binary.	<simplejavacalculator.UI: void parsetoBinary()>/$stringconstant1	<simplejavacalculator.UI: void parsetoBinary()>
add	<simplejavacalculator.Calculator$BiOperatorModes: void <clinit>()>/$stringconstant1	<simplejavacalculator.Calculator$BiOperatorModes: void <clinit>()>
Consolas	<simplejavacalculator.UI: void <init>()>/$stringconstant12	<simplejavacalculator.UI: void <init>()>
Consolas	<simplejavacalculator.UI: void <init>()>/$stringconstant13	<simplejavacalculator.UI: void <init>()>
x%	<simplejavacalculator.UI: void <init>()>/$stringconstant27	<simplejavacalculator.UI: void <init>()>
rate	<simplejavacalculator.Calculator$MonoOperatorModes: void <clinit>()>/$stringconstant7	<simplejavacalculator.Calculator$MonoOperatorModes: void <clinit>()>
Calculator PH	<simplejavacalculator.UI: void <init>()>/$stringconstant10	<simplejavacalculator.UI: void <init>()>
square	<simplejavacalculator.Calculator$MonoOperatorModes: void <clinit>()>/$stringconstant0	<simplejavacalculator.Calculator$MonoOperatorModes: void <clinit>()>
-	<simplejavacalculator.UI: void <init>()>/$stringconstant15	<simplejavacalculator.UI: void <init>()>
sin	<simplejavacalculator.Calculator$MonoOperatorModes: void <clinit>()>/$stringconstant4	<simplejavacalculator.Calculator$MonoOperatorModes: void <clinit>()>
+	<simplejavacalculator.UI: void <init>()>/$stringconstant14	<simplejavacalculator.UI: void <init>()>
Bin	<simplejavacalculator.UI: void <init>()>/$stringconstant30	<simplejavacalculator.UI: void <init>()>
x*x	<simplejavacalculator.UI: void <init>()>/$stringconstant20	<simplejavacalculator.UI: void <init>()>
"<<\\""\\"">>"	<simplejavacalculator.UI: void parsetoBinary()>/$stringconstant0	<simplejavacalculator.UI: void parsetoBinary()>
"<<\\""\\"">>"	<simplejavacalculator.UI: void writer(java.lang.Double)>/$stringconstant0	<simplejavacalculator.UI: void writer(java.lang.Double)>
8	<simplejavacalculator.UI: void <init>()>/$stringconstant8	<simplejavacalculator.UI: void <init>()>
Cos	<simplejavacalculator.UI: void <init>()>/$stringconstant22	<simplejavacalculator.UI: void <init>()>
9	<simplejavacalculator.UI: void <init>()>/$stringconstant9	<simplejavacalculator.UI: void <init>()>
3	<simplejavacalculator.UI: void <init>()>/$stringconstant3	<simplejavacalculator.UI: void <init>()>
<class simplejavacalculator.Calculator$MonoOperatorModes>	<simplejavacalculator.Calculator$MonoOperatorModes: simplejavacalculator.Calculator$MonoOperatorModes valueOf(java.lang.String)>/$classconstant0	<simplejavacalculator.Calculator$MonoOperatorModes: simplejavacalculator.Calculator$MonoOperatorModes valueOf(java.lang.String)>
<class simplejavacalculator.Calculator$BiOperatorModes>	<simplejavacalculator.Calculator$BiOperatorModes: simplejavacalculator.Calculator$BiOperatorModes valueOf(java.lang.String)>/$classconstant0	<simplejavacalculator.Calculator$BiOperatorModes: simplejavacalculator.Calculator$BiOperatorModes valueOf(java.lang.String)>
