<simplejavacalculator.Calculator$BiOperatorModes: simplejavacalculator.Calculator$BiOperatorModes multiply>	simplejavacalculator.Calculator$BiOperatorModes
<simplejavacalculator.Calculator: java.lang.Double num2>	simplejavacalculator.Calculator
<simplejavacalculator.UI: simplejavacalculator.Calculator calc>	simplejavacalculator.UI
<simplejavacalculator.UI: javax.swing.JPanel panel>	simplejavacalculator.UI
<simplejavacalculator.UI: javax.swing.JButton butOneDevidedBy>	simplejavacalculator.UI
<simplejavacalculator.UI: java.awt.Font font>	simplejavacalculator.UI
<simplejavacalculator.Calculator$BiOperatorModes: simplejavacalculator.Calculator$BiOperatorModes minus>	simplejavacalculator.Calculator$BiOperatorModes
<simplejavacalculator.UI: javax.swing.ImageIcon image>	simplejavacalculator.UI
<simplejavacalculator.UI: javax.swing.JButton butSquareRoot>	simplejavacalculator.UI
<simplejavacalculator.UI: javax.swing.JButton butDivide>	simplejavacalculator.UI
<simplejavacalculator.Calculator$MonoOperatorModes: simplejavacalculator.Calculator$MonoOperatorModes square>	simplejavacalculator.Calculator$MonoOperatorModes
<simplejavacalculator.Calculator$MonoOperatorModes: simplejavacalculator.Calculator$MonoOperatorModes log>	simplejavacalculator.Calculator$MonoOperatorModes
<simplejavacalculator.Calculator$MonoOperatorModes: simplejavacalculator.Calculator$MonoOperatorModes oneDevidedBy>	simplejavacalculator.Calculator$MonoOperatorModes
<simplejavacalculator.UI: javax.swing.JButton butTan>	simplejavacalculator.UI
<simplejavacalculator.Calculator$MonoOperatorModes: simplejavacalculator.Calculator$MonoOperatorModes abs>	simplejavacalculator.Calculator$MonoOperatorModes
<simplejavacalculator.UI: javax.swing.JButton butAdd>	simplejavacalculator.UI
<simplejavacalculator.Calculator$MonoOperatorModes: simplejavacalculator.Calculator$MonoOperatorModes[] $VALUES>	simplejavacalculator.Calculator$MonoOperatorModes
<simplejavacalculator.Calculator$MonoOperatorModes: simplejavacalculator.Calculator$MonoOperatorModes cos>	simplejavacalculator.Calculator$MonoOperatorModes
<simplejavacalculator.UI: javax.swing.JPanel panelSub2>	simplejavacalculator.UI
<simplejavacalculator.UI: javax.swing.JButton butCancel>	simplejavacalculator.UI
<simplejavacalculator.UI: javax.swing.JButton butlog>	simplejavacalculator.UI
<simplejavacalculator.UI: javax.swing.JPanel panelSub5>	simplejavacalculator.UI
<simplejavacalculator.UI: javax.swing.JPanel panelSub4>	simplejavacalculator.UI
<simplejavacalculator.Calculator$MonoOperatorModes: simplejavacalculator.Calculator$MonoOperatorModes rate>	simplejavacalculator.Calculator$MonoOperatorModes
<simplejavacalculator.Calculator$MonoOperatorModes: simplejavacalculator.Calculator$MonoOperatorModes sin>	simplejavacalculator.Calculator$MonoOperatorModes
<simplejavacalculator.UI: java.lang.String[] buttonValue>	simplejavacalculator.UI
<simplejavacalculator.Calculator$BiOperatorModes: simplejavacalculator.Calculator$BiOperatorModes add>	simplejavacalculator.Calculator$BiOperatorModes
<simplejavacalculator.UI: javax.swing.JPanel panelSub6>	simplejavacalculator.UI
<simplejavacalculator.UI: javax.swing.JButton butSquare>	simplejavacalculator.UI
<simplejavacalculator.UI: javax.swing.JButton butSin>	simplejavacalculator.UI
<simplejavacalculator.UI: javax.swing.JPanel panelSub3>	simplejavacalculator.UI
<simplejavacalculator.UI: javax.swing.JButton butMinus>	simplejavacalculator.UI
<simplejavacalculator.UI: javax.swing.JButton butabs>	simplejavacalculator.UI
<simplejavacalculator.Calculator: java.lang.Double num1>	simplejavacalculator.Calculator
<simplejavacalculator.Calculator$MonoOperatorModes: simplejavacalculator.Calculator$MonoOperatorModes tan>	simplejavacalculator.Calculator$MonoOperatorModes
<simplejavacalculator.UI: javax.swing.JButton butxpowerofy>	simplejavacalculator.UI
<simplejavacalculator.Calculator$BiOperatorModes: simplejavacalculator.Calculator$BiOperatorModes divide>	simplejavacalculator.Calculator$BiOperatorModes
<simplejavacalculator.UI: javax.swing.JButton butMultiply>	simplejavacalculator.UI
<simplejavacalculator.UI: javax.swing.JFrame frame>	simplejavacalculator.UI
<simplejavacalculator.Calculator$MonoOperatorModes: simplejavacalculator.Calculator$MonoOperatorModes squareRoot>	simplejavacalculator.Calculator$MonoOperatorModes
<java.lang.System: java.io.PrintStream err>	java.lang.System
<simplejavacalculator.UI: javax.swing.JButton butrate>	simplejavacalculator.UI
<simplejavacalculator.UI: javax.swing.JPanel panelSub8>	simplejavacalculator.UI
<simplejavacalculator.UI: javax.swing.JButton[] but>	simplejavacalculator.UI
<simplejavacalculator.UI: javax.swing.JButton butCos>	simplejavacalculator.UI
<simplejavacalculator.Calculator$BiOperatorModes: simplejavacalculator.Calculator$BiOperatorModes[] $VALUES>	simplejavacalculator.Calculator$BiOperatorModes
<simplejavacalculator.UI: javax.swing.JButton butEqual>	simplejavacalculator.UI
<simplejavacalculator.UI: javax.swing.JPanel panelSub7>	simplejavacalculator.UI
<simplejavacalculator.Calculator$BiOperatorModes: simplejavacalculator.Calculator$BiOperatorModes xpowerofy>	simplejavacalculator.Calculator$BiOperatorModes
<simplejavacalculator.UI: javax.swing.JTextArea text>	simplejavacalculator.UI
<simplejavacalculator.Calculator$BiOperatorModes: simplejavacalculator.Calculator$BiOperatorModes normal>	simplejavacalculator.Calculator$BiOperatorModes
<simplejavacalculator.Calculator: simplejavacalculator.Calculator$BiOperatorModes mode>	simplejavacalculator.Calculator
<simplejavacalculator.UI: javax.swing.JButton butBinary>	simplejavacalculator.UI
<simplejavacalculator.UI: java.awt.Font textFont>	simplejavacalculator.UI
<simplejavacalculator.UI: javax.swing.JPanel panelSub1>	simplejavacalculator.UI
