<simplejavacalculator.UI: void <init>()>/new javax.swing.ImageIcon/0	<simplejavacalculator.UI: javax.swing.ImageIcon image>	<simplejavacalculator.SimpleJavaCalculator: void main(java.lang.String[])>/new simplejavacalculator.UI/0
<simplejavacalculator.UI: void <init>()>/new javax.swing.JPanel/3	<simplejavacalculator.UI: javax.swing.JPanel panelSub3>	<simplejavacalculator.SimpleJavaCalculator: void main(java.lang.String[])>/new simplejavacalculator.UI/0
<simplejavacalculator.UI: void <init>()>/new javax.swing.JButton/14	<simplejavacalculator.UI: javax.swing.JButton butrate>	<simplejavacalculator.SimpleJavaCalculator: void main(java.lang.String[])>/new simplejavacalculator.UI/0
<simplejavacalculator.UI: void <init>()>/new javax.swing.JButton/9	<simplejavacalculator.UI: javax.swing.JButton butCos>	<simplejavacalculator.SimpleJavaCalculator: void main(java.lang.String[])>/new simplejavacalculator.UI/0
<simplejavacalculator.UI: void <init>()>/new javax.swing.JButton/6	<simplejavacalculator.UI: javax.swing.JButton butSquareRoot>	<simplejavacalculator.SimpleJavaCalculator: void main(java.lang.String[])>/new simplejavacalculator.UI/0
<simplejavacalculator.UI: void <init>()>/new javax.swing.JTextArea/0	<simplejavacalculator.UI: javax.swing.JTextArea text>	<simplejavacalculator.SimpleJavaCalculator: void main(java.lang.String[])>/new simplejavacalculator.UI/0
<simplejavacalculator.UI: void <init>()>/new javax.swing.JButton/2	<simplejavacalculator.UI: javax.swing.JButton butMinus>	<simplejavacalculator.SimpleJavaCalculator: void main(java.lang.String[])>/new simplejavacalculator.UI/0
<simplejavacalculator.UI: void <init>()>/new javax.swing.JButton/5	<simplejavacalculator.UI: javax.swing.JButton butEqual>	<simplejavacalculator.SimpleJavaCalculator: void main(java.lang.String[])>/new simplejavacalculator.UI/0
<simplejavacalculator.UI: void <init>()>/new javax.swing.JButton/4	<simplejavacalculator.UI: javax.swing.JButton butDivide>	<simplejavacalculator.SimpleJavaCalculator: void main(java.lang.String[])>/new simplejavacalculator.UI/0
<simplejavacalculator.UI: void <init>()>/new simplejavacalculator.Calculator/0	<simplejavacalculator.UI: simplejavacalculator.Calculator calc>	<simplejavacalculator.SimpleJavaCalculator: void main(java.lang.String[])>/new simplejavacalculator.UI/0
<simplejavacalculator.UI: void <init>()>/new javax.swing.JButton/17	<simplejavacalculator.UI: javax.swing.JButton butBinary>	<simplejavacalculator.SimpleJavaCalculator: void main(java.lang.String[])>/new simplejavacalculator.UI/0
<simplejavacalculator.Calculator$BiOperatorModes: void <clinit>()>/new simplejavacalculator.Calculator$BiOperatorModes/0	<simplejavacalculator.Calculator: simplejavacalculator.Calculator$BiOperatorModes mode>	<simplejavacalculator.UI: void <init>()>/new simplejavacalculator.Calculator/0
<simplejavacalculator.UI: void <init>()>/new javax.swing.JButton/7	<simplejavacalculator.UI: javax.swing.JButton butSquare>	<simplejavacalculator.SimpleJavaCalculator: void main(java.lang.String[])>/new simplejavacalculator.UI/0
<simplejavacalculator.UI: void <init>()>/new javax.swing.JButton/12	<simplejavacalculator.UI: javax.swing.JButton butxpowerofy>	<simplejavacalculator.SimpleJavaCalculator: void main(java.lang.String[])>/new simplejavacalculator.UI/0
<simplejavacalculator.UI: void <init>()>/new javax.swing.JButton/16	<simplejavacalculator.UI: javax.swing.JButton butCancel>	<simplejavacalculator.SimpleJavaCalculator: void main(java.lang.String[])>/new simplejavacalculator.UI/0
<simplejavacalculator.UI: void <init>()>/new javax.swing.JFrame/0	<simplejavacalculator.UI: javax.swing.JFrame frame>	<simplejavacalculator.SimpleJavaCalculator: void main(java.lang.String[])>/new simplejavacalculator.UI/0
<simplejavacalculator.UI: void <init>()>/new java.lang.String[]/0	<simplejavacalculator.UI: java.lang.String[] buttonValue>	<simplejavacalculator.SimpleJavaCalculator: void main(java.lang.String[])>/new simplejavacalculator.UI/0
<simplejavacalculator.UI: void <init>()>/new java.awt.Font/1	<simplejavacalculator.UI: java.awt.Font textFont>	<simplejavacalculator.SimpleJavaCalculator: void main(java.lang.String[])>/new simplejavacalculator.UI/0
<simplejavacalculator.UI: void <init>()>/new javax.swing.JButton/13	<simplejavacalculator.UI: javax.swing.JButton butlog>	<simplejavacalculator.SimpleJavaCalculator: void main(java.lang.String[])>/new simplejavacalculator.UI/0
<simplejavacalculator.UI: void <init>()>/new javax.swing.JButton/8	<simplejavacalculator.UI: javax.swing.JButton butOneDevidedBy>	<simplejavacalculator.SimpleJavaCalculator: void main(java.lang.String[])>/new simplejavacalculator.UI/0
<simplejavacalculator.UI: void <init>()>/new javax.swing.JButton/15	<simplejavacalculator.UI: javax.swing.JButton butabs>	<simplejavacalculator.SimpleJavaCalculator: void main(java.lang.String[])>/new simplejavacalculator.UI/0
<simplejavacalculator.UI: void <init>()>/new javax.swing.JButton/1	<simplejavacalculator.UI: javax.swing.JButton butAdd>	<simplejavacalculator.SimpleJavaCalculator: void main(java.lang.String[])>/new simplejavacalculator.UI/0
<simplejavacalculator.UI: void <init>()>/new javax.swing.JButton/11	<simplejavacalculator.UI: javax.swing.JButton butTan>	<simplejavacalculator.SimpleJavaCalculator: void main(java.lang.String[])>/new simplejavacalculator.UI/0
<simplejavacalculator.UI: void <init>()>/new javax.swing.JButton/10	<simplejavacalculator.UI: javax.swing.JButton butSin>	<simplejavacalculator.SimpleJavaCalculator: void main(java.lang.String[])>/new simplejavacalculator.UI/0
<simplejavacalculator.UI: void <init>()>/new javax.swing.JButton/3	<simplejavacalculator.UI: javax.swing.JButton butMultiply>	<simplejavacalculator.SimpleJavaCalculator: void main(java.lang.String[])>/new simplejavacalculator.UI/0
<simplejavacalculator.UI: void <init>()>/new java.awt.Font/0	<simplejavacalculator.UI: java.awt.Font font>	<simplejavacalculator.SimpleJavaCalculator: void main(java.lang.String[])>/new simplejavacalculator.UI/0
<simplejavacalculator.UI: void <init>()>/new javax.swing.JPanel/0	<simplejavacalculator.UI: javax.swing.JPanel panel>	<simplejavacalculator.SimpleJavaCalculator: void main(java.lang.String[])>/new simplejavacalculator.UI/0
<simplejavacalculator.UI: void <init>()>/new javax.swing.JPanel/1	<simplejavacalculator.UI: javax.swing.JPanel panelSub1>	<simplejavacalculator.SimpleJavaCalculator: void main(java.lang.String[])>/new simplejavacalculator.UI/0
<simplejavacalculator.UI: void <init>()>/new javax.swing.JPanel/5	<simplejavacalculator.UI: javax.swing.JPanel panelSub5>	<simplejavacalculator.SimpleJavaCalculator: void main(java.lang.String[])>/new simplejavacalculator.UI/0
<simplejavacalculator.UI: void <init>()>/new javax.swing.JPanel/4	<simplejavacalculator.UI: javax.swing.JPanel panelSub4>	<simplejavacalculator.SimpleJavaCalculator: void main(java.lang.String[])>/new simplejavacalculator.UI/0
<simplejavacalculator.UI: void <init>()>/new javax.swing.JPanel/8	<simplejavacalculator.UI: javax.swing.JPanel panelSub8>	<simplejavacalculator.SimpleJavaCalculator: void main(java.lang.String[])>/new simplejavacalculator.UI/0
<simplejavacalculator.UI: void <init>()>/new javax.swing.JPanel/6	<simplejavacalculator.UI: javax.swing.JPanel panelSub6>	<simplejavacalculator.SimpleJavaCalculator: void main(java.lang.String[])>/new simplejavacalculator.UI/0
<simplejavacalculator.UI: void <init>()>/new javax.swing.JButton[]/0	<simplejavacalculator.UI: javax.swing.JButton[] but>	<simplejavacalculator.SimpleJavaCalculator: void main(java.lang.String[])>/new simplejavacalculator.UI/0
<simplejavacalculator.UI: void <init>()>/new javax.swing.JPanel/7	<simplejavacalculator.UI: javax.swing.JPanel panelSub7>	<simplejavacalculator.SimpleJavaCalculator: void main(java.lang.String[])>/new simplejavacalculator.UI/0
<simplejavacalculator.UI: void <init>()>/new javax.swing.JPanel/2	<simplejavacalculator.UI: javax.swing.JPanel panelSub2>	<simplejavacalculator.SimpleJavaCalculator: void main(java.lang.String[])>/new simplejavacalculator.UI/0
