<simplejavacalculator.UI: void actionPerformed(java.awt.event.ActionEvent)>/simplejavacalculator.UI.reader/14	java.lang.Double()
<simplejavacalculator.UI: void actionPerformed(java.awt.event.ActionEvent)>/simplejavacalculator.UI.writer/15	void(java.lang.Double)
<simplejavacalculator.UI: void actionPerformed(java.awt.event.ActionEvent)>/simplejavacalculator.UI.writer/9	void(java.lang.Double)
<simplejavacalculator.UI: void actionPerformed(java.awt.event.ActionEvent)>/simplejavacalculator.UI.writer/11	void(java.lang.Double)
<simplejavacalculator.UI: void actionPerformed(java.awt.event.ActionEvent)>/simplejavacalculator.UI.writer/13	void(java.lang.Double)
<simplejavacalculator.UI: void actionPerformed(java.awt.event.ActionEvent)>/simplejavacalculator.UI.reader/1	java.lang.Double()
<simplejavacalculator.UI: void actionPerformed(java.awt.event.ActionEvent)>/simplejavacalculator.UI.writer/1	void(java.lang.Double)
<simplejavacalculator.UI: void actionPerformed(java.awt.event.ActionEvent)>/simplejavacalculator.UI.reader/5	java.lang.Double()
<simplejavacalculator.UI: void actionPerformed(java.awt.event.ActionEvent)>/simplejavacalculator.Calculator.reset/0	java.lang.Double()
<simplejavacalculator.UI: void actionPerformed(java.awt.event.ActionEvent)>/simplejavacalculator.UI.writer/4	void(java.lang.Double)
<simplejavacalculator.UI: void actionPerformed(java.awt.event.ActionEvent)>/simplejavacalculator.UI.reader/4	java.lang.Double()
<simplejavacalculator.UI: void actionPerformed(java.awt.event.ActionEvent)>/simplejavacalculator.Calculator.calculateMono/6	java.lang.Double(simplejavacalculator.Calculator$MonoOperatorModes,java.lang.Double)
<simplejavacalculator.UI: void actionPerformed(java.awt.event.ActionEvent)>/simplejavacalculator.UI.writer/12	void(java.lang.Double)
<simplejavacalculator.UI: void actionPerformed(java.awt.event.ActionEvent)>/simplejavacalculator.Calculator.calculateBi/3	java.lang.Double(simplejavacalculator.Calculator$BiOperatorModes,java.lang.Double)
<simplejavacalculator.UI: void actionPerformed(java.awt.event.ActionEvent)>/simplejavacalculator.UI.reader/0	java.lang.Double()
<simplejavacalculator.UI: void actionPerformed(java.awt.event.ActionEvent)>/simplejavacalculator.UI.writer/5	void(java.lang.Double)
<simplejavacalculator.UI: void actionPerformed(java.awt.event.ActionEvent)>/simplejavacalculator.UI.reader/10	java.lang.Double()
<simplejavacalculator.SimpleJavaCalculator: void main(java.lang.String[])>/simplejavacalculator.UI.init/0	void()
<simplejavacalculator.UI: void actionPerformed(java.awt.event.ActionEvent)>/simplejavacalculator.Calculator.calculateBi/1	java.lang.Double(simplejavacalculator.Calculator$BiOperatorModes,java.lang.Double)
<simplejavacalculator.UI: void actionPerformed(java.awt.event.ActionEvent)>/simplejavacalculator.Calculator.calculateBi/4	java.lang.Double(simplejavacalculator.Calculator$BiOperatorModes,java.lang.Double)
<simplejavacalculator.Calculator: java.lang.Double calculateEqual(java.lang.Double)>/simplejavacalculator.Calculator.calculateBi/0	java.lang.Double(simplejavacalculator.Calculator$BiOperatorModes,java.lang.Double)
<simplejavacalculator.UI: void actionPerformed(java.awt.event.ActionEvent)>/simplejavacalculator.Calculator.calculateMono/8	java.lang.Double(simplejavacalculator.Calculator$MonoOperatorModes,java.lang.Double)
<simplejavacalculator.UI: void actionPerformed(java.awt.event.ActionEvent)>/simplejavacalculator.Calculator.calculateEqual/0	java.lang.Double(java.lang.Double)
<simplejavacalculator.UI: void actionPerformed(java.awt.event.ActionEvent)>/simplejavacalculator.UI.reader/13	java.lang.Double()
<simplejavacalculator.UI: void actionPerformed(java.awt.event.ActionEvent)>/simplejavacalculator.Calculator.calculateMono/7	java.lang.Double(simplejavacalculator.Calculator$MonoOperatorModes,java.lang.Double)
<simplejavacalculator.UI: void actionPerformed(java.awt.event.ActionEvent)>/simplejavacalculator.UI.writer/10	void(java.lang.Double)
<simplejavacalculator.UI: void actionPerformed(java.awt.event.ActionEvent)>/simplejavacalculator.UI.writer/0	void(java.lang.Double)
<simplejavacalculator.UI: void actionPerformed(java.awt.event.ActionEvent)>/simplejavacalculator.UI.writer/2	void(java.lang.Double)
<simplejavacalculator.UI: void actionPerformed(java.awt.event.ActionEvent)>/simplejavacalculator.UI.reader/11	java.lang.Double()
<simplejavacalculator.UI: void actionPerformed(java.awt.event.ActionEvent)>/simplejavacalculator.UI.reader/2	java.lang.Double()
<simplejavacalculator.UI: void actionPerformed(java.awt.event.ActionEvent)>/simplejavacalculator.UI.writer/8	void(java.lang.Double)
<simplejavacalculator.UI: void actionPerformed(java.awt.event.ActionEvent)>/simplejavacalculator.UI.writer/3	void(java.lang.Double)
<simplejavacalculator.UI: void actionPerformed(java.awt.event.ActionEvent)>/simplejavacalculator.Calculator.calculateBi/2	java.lang.Double(simplejavacalculator.Calculator$BiOperatorModes,java.lang.Double)
<simplejavacalculator.UI: void actionPerformed(java.awt.event.ActionEvent)>/simplejavacalculator.UI.reader/12	java.lang.Double()
<simplejavacalculator.UI: void actionPerformed(java.awt.event.ActionEvent)>/simplejavacalculator.Calculator.calculateMono/4	java.lang.Double(simplejavacalculator.Calculator$MonoOperatorModes,java.lang.Double)
<simplejavacalculator.UI: void actionPerformed(java.awt.event.ActionEvent)>/simplejavacalculator.Calculator.calculateBi/0	java.lang.Double(simplejavacalculator.Calculator$BiOperatorModes,java.lang.Double)
<simplejavacalculator.UI: void actionPerformed(java.awt.event.ActionEvent)>/simplejavacalculator.UI.writer/6	void(java.lang.Double)
<simplejavacalculator.UI: void actionPerformed(java.awt.event.ActionEvent)>/simplejavacalculator.Calculator.calculateMono/0	java.lang.Double(simplejavacalculator.Calculator$MonoOperatorModes,java.lang.Double)
<simplejavacalculator.UI: void actionPerformed(java.awt.event.ActionEvent)>/simplejavacalculator.UI.writer/14	void(java.lang.Double)
<simplejavacalculator.UI: void actionPerformed(java.awt.event.ActionEvent)>/simplejavacalculator.Calculator.calculateMono/3	java.lang.Double(simplejavacalculator.Calculator$MonoOperatorModes,java.lang.Double)
<simplejavacalculator.UI: void actionPerformed(java.awt.event.ActionEvent)>/simplejavacalculator.UI.reader/9	java.lang.Double()
<simplejavacalculator.UI: void actionPerformed(java.awt.event.ActionEvent)>/simplejavacalculator.UI.reader/6	java.lang.Double()
<simplejavacalculator.UI: void actionPerformed(java.awt.event.ActionEvent)>/simplejavacalculator.UI.writer/7	void(java.lang.Double)
<simplejavacalculator.UI: void actionPerformed(java.awt.event.ActionEvent)>/simplejavacalculator.UI.reader/7	java.lang.Double()
<simplejavacalculator.UI: void actionPerformed(java.awt.event.ActionEvent)>/simplejavacalculator.Calculator.calculateMono/1	java.lang.Double(simplejavacalculator.Calculator$MonoOperatorModes,java.lang.Double)
<simplejavacalculator.UI: void actionPerformed(java.awt.event.ActionEvent)>/simplejavacalculator.UI.reader/8	java.lang.Double()
<simplejavacalculator.UI: void actionPerformed(java.awt.event.ActionEvent)>/simplejavacalculator.Calculator.calculateMono/5	java.lang.Double(simplejavacalculator.Calculator$MonoOperatorModes,java.lang.Double)
<simplejavacalculator.UI: void actionPerformed(java.awt.event.ActionEvent)>/simplejavacalculator.UI.reader/3	java.lang.Double()
<simplejavacalculator.UI: void actionPerformed(java.awt.event.ActionEvent)>/simplejavacalculator.Calculator.calculateMono/2	java.lang.Double(simplejavacalculator.Calculator$MonoOperatorModes,java.lang.Double)
