<simplejavacalculator.UI: void actionPerformed(java.awt.event.ActionEvent)>/simplejavacalculator.UI.reader/14	<simplejavacalculator.UI: java.lang.Double reader()>	0
<simplejavacalculator.UI: void parsetoBinary()>/java.io.PrintStream.println/0	<java.io.PrintStream: void println(java.lang.String)>	0
<simplejavacalculator.UI: void parsetoBinary()>/javax.swing.JTextArea.getText/0	<javax.swing.text.JTextComponent: java.lang.String getText()>	0
<simplejavacalculator.UI: void init()>/javax.swing.JFrame.setDefaultCloseOperation/0	<javax.swing.JFrame: void setDefaultCloseOperation(int)>	0
<simplejavacalculator.UI: void init()>/javax.swing.JButton.addActionListener/2	<javax.swing.AbstractButton: void addActionListener(java.awt.event.ActionListener)>	0
<simplejavacalculator.UI: void actionPerformed(java.awt.event.ActionEvent)>/simplejavacalculator.UI.writer/15	<simplejavacalculator.UI: void writer(java.lang.Double)>	0
<simplejavacalculator.UI: void actionPerformed(java.awt.event.ActionEvent)>/javax.swing.JTextArea.selectAll/0	<javax.swing.text.JTextComponent: void selectAll()>	0
<simplejavacalculator.UI: void actionPerformed(java.awt.event.ActionEvent)>/simplejavacalculator.UI.writer/9	<simplejavacalculator.UI: void writer(java.lang.Double)>	0
<simplejavacalculator.UI: void init()>/javax.swing.JFrame.setLocationRelativeTo/0	<java.awt.Window: void setLocationRelativeTo(java.awt.Component)>	0
<simplejavacalculator.UI: void init()>/javax.swing.JButton.setFont/0	<javax.swing.JComponent: void setFont(java.awt.Font)>	0
<simplejavacalculator.UI: void actionPerformed(java.awt.event.ActionEvent)>/simplejavacalculator.UI.writer/14	<simplejavacalculator.UI: void writer(java.lang.Double)>	0
<simplejavacalculator.Calculator$MonoOperatorModes: simplejavacalculator.Calculator$MonoOperatorModes[] values()>/java.lang.Object.clone/0	<java.lang.Object: java.lang.Object clone()>	0
<simplejavacalculator.UI: void actionPerformed(java.awt.event.ActionEvent)>/simplejavacalculator.UI.writer/13	<simplejavacalculator.UI: void writer(java.lang.Double)>	0
<simplejavacalculator.UI: void actionPerformed(java.awt.event.ActionEvent)>/simplejavacalculator.UI.reader/1	<simplejavacalculator.UI: java.lang.Double reader()>	0
<simplejavacalculator.UI: void actionPerformed(java.awt.event.ActionEvent)>/simplejavacalculator.UI.writer/1	<simplejavacalculator.UI: void writer(java.lang.Double)>	0
<simplejavacalculator.UI: void init()>/javax.swing.JFrame.add/0	<java.awt.Container: java.awt.Component add(java.awt.Component)>	0
<simplejavacalculator.Calculator$BiOperatorModes: simplejavacalculator.Calculator$BiOperatorModes[] values()>/java.lang.Object.clone/0	<java.lang.Object: java.lang.Object clone()>	0
<simplejavacalculator.UI: void actionPerformed(java.awt.event.ActionEvent)>/simplejavacalculator.UI.reader/5	<simplejavacalculator.UI: java.lang.Double reader()>	0
<simplejavacalculator.UI: void actionPerformed(java.awt.event.ActionEvent)>/simplejavacalculator.Calculator.reset/0	<simplejavacalculator.Calculator: java.lang.Double reset()>	0
<simplejavacalculator.UI: void init()>/javax.swing.JButton.setFont/8	<javax.swing.JComponent: void setFont(java.awt.Font)>	0
<simplejavacalculator.UI: void init()>/javax.swing.JPanel.add/13	<java.awt.Container: java.awt.Component add(java.awt.Component)>	0
<simplejavacalculator.UI: void init()>/javax.swing.JButton.addActionListener/10	<javax.swing.AbstractButton: void addActionListener(java.awt.event.ActionListener)>	0
<simplejavacalculator.UI: void actionPerformed(java.awt.event.ActionEvent)>/simplejavacalculator.UI.writer/4	<simplejavacalculator.UI: void writer(java.lang.Double)>	0
<simplejavacalculator.UI: void actionPerformed(java.awt.event.ActionEvent)>/java.awt.event.ActionEvent.getSource/0	<java.util.EventObject: java.lang.Object getSource()>	0
<simplejavacalculator.UI: void actionPerformed(java.awt.event.ActionEvent)>/simplejavacalculator.UI.reader/4	<simplejavacalculator.UI: java.lang.Double reader()>	0
<simplejavacalculator.UI: void init()>/javax.swing.JPanel.add/27	<java.awt.Container: java.awt.Component add(java.awt.Component)>	0
<simplejavacalculator.UI: void init()>/javax.swing.JButton.addActionListener/18	<javax.swing.AbstractButton: void addActionListener(java.awt.event.ActionListener)>	0
<simplejavacalculator.UI: void init()>/javax.swing.JFrame.setIconImage/0	<javax.swing.JFrame: void setIconImage(java.awt.Image)>	0
<simplejavacalculator.UI: void actionPerformed(java.awt.event.ActionEvent)>/simplejavacalculator.Calculator.calculateMono/6	<simplejavacalculator.Calculator: java.lang.Double calculateMono(simplejavacalculator.Calculator$MonoOperatorModes,java.lang.Double)>	0
<simplejavacalculator.UI: void actionPerformed(java.awt.event.ActionEvent)>/simplejavacalculator.UI.writer/12	<simplejavacalculator.UI: void writer(java.lang.Double)>	0
<simplejavacalculator.UI: void init()>/javax.swing.JButton.addActionListener/4	<javax.swing.AbstractButton: void addActionListener(java.awt.event.ActionListener)>	0
<simplejavacalculator.UI: void actionPerformed(java.awt.event.ActionEvent)>/simplejavacalculator.Calculator.calculateBi/3	<simplejavacalculator.Calculator: java.lang.Double calculateBi(simplejavacalculator.Calculator$BiOperatorModes,java.lang.Double)>	0
<simplejavacalculator.UI: void actionPerformed(java.awt.event.ActionEvent)>/simplejavacalculator.UI.reader/0	<simplejavacalculator.UI: java.lang.Double reader()>	0
<simplejavacalculator.UI: void actionPerformed(java.awt.event.ActionEvent)>/simplejavacalculator.UI.writer/5	<simplejavacalculator.UI: void writer(java.lang.Double)>	0
<simplejavacalculator.UI: void init()>/javax.swing.JButton.addActionListener/7	<javax.swing.AbstractButton: void addActionListener(java.awt.event.ActionListener)>	0
<simplejavacalculator.UI: void actionPerformed(java.awt.event.ActionEvent)>/simplejavacalculator.UI.reader/7	<simplejavacalculator.UI: java.lang.Double reader()>	0
<simplejavacalculator.SimpleJavaCalculator: void main(java.lang.String[])>/simplejavacalculator.UI.init/0	<simplejavacalculator.UI: void init()>	0
<simplejavacalculator.UI: void init()>/javax.swing.JPanel.add/34	<java.awt.Container: java.awt.Component add(java.awt.Component)>	0
<simplejavacalculator.UI: java.lang.Double reader()>/javax.swing.JTextArea.getText/0	<javax.swing.text.JTextComponent: java.lang.String getText()>	0
<simplejavacalculator.UI: void init()>/javax.swing.JButton.setFont/10	<javax.swing.JComponent: void setFont(java.awt.Font)>	0
<simplejavacalculator.UI: void parsetoBinary()>/java.lang.NumberFormatException.toString/0	<java.lang.Throwable: java.lang.String toString()>	0
<simplejavacalculator.UI: void parsetoBinary()>/java.lang.StringBuilder.append/3	<java.lang.StringBuilder: java.lang.StringBuilder append(java.lang.String)>	0
<simplejavacalculator.UI: void actionPerformed(java.awt.event.ActionEvent)>/simplejavacalculator.Calculator.calculateBi/1	<simplejavacalculator.Calculator: java.lang.Double calculateBi(simplejavacalculator.Calculator$BiOperatorModes,java.lang.Double)>	0
<simplejavacalculator.UI: void init()>/javax.swing.JButton.addActionListener/11	<javax.swing.AbstractButton: void addActionListener(java.awt.event.ActionListener)>	0
<simplejavacalculator.UI: void init()>/javax.swing.JButton.addActionListener/14	<javax.swing.AbstractButton: void addActionListener(java.awt.event.ActionListener)>	0
<simplejavacalculator.UI: void init()>/javax.swing.JPanel.add/33	<java.awt.Container: java.awt.Component add(java.awt.Component)>	0
<simplejavacalculator.UI: void init()>/javax.swing.JFrame.setResizable/0	<java.awt.Frame: void setResizable(boolean)>	0
<simplejavacalculator.UI: void actionPerformed(java.awt.event.ActionEvent)>/simplejavacalculator.Calculator.calculateBi/4	<simplejavacalculator.Calculator: java.lang.Double calculateBi(simplejavacalculator.Calculator$BiOperatorModes,java.lang.Double)>	0
<simplejavacalculator.Calculator: java.lang.Double calculateEqual(java.lang.Double)>/simplejavacalculator.Calculator.calculateBi/0	<simplejavacalculator.Calculator: java.lang.Double calculateBi(simplejavacalculator.Calculator$BiOperatorModes,java.lang.Double)>	0
<simplejavacalculator.UI: void parsetoBinary()>/java.lang.StringBuilder.toString/1	<java.lang.StringBuilder: java.lang.String toString()>	0
<simplejavacalculator.UI: void actionPerformed(java.awt.event.ActionEvent)>/simplejavacalculator.Calculator.calculateMono/8	<simplejavacalculator.Calculator: java.lang.Double calculateMono(simplejavacalculator.Calculator$MonoOperatorModes,java.lang.Double)>	0
<simplejavacalculator.UI: void parsetoBinary()>/java.lang.StringBuilder.append/2	<java.lang.StringBuilder: java.lang.StringBuilder append(java.lang.String)>	0
<simplejavacalculator.UI: void actionPerformed(java.awt.event.ActionEvent)>/simplejavacalculator.Calculator.calculateEqual/0	<simplejavacalculator.Calculator: java.lang.Double calculateEqual(java.lang.Double)>	0
<simplejavacalculator.UI: void parsetoBinary()>/java.lang.StringBuilder.append/1	<java.lang.StringBuilder: java.lang.StringBuilder append(java.lang.String)>	0
<simplejavacalculator.UI: void init()>/javax.swing.JPanel.add/40	<java.awt.Container: java.awt.Component add(java.awt.Component)>	0
<simplejavacalculator.UI: void actionPerformed(java.awt.event.ActionEvent)>/simplejavacalculator.UI.reader/13	<simplejavacalculator.UI: java.lang.Double reader()>	0
<simplejavacalculator.UI: void init()>/javax.swing.JPanel.add/20	<java.awt.Container: java.awt.Component add(java.awt.Component)>	0
<simplejavacalculator.UI: void actionPerformed(java.awt.event.ActionEvent)>/simplejavacalculator.Calculator.calculateMono/7	<simplejavacalculator.Calculator: java.lang.Double calculateMono(simplejavacalculator.Calculator$MonoOperatorModes,java.lang.Double)>	0
<simplejavacalculator.UI: void actionPerformed(java.awt.event.ActionEvent)>/simplejavacalculator.UI.writer/10	<simplejavacalculator.UI: void writer(java.lang.Double)>	0
<simplejavacalculator.UI: void init()>/javax.swing.JPanel.add/38	<java.awt.Container: java.awt.Component add(java.awt.Component)>	0
<simplejavacalculator.UI: void init()>/javax.swing.JButton.addActionListener/0	<javax.swing.AbstractButton: void addActionListener(java.awt.event.ActionListener)>	0
<simplejavacalculator.UI: void actionPerformed(java.awt.event.ActionEvent)>/simplejavacalculator.UI.writer/0	<simplejavacalculator.UI: void writer(java.lang.Double)>	0
<simplejavacalculator.UI: void init()>/javax.swing.JPanel.add/31	<java.awt.Container: java.awt.Component add(java.awt.Component)>	0
<simplejavacalculator.UI: void actionPerformed(java.awt.event.ActionEvent)>/simplejavacalculator.UI.writer/2	<simplejavacalculator.UI: void writer(java.lang.Double)>	0
<simplejavacalculator.UI: void actionPerformed(java.awt.event.ActionEvent)>/simplejavacalculator.UI.reader/11	<simplejavacalculator.UI: java.lang.Double reader()>	0
<simplejavacalculator.UI: void init()>/javax.swing.JPanel.add/26	<java.awt.Container: java.awt.Component add(java.awt.Component)>	0
<simplejavacalculator.UI: void init()>/javax.swing.JPanel.add/30	<java.awt.Container: java.awt.Component add(java.awt.Component)>	0
<simplejavacalculator.UI: void actionPerformed(java.awt.event.ActionEvent)>/simplejavacalculator.UI.reader/2	<simplejavacalculator.UI: java.lang.Double reader()>	0
<simplejavacalculator.UI: void init()>/javax.swing.JButton.addActionListener/12	<javax.swing.AbstractButton: void addActionListener(java.awt.event.ActionListener)>	0
<simplejavacalculator.UI: void init()>/javax.swing.JPanel.add/25	<java.awt.Container: java.awt.Component add(java.awt.Component)>	0
<simplejavacalculator.UI: void init()>/javax.swing.JPanel.add/12	<java.awt.Container: java.awt.Component add(java.awt.Component)>	0
<simplejavacalculator.UI: void init()>/javax.swing.JFrame.setSize/0	<java.awt.Window: void setSize(int,int)>	0
<simplejavacalculator.UI: void init()>/javax.swing.JPanel.add/35	<java.awt.Container: java.awt.Component add(java.awt.Component)>	0
<simplejavacalculator.UI: void init()>/javax.swing.JPanel.add/37	<java.awt.Container: java.awt.Component add(java.awt.Component)>	0
<simplejavacalculator.UI: void init()>/javax.swing.JButton.addActionListener/1	<javax.swing.AbstractButton: void addActionListener(java.awt.event.ActionListener)>	0
<simplejavacalculator.UI: void actionPerformed(java.awt.event.ActionEvent)>/simplejavacalculator.UI.writer/6	<simplejavacalculator.UI: void writer(java.lang.Double)>	0
<simplejavacalculator.UI: void init()>/javax.swing.JButton.setFont/4	<javax.swing.JComponent: void setFont(java.awt.Font)>	0
<simplejavacalculator.UI: void init()>/javax.swing.JTextArea.setEditable/0	<javax.swing.text.JTextComponent: void setEditable(boolean)>	0
<simplejavacalculator.UI: void actionPerformed(java.awt.event.ActionEvent)>/simplejavacalculator.UI.writer/3	<simplejavacalculator.UI: void writer(java.lang.Double)>	0
<simplejavacalculator.UI: void actionPerformed(java.awt.event.ActionEvent)>/simplejavacalculator.Calculator.calculateBi/2	<simplejavacalculator.Calculator: java.lang.Double calculateBi(simplejavacalculator.Calculator$BiOperatorModes,java.lang.Double)>	0
<simplejavacalculator.UI: void init()>/javax.swing.JTextArea.setFont/0	<javax.swing.JTextArea: void setFont(java.awt.Font)>	0
<simplejavacalculator.UI: void actionPerformed(java.awt.event.ActionEvent)>/simplejavacalculator.UI.reader/12	<simplejavacalculator.UI: java.lang.Double reader()>	0
<simplejavacalculator.UI: void init()>/javax.swing.JPanel.add/22	<java.awt.Container: java.awt.Component add(java.awt.Component)>	1
<simplejavacalculator.UI: void init()>/javax.swing.JPanel.add/22	<java.awt.Container: java.awt.Component add(java.awt.Component)>	10
<simplejavacalculator.UI: void init()>/javax.swing.JPanel.add/24	<java.awt.Container: java.awt.Component add(java.awt.Component)>	1
<simplejavacalculator.UI: void init()>/javax.swing.JPanel.add/24	<java.awt.Container: java.awt.Component add(java.awt.Component)>	10
<simplejavacalculator.Calculator: java.lang.Double calculateBiImpl()>/java.lang.Double.doubleValue/7	<java.lang.Class: java.io.InputStream getResourceAsStream(java.lang.String)>	1
<simplejavacalculator.Calculator: java.lang.Double calculateBiImpl()>/java.lang.Double.doubleValue/7	<java.lang.Double: double doubleValue()>	10
<simplejavacalculator.UI: void init()>/javax.swing.JButton.setFont/13	<javax.swing.JComponent: void setFont(java.awt.Font)>	1
<simplejavacalculator.UI: void init()>/javax.swing.JButton.setFont/13	<javax.swing.JComponent: void setFont(java.awt.Font)>	10
<simplejavacalculator.Calculator: java.lang.Double calculateMono(simplejavacalculator.Calculator$MonoOperatorModes,java.lang.Double)>/java.lang.Double.doubleValue/4	<java.lang.Class: java.io.InputStream getResourceAsStream(java.lang.String)>	1
<simplejavacalculator.Calculator: java.lang.Double calculateMono(simplejavacalculator.Calculator$MonoOperatorModes,java.lang.Double)>/java.lang.Double.doubleValue/4	<java.lang.Double: double doubleValue()>	10
<simplejavacalculator.UI: void actionPerformed(java.awt.event.ActionEvent)>/simplejavacalculator.Calculator.calculateMono/4	<simplejavacalculator.Calculator: java.lang.Double calculateMono(simplejavacalculator.Calculator$MonoOperatorModes,java.lang.Double)>	1
<simplejavacalculator.UI: void actionPerformed(java.awt.event.ActionEvent)>/simplejavacalculator.Calculator.calculateMono/4	<simplejavacalculator.Calculator: java.lang.Double calculateMono(simplejavacalculator.Calculator$MonoOperatorModes,java.lang.Double)>	10
<simplejavacalculator.UI: void actionPerformed(java.awt.event.ActionEvent)>/simplejavacalculator.Calculator.calculateBi/0	<simplejavacalculator.Calculator: java.lang.Double calculateBi(simplejavacalculator.Calculator$BiOperatorModes,java.lang.Double)>	1
<simplejavacalculator.UI: void actionPerformed(java.awt.event.ActionEvent)>/simplejavacalculator.Calculator.calculateBi/0	<simplejavacalculator.Calculator: java.lang.Double calculateBi(simplejavacalculator.Calculator$BiOperatorModes,java.lang.Double)>	10
<simplejavacalculator.UI: void init()>/javax.swing.JButton.setFont/1	<javax.swing.JComponent: void setFont(java.awt.Font)>	1
<simplejavacalculator.UI: void init()>/javax.swing.JButton.setFont/1	<javax.swing.JComponent: void setFont(java.awt.Font)>	10
<simplejavacalculator.UI: void writer(java.lang.Double)>/javax.swing.JTextArea.setText/1	<java.lang.Double: double doubleValue()>	1
<simplejavacalculator.UI: void writer(java.lang.Double)>/javax.swing.JTextArea.setText/1	<javax.swing.text.JTextComponent: void setText(java.lang.String)>	10
<simplejavacalculator.UI: void init()>/javax.swing.JPanel.add/21	<java.awt.Container: java.awt.Component add(java.awt.Component)>	1
<simplejavacalculator.UI: void init()>/javax.swing.JPanel.add/21	<java.awt.Container: java.awt.Component add(java.awt.Component)>	10
<simplejavacalculator.UI: void init()>/javax.swing.JButton.addActionListener/17	<javax.swing.AbstractButton: void addActionListener(java.awt.event.ActionListener)>	10
<simplejavacalculator.UI: void init()>/javax.swing.JButton.addActionListener/17	new_var_701	1
<simplejavacalculator.UI: void actionPerformed(java.awt.event.ActionEvent)>/simplejavacalculator.UI.writer/11	<simplejavacalculator.UI: void writer(java.lang.Double)>	10
<simplejavacalculator.UI: void actionPerformed(java.awt.event.ActionEvent)>/simplejavacalculator.UI.writer/11	<javax.swing.AbstractButton: void addActionListener(java.awt.event.ActionListener)>	1
<simplejavacalculator.UI: void init()>/javax.swing.JPanel.add/1	<java.awt.Container: java.awt.Component add(java.awt.Component)>	1
<simplejavacalculator.UI: void init()>/javax.swing.JPanel.add/1	<java.awt.Container: java.awt.Component add(java.awt.Component)>	10
<simplejavacalculator.UI: void init()>/javax.swing.JButton.addActionListener/8	<javax.swing.AbstractButton: void addActionListener(java.awt.event.ActionListener)>	1
<simplejavacalculator.UI: void init()>/javax.swing.JButton.addActionListener/8	<javax.swing.AbstractButton: void addActionListener(java.awt.event.ActionListener)>	10
<simplejavacalculator.UI: void init()>/javax.swing.JPanel.add/17	<java.awt.Container: java.awt.Component add(java.awt.Component)>	1
<simplejavacalculator.UI: void init()>/javax.swing.JPanel.add/17	<java.awt.Container: java.awt.Component add(java.awt.Component)>	10
<simplejavacalculator.UI: void init()>/javax.swing.JPanel.add/23	<java.awt.Container: java.awt.Component add(java.awt.Component)>	1
<simplejavacalculator.UI: void init()>/javax.swing.JPanel.add/23	<java.awt.Container: java.awt.Component add(java.awt.Component)>	10
<simplejavacalculator.UI: void init()>/javax.swing.JPanel.add/7	<java.awt.Container: java.awt.Component add(java.awt.Component)>	1
<simplejavacalculator.UI: void init()>/javax.swing.JPanel.add/7	<java.awt.Container: java.awt.Component add(java.awt.Component)>	10
<simplejavacalculator.UI: void init()>/javax.swing.JPanel.add/4	<java.awt.Container: java.awt.Component add(java.awt.Component)>	1
<simplejavacalculator.UI: void init()>/javax.swing.JPanel.add/4	<java.awt.Container: java.awt.Component add(java.awt.Component)>	10
<simplejavacalculator.UI: void init()>/javax.swing.JPanel.add/39	<simplejavacalculator.UI: void writer(java.lang.Double)>	1
<simplejavacalculator.UI: void init()>/javax.swing.JPanel.add/39	<java.awt.Container: java.awt.Component add(java.awt.Component)>	10
<simplejavacalculator.UI: void init()>/javax.swing.JButton.addActionListener/16	<javax.swing.AbstractButton: void addActionListener(java.awt.event.ActionListener)>	1
<simplejavacalculator.UI: void init()>/javax.swing.JButton.addActionListener/16	<javax.swing.AbstractButton: void addActionListener(java.awt.event.ActionListener)>	10
<simplejavacalculator.UI: void init()>/javax.swing.JButton.addActionListener/5	<javax.swing.AbstractButton: void addActionListener(java.awt.event.ActionListener)>	1
<simplejavacalculator.UI: void init()>/javax.swing.JButton.addActionListener/5	<javax.swing.AbstractButton: void addActionListener(java.awt.event.ActionListener)>	10
<simplejavacalculator.Calculator: java.lang.Double calculateMono(simplejavacalculator.Calculator$MonoOperatorModes,java.lang.Double)>/java.lang.Double.doubleValue/6	<java.lang.Class: java.io.InputStream getResourceAsStream(java.lang.String)>	1
<simplejavacalculator.Calculator: java.lang.Double calculateMono(simplejavacalculator.Calculator$MonoOperatorModes,java.lang.Double)>/java.lang.Double.doubleValue/6	<java.lang.Double: double doubleValue()>	10
<simplejavacalculator.UI: void init()>/javax.swing.JPanel.add/5	<java.awt.Container: java.awt.Component add(java.awt.Component)>	1
<simplejavacalculator.UI: void init()>/javax.swing.JPanel.add/5	<java.awt.Container: java.awt.Component add(java.awt.Component)>	10
<simplejavacalculator.UI: void init()>/javax.swing.JPanel.add/10	<java.awt.Container: java.awt.Component add(java.awt.Component)>	1
<simplejavacalculator.UI: void init()>/javax.swing.JPanel.add/10	<java.awt.Container: java.awt.Component add(java.awt.Component)>	10
<simplejavacalculator.Calculator: java.lang.Double calculateBiImpl()>/java.lang.Double.doubleValue/10	<java.lang.Class: java.io.InputStream getResourceAsStream(java.lang.String)>	1
<simplejavacalculator.Calculator: java.lang.Double calculateBiImpl()>/java.lang.Double.doubleValue/10	<java.lang.Double: double doubleValue()>	10
<simplejavacalculator.UI: void init()>/javax.swing.JButton.addActionListener/13	<javax.swing.AbstractButton: void addActionListener(java.awt.event.ActionListener)>	10
<simplejavacalculator.UI: void init()>/javax.swing.JButton.addActionListener/13	<javax.swing.JComponent: void setFont(java.awt.Font)>	1
<simplejavacalculator.UI: void actionPerformed(java.awt.event.ActionEvent)>/simplejavacalculator.Calculator.calculateMono/3	<simplejavacalculator.Calculator: java.lang.Double calculateMono(simplejavacalculator.Calculator$MonoOperatorModes,java.lang.Double)>	10
<simplejavacalculator.UI: void actionPerformed(java.awt.event.ActionEvent)>/simplejavacalculator.Calculator.calculateMono/3	<javax.swing.JComponent: void setFont(java.awt.Font)>	1
<simplejavacalculator.UI: void actionPerformed(java.awt.event.ActionEvent)>/simplejavacalculator.UI.writer/7	<simplejavacalculator.UI: void writer(java.lang.Double)>	10
<simplejavacalculator.UI: void actionPerformed(java.awt.event.ActionEvent)>/simplejavacalculator.UI.writer/7	<javax.swing.AbstractButton: void addActionListener(java.awt.event.ActionListener)>	1
<simplejavacalculator.UI: void init()>/javax.swing.JPanel.add/29	<java.awt.Container: java.awt.Component add(java.awt.Component)>	1
<simplejavacalculator.UI: void init()>/javax.swing.JPanel.add/29	<java.awt.Container: java.awt.Component add(java.awt.Component)>	10
<simplejavacalculator.UI: void actionPerformed(java.awt.event.ActionEvent)>/simplejavacalculator.Calculator.calculateMono/0	<simplejavacalculator.Calculator: java.lang.Double calculateMono(simplejavacalculator.Calculator$MonoOperatorModes,java.lang.Double)>	1
<simplejavacalculator.UI: void actionPerformed(java.awt.event.ActionEvent)>/simplejavacalculator.Calculator.calculateMono/0	<simplejavacalculator.Calculator: java.lang.Double calculateMono(simplejavacalculator.Calculator$MonoOperatorModes,java.lang.Double)>	10
<simplejavacalculator.UI: void init()>/javax.swing.JButton.setFont/5	<javax.swing.JComponent: void setFont(java.awt.Font)>	1
<simplejavacalculator.UI: void init()>/javax.swing.JButton.setFont/5	<javax.swing.JComponent: void setFont(java.awt.Font)>	10
<simplejavacalculator.UI: void init()>/javax.swing.JPanel.add/11	<java.awt.Container: java.awt.Component add(java.awt.Component)>	1
<simplejavacalculator.UI: void init()>/javax.swing.JPanel.add/11	<java.awt.Container: java.awt.Component add(java.awt.Component)>	10
<simplejavacalculator.UI: void init()>/javax.swing.JButton.addActionListener/15	<javax.swing.AbstractButton: void addActionListener(java.awt.event.ActionListener)>	10
<simplejavacalculator.UI: void init()>/javax.swing.JButton.addActionListener/15	<javax.swing.JComponent: void setFont(java.awt.Font)>	1
<simplejavacalculator.UI: void init()>/javax.swing.JPanel.add/32	<java.awt.Container: java.awt.Component add(java.awt.Component)>	10
<simplejavacalculator.UI: void init()>/javax.swing.JPanel.add/32	<java.lang.Class: java.io.InputStream getResourceAsStream(java.lang.String)>	1
<simplejavacalculator.Calculator: java.lang.Double calculateBiImpl()>/java.lang.Double.doubleValue/2	<java.lang.Class: java.io.InputStream getResourceAsStream(java.lang.String)>	1
<simplejavacalculator.Calculator: java.lang.Double calculateBiImpl()>/java.lang.Double.doubleValue/2	<java.lang.Double: double doubleValue()>	10
<simplejavacalculator.Calculator: java.lang.Double calculateBiImpl()>/java.lang.Double.doubleValue/4	<java.lang.Class: java.io.InputStream getResourceAsStream(java.lang.String)>	1
<simplejavacalculator.Calculator: java.lang.Double calculateBiImpl()>/java.lang.Double.doubleValue/4	<java.lang.Double: double doubleValue()>	10
<simplejavacalculator.Calculator: java.lang.Double calculateMono(simplejavacalculator.Calculator$MonoOperatorModes,java.lang.Double)>/java.lang.Double.doubleValue/11	<java.lang.Class: java.io.InputStream getResourceAsStream(java.lang.String)>	1
<simplejavacalculator.Calculator: java.lang.Double calculateMono(simplejavacalculator.Calculator$MonoOperatorModes,java.lang.Double)>/java.lang.Double.doubleValue/11	<java.lang.Double: double doubleValue()>	10
<simplejavacalculator.Calculator: java.lang.Double calculateMono(simplejavacalculator.Calculator$MonoOperatorModes,java.lang.Double)>/java.lang.Double.doubleValue/2	<java.lang.Class: java.io.InputStream getResourceAsStream(java.lang.String)>	1
<simplejavacalculator.Calculator: java.lang.Double calculateMono(simplejavacalculator.Calculator$MonoOperatorModes,java.lang.Double)>/java.lang.Double.doubleValue/2	<java.lang.Double: double doubleValue()>	10
<simplejavacalculator.Calculator: java.lang.Double calculateMono(simplejavacalculator.Calculator$MonoOperatorModes,java.lang.Double)>/java.lang.Double.doubleValue/5	<java.lang.Class: java.io.InputStream getResourceAsStream(java.lang.String)>	1
<simplejavacalculator.Calculator: java.lang.Double calculateMono(simplejavacalculator.Calculator$MonoOperatorModes,java.lang.Double)>/java.lang.Double.doubleValue/5	<java.lang.Double: double doubleValue()>	10
<simplejavacalculator.UI: void init()>/javax.swing.JPanel.add/16	<java.awt.Container: java.awt.Component add(java.awt.Component)>	1
<simplejavacalculator.UI: void init()>/javax.swing.JPanel.add/16	<java.awt.Container: java.awt.Component add(java.awt.Component)>	10
<simplejavacalculator.UI: void parsetoBinary()>/java.lang.Long.toBinaryString/0	<java.lang.Class: java.io.InputStream getResourceAsStream(java.lang.String)>	1
<simplejavacalculator.UI: void parsetoBinary()>/java.lang.Long.toBinaryString/0	<java.lang.Long: java.lang.String toBinaryString(long)>	10
<simplejavacalculator.UI: void init()>/javax.swing.JPanel.add/36	<java.awt.Container: java.awt.Component add(java.awt.Component)>	1
<simplejavacalculator.UI: void init()>/javax.swing.JPanel.add/36	<java.awt.Container: java.awt.Component add(java.awt.Component)>	10
<simplejavacalculator.UI: void init()>/javax.swing.JButton.setFont/3	<javax.swing.JComponent: void setFont(java.awt.Font)>	1
<simplejavacalculator.UI: void init()>/javax.swing.JButton.setFont/3	<javax.swing.JComponent: void setFont(java.awt.Font)>	10
<simplejavacalculator.UI: void init()>/javax.swing.JButton.setFont/7	<javax.swing.JComponent: void setFont(java.awt.Font)>	1
<simplejavacalculator.UI: void init()>/javax.swing.JButton.setFont/7	<javax.swing.JComponent: void setFont(java.awt.Font)>	10
<simplejavacalculator.UI: void parsetoBinary()>/java.lang.StringBuilder.append/0	<java.lang.StringBuilder: java.lang.StringBuilder append(java.lang.String)>	1
<simplejavacalculator.UI: void parsetoBinary()>/java.lang.StringBuilder.append/0	<java.lang.StringBuilder: java.lang.StringBuilder append(java.lang.String)>	10
<simplejavacalculator.UI: void init()>/javax.swing.JButton.setFont/11	<javax.swing.JComponent: void setFont(java.awt.Font)>	1
<simplejavacalculator.UI: void init()>/javax.swing.JButton.setFont/11	<javax.swing.JComponent: void setFont(java.awt.Font)>	10
<simplejavacalculator.Calculator: java.lang.Double calculateMono(simplejavacalculator.Calculator$MonoOperatorModes,java.lang.Double)>/java.lang.Double.doubleValue/10	<java.lang.Class: java.io.InputStream getResourceAsStream(java.lang.String)>	1
<simplejavacalculator.Calculator: java.lang.Double calculateMono(simplejavacalculator.Calculator$MonoOperatorModes,java.lang.Double)>/java.lang.Double.doubleValue/10	<java.lang.Double: double doubleValue()>	10
<simplejavacalculator.UI: void init()>/javax.swing.JPanel.add/19	<java.awt.Container: java.awt.Component add(java.awt.Component)>	1
<simplejavacalculator.UI: void init()>/javax.swing.JPanel.add/19	<java.awt.Container: java.awt.Component add(java.awt.Component)>	10
<simplejavacalculator.SimpleJavaCalculator: void main(java.lang.String[])>/java.io.PrintStream.println/0	<simplejavacalculator.UI: void writer(java.lang.Double)>	1
<simplejavacalculator.SimpleJavaCalculator: void main(java.lang.String[])>/java.io.PrintStream.println/0	<java.io.PrintStream: void println(java.lang.String)>	10
<simplejavacalculator.Calculator: java.lang.Double calculateMono(simplejavacalculator.Calculator$MonoOperatorModes,java.lang.Double)>/java.lang.Double.doubleValue/1	<java.lang.Class: java.io.InputStream getResourceAsStream(java.lang.String)>	1
<simplejavacalculator.Calculator: java.lang.Double calculateMono(simplejavacalculator.Calculator$MonoOperatorModes,java.lang.Double)>/java.lang.Double.doubleValue/1	<java.lang.Double: double doubleValue()>	10
<simplejavacalculator.BufferedImageCustom: java.awt.Image imageReturn()>/java.lang.Object.getClass/0	<java.awt.Container: java.awt.Component add(java.awt.Component)>	1
<simplejavacalculator.BufferedImageCustom: java.awt.Image imageReturn()>/java.lang.Object.getClass/0	<java.lang.Object: java.lang.Class getClass()>	10
<simplejavacalculator.UI: void init()>/javax.swing.JButton.setFont/6	<javax.swing.AbstractButton: void addActionListener(java.awt.event.ActionListener)>	1
<simplejavacalculator.UI: void init()>/javax.swing.JButton.setFont/6	<javax.swing.JComponent: void setFont(java.awt.Font)>	10
<simplejavacalculator.UI: void parsetoBinary()>/javax.swing.JTextArea.setText/0	<java.lang.Double: double doubleValue()>	1
<simplejavacalculator.UI: void parsetoBinary()>/javax.swing.JTextArea.setText/0	<javax.swing.text.JTextComponent: void setText(java.lang.String)>	10
<simplejavacalculator.SimpleJavaCalculator: void main(java.lang.String[])>/java.lang.Exception.getMessage/0	<java.lang.Class: java.io.InputStream getResourceAsStream(java.lang.String)>	1
<simplejavacalculator.SimpleJavaCalculator: void main(java.lang.String[])>/java.lang.Exception.getMessage/0	<java.lang.Throwable: java.lang.String getMessage()>	10
<simplejavacalculator.UI: void actionPerformed(java.awt.event.ActionEvent)>/simplejavacalculator.Calculator.calculateMono/1	<simplejavacalculator.Calculator: java.lang.Double calculateMono(simplejavacalculator.Calculator$MonoOperatorModes,java.lang.Double)>	1
<simplejavacalculator.UI: void actionPerformed(java.awt.event.ActionEvent)>/simplejavacalculator.Calculator.calculateMono/1	<simplejavacalculator.Calculator: java.lang.Double calculateMono(simplejavacalculator.Calculator$MonoOperatorModes,java.lang.Double)>	10
<simplejavacalculator.UI: void init()>/javax.swing.JButton.setFont/16	<javax.swing.JComponent: void setFont(java.awt.Font)>	10
<simplejavacalculator.UI: void init()>/javax.swing.JButton.setFont/16	<java.awt.Container: java.awt.Component add(java.awt.Component)>	1
<simplejavacalculator.UI: void init()>/javax.swing.JPanel.add/14	<java.awt.Container: java.awt.Component add(java.awt.Component)>	1
<simplejavacalculator.UI: void init()>/javax.swing.JPanel.add/14	<java.awt.Container: java.awt.Component add(java.awt.Component)>	10
<simplejavacalculator.UI: void parsetoBinary()>/java.lang.StringBuilder.toString/0	<java.lang.StringBuilder: java.lang.String toString()>	1
<simplejavacalculator.UI: void parsetoBinary()>/java.lang.StringBuilder.toString/0	<java.lang.StringBuilder: java.lang.String toString()>	10
<simplejavacalculator.UI: void init()>/javax.swing.JButton.addActionListener/3	<javax.swing.AbstractButton: void addActionListener(java.awt.event.ActionListener)>	1
<simplejavacalculator.UI: void init()>/javax.swing.JButton.addActionListener/3	<javax.swing.AbstractButton: void addActionListener(java.awt.event.ActionListener)>	10
<simplejavacalculator.Calculator: java.lang.Double calculateMono(simplejavacalculator.Calculator$MonoOperatorModes,java.lang.Double)>/java.lang.Double.doubleValue/3	<simplejavacalculator.BufferedImageCustom: java.awt.Image imageReturn()>	1
<simplejavacalculator.Calculator: java.lang.Double calculateMono(simplejavacalculator.Calculator$MonoOperatorModes,java.lang.Double)>/java.lang.Double.doubleValue/3	<java.lang.Double: double doubleValue()>	10
<simplejavacalculator.Calculator: java.lang.Double calculateMono(simplejavacalculator.Calculator$MonoOperatorModes,java.lang.Double)>/java.lang.Double.doubleValue/12	<java.lang.Class: java.io.InputStream getResourceAsStream(java.lang.String)>	1
<simplejavacalculator.Calculator: java.lang.Double calculateMono(simplejavacalculator.Calculator$MonoOperatorModes,java.lang.Double)>/java.lang.Double.doubleValue/12	<java.lang.Double: double doubleValue()>	10
<simplejavacalculator.UI: void actionPerformed(java.awt.event.ActionEvent)>/simplejavacalculator.UI.reader/9	<simplejavacalculator.UI: java.lang.Double reader()>	1
<simplejavacalculator.UI: void actionPerformed(java.awt.event.ActionEvent)>/simplejavacalculator.UI.reader/9	<simplejavacalculator.UI: java.lang.Double reader()>	10
<simplejavacalculator.UI: void init()>/javax.swing.JButton.setFont/2	<javax.swing.JComponent: void setFont(java.awt.Font)>	1
<simplejavacalculator.UI: void init()>/javax.swing.JButton.setFont/2	<javax.swing.JComponent: void setFont(java.awt.Font)>	10
<simplejavacalculator.UI: void init()>/javax.swing.JPanel.add/15	<java.awt.Container: java.awt.Component add(java.awt.Component)>	1
<simplejavacalculator.UI: void init()>/javax.swing.JPanel.add/15	<java.awt.Container: java.awt.Component add(java.awt.Component)>	10
<simplejavacalculator.UI: void init()>/javax.swing.JPanel.add/0	<java.awt.Container: java.awt.Component add(java.awt.Component)>	1
<simplejavacalculator.UI: void init()>/javax.swing.JPanel.add/0	<java.awt.Container: java.awt.Component add(java.awt.Component)>	10
<simplejavacalculator.Calculator: java.lang.Double calculateBiImpl()>/java.lang.Double.doubleValue/1	<java.lang.Class: java.io.InputStream getResourceAsStream(java.lang.String)>	1
<simplejavacalculator.Calculator: java.lang.Double calculateBiImpl()>/java.lang.Double.doubleValue/1	<java.lang.Double: double doubleValue()>	10
<simplejavacalculator.UI: void init()>/javax.swing.JPanel.add/2	<java.awt.Container: java.awt.Component add(java.awt.Component)>	1
<simplejavacalculator.UI: void init()>/javax.swing.JPanel.add/2	<java.awt.Container: java.awt.Component add(java.awt.Component)>	10
<simplejavacalculator.UI: void init()>/javax.swing.JPanel.add/3	<java.awt.Container: java.awt.Component add(java.awt.Component)>	1
<simplejavacalculator.UI: void init()>/javax.swing.JPanel.add/3	<java.awt.Container: java.awt.Component add(java.awt.Component)>	10
<simplejavacalculator.UI: void init()>/javax.swing.JButton.addActionListener/6	<javax.swing.AbstractButton: void addActionListener(java.awt.event.ActionListener)>	1
<simplejavacalculator.UI: void init()>/javax.swing.JButton.addActionListener/6	<javax.swing.AbstractButton: void addActionListener(java.awt.event.ActionListener)>	10
<simplejavacalculator.Calculator: java.lang.Double calculateMono(simplejavacalculator.Calculator$MonoOperatorModes,java.lang.Double)>/java.lang.Double.doubleValue/8	<java.lang.Class: java.io.InputStream getResourceAsStream(java.lang.String)>	1
<simplejavacalculator.Calculator: java.lang.Double calculateMono(simplejavacalculator.Calculator$MonoOperatorModes,java.lang.Double)>/java.lang.Double.doubleValue/8	<java.lang.Double: double doubleValue()>	10
<simplejavacalculator.Calculator: java.lang.Double calculateBiImpl()>/java.lang.Double.doubleValue/8	<java.lang.Class: java.io.InputStream getResourceAsStream(java.lang.String)>	1
<simplejavacalculator.Calculator: java.lang.Double calculateBiImpl()>/java.lang.Double.doubleValue/8	<java.lang.Double: double doubleValue()>	10
<simplejavacalculator.UI: void actionPerformed(java.awt.event.ActionEvent)>/simplejavacalculator.UI.reader/10	<simplejavacalculator.UI: java.lang.Double reader()>	1
<simplejavacalculator.UI: void actionPerformed(java.awt.event.ActionEvent)>/simplejavacalculator.UI.reader/10	<simplejavacalculator.UI: java.lang.Double reader()>	10
<simplejavacalculator.UI: void <init>()>/javax.swing.ImageIcon.<init>/0	<simplejavacalculator.UI: void writer(java.lang.Double)>	1
<simplejavacalculator.UI: void <init>()>/javax.swing.ImageIcon.<init>/0	<javax.swing.ImageIcon: void <init>(java.awt.Image)>	10
<simplejavacalculator.Calculator: java.lang.Double calculateMono(simplejavacalculator.Calculator$MonoOperatorModes,java.lang.Double)>/java.lang.Double.doubleValue/13	<java.lang.Class: java.io.InputStream getResourceAsStream(java.lang.String)>	1
<simplejavacalculator.Calculator: java.lang.Double calculateMono(simplejavacalculator.Calculator$MonoOperatorModes,java.lang.Double)>/java.lang.Double.doubleValue/13	<java.lang.Double: double doubleValue()>	10
<simplejavacalculator.Calculator: java.lang.Double calculateBiImpl()>/java.lang.Double.doubleValue/5	<java.lang.Class: java.io.InputStream getResourceAsStream(java.lang.String)>	1
<simplejavacalculator.Calculator: java.lang.Double calculateBiImpl()>/java.lang.Double.doubleValue/5	<java.lang.Double: double doubleValue()>	10
<simplejavacalculator.UI: void init()>/javax.swing.JPanel.add/8	<java.awt.Container: java.awt.Component add(java.awt.Component)>	1
<simplejavacalculator.UI: void init()>/javax.swing.JPanel.add/8	<java.awt.Container: java.awt.Component add(java.awt.Component)>	10
<simplejavacalculator.UI: void init()>/javax.swing.JButton.setFont/12	<javax.swing.JComponent: void setFont(java.awt.Font)>	1
<simplejavacalculator.UI: void init()>/javax.swing.JButton.setFont/12	<javax.swing.JComponent: void setFont(java.awt.Font)>	10
<simplejavacalculator.UI: void init()>/javax.swing.JFrame.setVisible/0	<javax.swing.JComponent: void setFont(java.awt.Font)>	1
<simplejavacalculator.UI: void init()>/javax.swing.JFrame.setVisible/0	<java.awt.Window: void setVisible(boolean)>	10
<simplejavacalculator.UI: void actionPerformed(java.awt.event.ActionEvent)>/simplejavacalculator.UI.writer/8	<simplejavacalculator.UI: java.lang.Double reader()>	1
<simplejavacalculator.UI: void actionPerformed(java.awt.event.ActionEvent)>/simplejavacalculator.UI.writer/8	<simplejavacalculator.UI: void writer(java.lang.Double)>	10
<simplejavacalculator.UI: void actionPerformed(java.awt.event.ActionEvent)>/simplejavacalculator.Calculator.calculateMono/5	<simplejavacalculator.Calculator: java.lang.Double calculateMono(simplejavacalculator.Calculator$MonoOperatorModes,java.lang.Double)>	10
<simplejavacalculator.UI: void actionPerformed(java.awt.event.ActionEvent)>/simplejavacalculator.Calculator.calculateMono/5	<java.awt.Container: java.awt.Component add(java.awt.Component)>	1
<simplejavacalculator.UI: void writer(java.lang.Double)>/javax.swing.JTextArea.setText/0	<java.lang.Double: double doubleValue()>	1
<simplejavacalculator.UI: void writer(java.lang.Double)>/javax.swing.JTextArea.setText/0	<javax.swing.text.JTextComponent: void setText(java.lang.String)>	10
<simplejavacalculator.Calculator: java.lang.Double calculateBiImpl()>/java.lang.Double.doubleValue/6	<java.lang.Class: java.io.InputStream getResourceAsStream(java.lang.String)>	1
<simplejavacalculator.Calculator: java.lang.Double calculateBiImpl()>/java.lang.Double.doubleValue/6	<java.lang.Double: double doubleValue()>	10
<simplejavacalculator.BufferedImageCustom: java.awt.Image imageReturn()>/java.lang.Class.getResourceAsStream/0	<java.lang.Class: java.io.InputStream getResourceAsStream(java.lang.String)>	1
<simplejavacalculator.BufferedImageCustom: java.awt.Image imageReturn()>/java.lang.Class.getResourceAsStream/0	<java.lang.Class: java.io.InputStream getResourceAsStream(java.lang.String)>	10
<simplejavacalculator.UI: void init()>/javax.swing.JPanel.add/18	<java.awt.Container: java.awt.Component add(java.awt.Component)>	1
<simplejavacalculator.UI: void init()>/javax.swing.JPanel.add/18	<java.awt.Container: java.awt.Component add(java.awt.Component)>	10
<simplejavacalculator.UI: void init()>/javax.swing.JButton.addActionListener/9	<javax.swing.AbstractButton: void addActionListener(java.awt.event.ActionListener)>	1
<simplejavacalculator.UI: void init()>/javax.swing.JButton.addActionListener/9	<javax.swing.AbstractButton: void addActionListener(java.awt.event.ActionListener)>	10
<simplejavacalculator.UI: void actionPerformed(java.awt.event.ActionEvent)>/simplejavacalculator.UI.reader/6	<simplejavacalculator.Calculator: java.lang.Double calculateMono(simplejavacalculator.Calculator$MonoOperatorModes,java.lang.Double)>	1
<simplejavacalculator.UI: void actionPerformed(java.awt.event.ActionEvent)>/simplejavacalculator.UI.reader/6	<simplejavacalculator.UI: java.lang.Double reader()>	10
<simplejavacalculator.UI: void <init>()>/simplejavacalculator.BufferedImageCustom.imageReturn/0	<simplejavacalculator.UI: java.lang.Double reader()>	1
<simplejavacalculator.UI: void <init>()>/simplejavacalculator.BufferedImageCustom.imageReturn/0	<simplejavacalculator.BufferedImageCustom: java.awt.Image imageReturn()>	10
<simplejavacalculator.UI: void actionPerformed(java.awt.event.ActionEvent)>/simplejavacalculator.Calculator.calculateMono/2	<simplejavacalculator.Calculator: java.lang.Double calculateMono(simplejavacalculator.Calculator$MonoOperatorModes,java.lang.Double)>	1
<simplejavacalculator.UI: void actionPerformed(java.awt.event.ActionEvent)>/simplejavacalculator.Calculator.calculateMono/2	<simplejavacalculator.Calculator: java.lang.Double calculateMono(simplejavacalculator.Calculator$MonoOperatorModes,java.lang.Double)>	10
<simplejavacalculator.UI: void init()>/javax.swing.JButton.setFont/17	<javax.swing.JComponent: void setFont(java.awt.Font)>	10
<simplejavacalculator.UI: void init()>/javax.swing.JButton.setFont/17	<java.awt.Container: java.awt.Component add(java.awt.Component)>	1
<simplejavacalculator.UI: void actionPerformed(java.awt.event.ActionEvent)>/javax.swing.JTextArea.replaceSelection/0	<javax.swing.text.JTextComponent: void replaceSelection(java.lang.String)>	1
<simplejavacalculator.UI: void actionPerformed(java.awt.event.ActionEvent)>/javax.swing.JTextArea.replaceSelection/0	<javax.swing.text.JTextComponent: void replaceSelection(java.lang.String)>	10
<simplejavacalculator.Calculator: java.lang.Double calculateMono(simplejavacalculator.Calculator$MonoOperatorModes,java.lang.Double)>/java.lang.Double.doubleValue/7	<java.lang.Class: java.io.InputStream getResourceAsStream(java.lang.String)>	1
<simplejavacalculator.Calculator: java.lang.Double calculateMono(simplejavacalculator.Calculator$MonoOperatorModes,java.lang.Double)>/java.lang.Double.doubleValue/7	<java.lang.Double: double doubleValue()>	10
<simplejavacalculator.UI: void <init>()>/javax.swing.JPanel.setLayout/0	<java.awt.Container: void setLayout(java.awt.LayoutManager)>	1
<simplejavacalculator.UI: void <init>()>/javax.swing.JPanel.setLayout/0	<java.awt.Container: void setLayout(java.awt.LayoutManager)>	10
<simplejavacalculator.Calculator: java.lang.Double calculateMono(simplejavacalculator.Calculator$MonoOperatorModes,java.lang.Double)>/java.lang.Double.doubleValue/9	<simplejavacalculator.UI: java.lang.Double reader()>	1
<simplejavacalculator.Calculator: java.lang.Double calculateMono(simplejavacalculator.Calculator$MonoOperatorModes,java.lang.Double)>/java.lang.Double.doubleValue/9	<java.lang.Double: double doubleValue()>	10
<simplejavacalculator.UI: void init()>/javax.swing.JPanel.add/28	<simplejavacalculator.Calculator: java.lang.Double calculateMono(simplejavacalculator.Calculator$MonoOperatorModes,java.lang.Double)>	1
<simplejavacalculator.UI: void init()>/javax.swing.JPanel.add/28	<java.awt.Container: java.awt.Component add(java.awt.Component)>	10
<simplejavacalculator.Calculator: java.lang.Double calculateBiImpl()>/java.lang.Double.doubleValue/9	<javax.swing.JComponent: void setFont(java.awt.Font)>	1
<simplejavacalculator.Calculator: java.lang.Double calculateBiImpl()>/java.lang.Double.doubleValue/9	<java.lang.Double: double doubleValue()>	10
<simplejavacalculator.Calculator: java.lang.Double calculateBiImpl()>/java.lang.Double.doubleValue/3	<java.lang.Class: java.io.InputStream getResourceAsStream(java.lang.String)>	1
<simplejavacalculator.Calculator: java.lang.Double calculateBiImpl()>/java.lang.Double.doubleValue/3	<java.lang.Double: double doubleValue()>	10
<simplejavacalculator.UI: void parsetoBinary()>/java.lang.Long.parseLong/0	<java.awt.Container: java.awt.Component add(java.awt.Component)>	1
<simplejavacalculator.UI: void parsetoBinary()>/java.lang.Long.parseLong/0	<java.lang.Long: long parseLong(java.lang.String)>	10
<simplejavacalculator.UI: void init()>/javax.swing.JPanel.add/9	<java.awt.Container: java.awt.Component add(java.awt.Component)>	10
<simplejavacalculator.UI: void init()>/javax.swing.JPanel.add/9	<java.lang.Class: java.io.InputStream getResourceAsStream(java.lang.String)>	1
<simplejavacalculator.Calculator: java.lang.Double calculateMono(simplejavacalculator.Calculator$MonoOperatorModes,java.lang.Double)>/java.lang.Double.doubleValue/0	<java.lang.Class: java.io.InputStream getResourceAsStream(java.lang.String)>	1
<simplejavacalculator.Calculator: java.lang.Double calculateMono(simplejavacalculator.Calculator$MonoOperatorModes,java.lang.Double)>/java.lang.Double.doubleValue/0	<java.lang.Double: double doubleValue()>	10
<simplejavacalculator.Calculator: java.lang.Double calculateBiImpl()>/java.lang.Double.doubleValue/0	<java.lang.Class: java.io.InputStream getResourceAsStream(java.lang.String)>	1
<simplejavacalculator.Calculator: java.lang.Double calculateBiImpl()>/java.lang.Double.doubleValue/0	<java.lang.Double: double doubleValue()>	10
<simplejavacalculator.UI: void init()>/javax.swing.JButton.setFont/9	<javax.swing.JComponent: void setFont(java.awt.Font)>	1
<simplejavacalculator.UI: void init()>/javax.swing.JButton.setFont/9	<javax.swing.JComponent: void setFont(java.awt.Font)>	10
<simplejavacalculator.UI: void actionPerformed(java.awt.event.ActionEvent)>/simplejavacalculator.UI.reader/8	<simplejavacalculator.UI: java.lang.Double reader()>	10
<simplejavacalculator.UI: void init()>/javax.swing.JPanel.add/6	<java.awt.Container: java.awt.Component add(java.awt.Component)>	10
<simplejavacalculator.UI: void init()>/javax.swing.JPanel.add/6	<javax.swing.Box: java.awt.Component createHorizontalStrut(int)>	1
<simplejavacalculator.UI: void actionPerformed(java.awt.event.ActionEvent)>/simplejavacalculator.UI.reader/3	<simplejavacalculator.UI: java.lang.Double reader()>	10
<simplejavacalculator.UI: void init()>/javax.swing.JButton.setFont/15	<javax.swing.JComponent: void setFont(java.awt.Font)>	10
<simplejavacalculator.UI: void writer(java.lang.Double)>/java.lang.Double.doubleValue/0	<java.lang.Double: double doubleValue()>	10
<simplejavacalculator.UI: void init()>/javax.swing.ImageIcon.getImage/0	<javax.swing.ImageIcon: java.awt.Image getImage()>	10
<simplejavacalculator.UI: void writer(java.lang.Double)>/java.lang.Double.doubleValue/1	<java.lang.Double: double doubleValue()>	10
<simplejavacalculator.UI: void init()>/javax.swing.JButton.setFont/14	<javax.swing.JComponent: void setFont(java.awt.Font)>	10
<simplejavacalculator.UI: void init()>/javax.swing.JButton.setFont/14	<java.awt.Font: void <init>(java.lang.String,int,int)>	1
<simplejavacalculator.UI: void <init>()>/simplejavacalculator.Calculator.<init>/0	<simplejavacalculator.Calculator: void <init>()>	0
<simplejavacalculator.Calculator$MonoOperatorModes: void <clinit>()>/simplejavacalculator.Calculator$MonoOperatorModes.<init>/8	<simplejavacalculator.Calculator$MonoOperatorModes: void <init>(java.lang.String,int)>	0
<simplejavacalculator.Calculator$BiOperatorModes: void <clinit>()>/simplejavacalculator.Calculator$BiOperatorModes.<init>/2	<simplejavacalculator.Calculator$BiOperatorModes: void <init>(java.lang.String,int)>	0
<simplejavacalculator.UI: void <init>()>/javax.swing.JButton.<init>/9	<javax.swing.JButton: void <init>(java.lang.String)>	0
<simplejavacalculator.Calculator$MonoOperatorModes: void <clinit>()>/simplejavacalculator.Calculator$MonoOperatorModes.<init>/3	<simplejavacalculator.Calculator$MonoOperatorModes: void <init>(java.lang.String,int)>	0
<simplejavacalculator.Calculator$MonoOperatorModes: void <clinit>()>/simplejavacalculator.Calculator$MonoOperatorModes.<init>/1	<simplejavacalculator.Calculator$MonoOperatorModes: void <init>(java.lang.String,int)>	0
<simplejavacalculator.UI: void <init>()>/javax.swing.JButton.<init>/16	<javax.swing.JButton: void <init>(java.lang.String)>	0
<simplejavacalculator.UI: void <init>()>/javax.swing.JButton.<init>/5	<javax.swing.JButton: void <init>(java.lang.String)>	0
<simplejavacalculator.UI: void <init>()>/javax.swing.JButton.<init>/3	<javax.swing.JButton: void <init>(java.lang.String)>	0
<simplejavacalculator.Calculator$BiOperatorModes: void <clinit>()>/simplejavacalculator.Calculator$BiOperatorModes.<init>/4	<simplejavacalculator.Calculator$BiOperatorModes: void <init>(java.lang.String,int)>	0
<simplejavacalculator.Calculator: java.lang.Double calculateBi(simplejavacalculator.Calculator$BiOperatorModes,java.lang.Double)>/simplejavacalculator.Calculator.calculateBiImpl/0	<simplejavacalculator.Calculator: java.lang.Double calculateBiImpl()>	0
<simplejavacalculator.UI: void <init>()>/javax.swing.JButton.<init>/14	<javax.swing.JButton: void <init>(java.lang.String)>	0
<simplejavacalculator.Calculator$BiOperatorModes: void <clinit>()>/simplejavacalculator.Calculator$BiOperatorModes.<init>/0	<simplejavacalculator.Calculator$BiOperatorModes: void <init>(java.lang.String,int)>	0
<simplejavacalculator.UI: void <init>()>/java.lang.Object.<init>/0	<java.lang.Object: void <init>()>	0
<simplejavacalculator.Calculator: java.lang.Double calculateBiImpl()>/java.lang.Error.<init>/0	<java.lang.Error: void <init>()>	0
<simplejavacalculator.Calculator$MonoOperatorModes: void <clinit>()>/simplejavacalculator.Calculator$MonoOperatorModes.<init>/4	<simplejavacalculator.Calculator$MonoOperatorModes: void <init>(java.lang.String,int)>	0
<simplejavacalculator.Calculator$BiOperatorModes: void <clinit>()>/simplejavacalculator.Calculator$BiOperatorModes.<init>/1	<simplejavacalculator.Calculator$BiOperatorModes: void <init>(java.lang.String,int)>	0
<simplejavacalculator.SimpleJavaCalculator: void main(java.lang.String[])>/simplejavacalculator.UI.<init>/0	<simplejavacalculator.UI: void <init>()>	0
<simplejavacalculator.Calculator$MonoOperatorModes: void <clinit>()>/simplejavacalculator.Calculator$MonoOperatorModes.<init>/7	<simplejavacalculator.Calculator$MonoOperatorModes: void <init>(java.lang.String,int)>	0
<simplejavacalculator.UI: void <init>()>/javax.swing.JButton.<init>/12	<javax.swing.JButton: void <init>(java.lang.String)>	0
<simplejavacalculator.UI: void actionPerformed(java.awt.event.ActionEvent)>/simplejavacalculator.UI.parsetoBinary/0	<simplejavacalculator.UI: void parsetoBinary()>	0
<simplejavacalculator.Calculator$BiOperatorModes: void <clinit>()>/simplejavacalculator.Calculator$BiOperatorModes.<init>/5	<simplejavacalculator.Calculator$BiOperatorModes: void <init>(java.lang.String,int)>	0
<simplejavacalculator.Calculator$MonoOperatorModes: void <clinit>()>/simplejavacalculator.Calculator$MonoOperatorModes.<init>/5	<simplejavacalculator.Calculator$MonoOperatorModes: void <init>(java.lang.String,int)>	0
<simplejavacalculator.Calculator$BiOperatorModes: void <clinit>()>/simplejavacalculator.Calculator$BiOperatorModes.<init>/3	<simplejavacalculator.Calculator$BiOperatorModes: void <init>(java.lang.String,int)>	0
<simplejavacalculator.Calculator$MonoOperatorModes: void <clinit>()>/simplejavacalculator.Calculator$MonoOperatorModes.<init>/0	<simplejavacalculator.Calculator$MonoOperatorModes: void <init>(java.lang.String,int)>	0
<simplejavacalculator.Calculator$MonoOperatorModes: void <clinit>()>/simplejavacalculator.Calculator$MonoOperatorModes.<init>/6	<simplejavacalculator.Calculator$MonoOperatorModes: void <init>(java.lang.String,int)>	0
<simplejavacalculator.Calculator: void <init>()>/java.lang.Object.<init>/0	<java.lang.Object: void <init>()>	0
<simplejavacalculator.Calculator$MonoOperatorModes: void <clinit>()>/simplejavacalculator.Calculator$MonoOperatorModes.<init>/2	<simplejavacalculator.Calculator$MonoOperatorModes: void <init>(java.lang.String,int)>	0
<simplejavacalculator.UI: void <init>()>/javax.swing.JFrame.<init>/0	<javax.swing.JFrame: void <init>(java.lang.String)>	0
<simplejavacalculator.Calculator: java.lang.Double calculateMono(simplejavacalculator.Calculator$MonoOperatorModes,java.lang.Double)>/java.lang.Error.<init>/0	<java.lang.Error: void <init>()>	1
<simplejavacalculator.Calculator: java.lang.Double calculateMono(simplejavacalculator.Calculator$MonoOperatorModes,java.lang.Double)>/java.lang.Error.<init>/0	<java.lang.Error: void <init>()>	10
<simplejavacalculator.UI: void parsetoBinary()>/java.lang.StringBuilder.<init>/1	<java.lang.Enum: void <init>(java.lang.String,int)>	1
<simplejavacalculator.UI: void parsetoBinary()>/java.lang.StringBuilder.<init>/1	<java.lang.StringBuilder: void <init>()>	10
<simplejavacalculator.UI: void <init>()>/javax.swing.JButton.<init>/13	<javax.swing.JButton: void <init>(java.lang.String)>	1
<simplejavacalculator.UI: void <init>()>/javax.swing.JButton.<init>/13	<javax.swing.JButton: void <init>(java.lang.String)>	10
<simplejavacalculator.UI: void <init>()>/javax.swing.JPanel.<init>/3	<java.awt.Font: void <init>(java.lang.String,int,int)>	1
<simplejavacalculator.UI: void <init>()>/javax.swing.JPanel.<init>/3	<javax.swing.JPanel: void <init>(java.awt.LayoutManager)>	10
<simplejavacalculator.UI: void <init>()>/javax.swing.JButton.<init>/17	<javax.swing.JButton: void <init>(java.lang.String)>	1
<simplejavacalculator.UI: void <init>()>/javax.swing.JButton.<init>/17	<javax.swing.JButton: void <init>(java.lang.String)>	10
<simplejavacalculator.UI: void <init>()>/java.awt.FlowLayout.<init>/3	<javax.swing.JPanel: void <init>(java.awt.LayoutManager)>	1
<simplejavacalculator.UI: void <init>()>/java.awt.FlowLayout.<init>/3	<java.awt.FlowLayout: void <init>()>	10
<simplejavacalculator.UI: void <init>()>/javax.swing.JButton.<init>/11	<javax.swing.JButton: void <init>(java.lang.String)>	1
<simplejavacalculator.UI: void <init>()>/javax.swing.JButton.<init>/11	<javax.swing.JButton: void <init>(java.lang.String)>	10
<simplejavacalculator.UI: void <init>()>/java.awt.Font.<init>/0	<java.awt.Font: void <init>(java.lang.String,int,int)>	10
<simplejavacalculator.UI: void <init>()>/java.awt.Font.<init>/0	<javax.swing.JPanel: void <init>()>	1
<simplejavacalculator.UI: void <init>()>/java.awt.FlowLayout.<init>/1	<javax.swing.JPanel: void <init>(java.awt.LayoutManager)>	1
<simplejavacalculator.UI: void <init>()>/java.awt.FlowLayout.<init>/1	<java.awt.FlowLayout: void <init>()>	10
<simplejavacalculator.UI: void <init>()>/javax.swing.JPanel.<init>/0	<java.awt.Font: void <init>(java.lang.String,int,int)>	1
<simplejavacalculator.UI: void <init>()>/javax.swing.JPanel.<init>/0	<javax.swing.JPanel: void <init>()>	10
<simplejavacalculator.BufferedImageCustom: void <init>()>/java.lang.Object.<init>/0	<java.lang.Object: void <init>()>	1
<simplejavacalculator.BufferedImageCustom: void <init>()>/java.lang.Object.<init>/0	<java.lang.Object: void <init>()>	10
<simplejavacalculator.UI: void <init>()>/javax.swing.JButton.<init>/4	<javax.swing.JButton: void <init>(java.lang.String)>	1
<simplejavacalculator.UI: void <init>()>/javax.swing.JButton.<init>/4	<javax.swing.JButton: void <init>(java.lang.String)>	10
<simplejavacalculator.UI: void <init>()>/javax.swing.JButton.<init>/0	<javax.swing.JButton: void <init>(java.lang.String)>	1
<simplejavacalculator.UI: void <init>()>/javax.swing.JButton.<init>/0	<javax.swing.JButton: void <init>(java.lang.String)>	10
<simplejavacalculator.UI: void <init>()>/javax.swing.JPanel.<init>/1	<java.awt.Font: void <init>(java.lang.String,int,int)>	1
<simplejavacalculator.UI: void <init>()>/javax.swing.JPanel.<init>/1	<javax.swing.JPanel: void <init>(java.awt.LayoutManager)>	10
<simplejavacalculator.UI: void <init>()>/javax.swing.JPanel.<init>/8	<javax.swing.JButton: void <init>(java.lang.String)>	1
<simplejavacalculator.UI: void <init>()>/javax.swing.JPanel.<init>/8	<javax.swing.JPanel: void <init>(java.awt.LayoutManager)>	10
<simplejavacalculator.UI: void <init>()>/java.awt.FlowLayout.<init>/0	<javax.swing.JPanel: void <init>(java.awt.LayoutManager)>	1
<simplejavacalculator.UI: void <init>()>/java.awt.FlowLayout.<init>/0	<java.awt.FlowLayout: void <init>()>	10
<simplejavacalculator.UI: void <init>()>/javax.swing.JButton.<init>/7	<javax.swing.JButton: void <init>(java.lang.String)>	1
<simplejavacalculator.UI: void <init>()>/javax.swing.JButton.<init>/7	<javax.swing.JButton: void <init>(java.lang.String)>	10
<simplejavacalculator.UI: void <init>()>/javax.swing.JButton.<init>/10	<javax.swing.JButton: void <init>(java.lang.String)>	1
<simplejavacalculator.UI: void <init>()>/javax.swing.JButton.<init>/10	<javax.swing.JButton: void <init>(java.lang.String)>	10
<simplejavacalculator.UI: void <init>()>/java.awt.FlowLayout.<init>/4	<javax.swing.JPanel: void <init>(java.awt.LayoutManager)>	1
<simplejavacalculator.UI: void <init>()>/java.awt.FlowLayout.<init>/4	<java.awt.FlowLayout: void <init>()>	10
<simplejavacalculator.UI: void <init>()>/java.awt.Font.<init>/1	<java.awt.Font: void <init>(java.lang.String,int,int)>	10
<simplejavacalculator.UI: void <init>()>/java.awt.Font.<init>/1	<javax.swing.JTextArea: void <init>(int,int)>	1
<simplejavacalculator.UI: void <init>()>/javax.swing.JPanel.<init>/2	<java.awt.Font: void <init>(java.lang.String,int,int)>	1
<simplejavacalculator.UI: void <init>()>/javax.swing.JPanel.<init>/2	<javax.swing.JPanel: void <init>(java.awt.LayoutManager)>	10
<simplejavacalculator.Calculator$BiOperatorModes: void <init>(java.lang.String,int)>/java.lang.Enum.<init>/0	<java.lang.Enum: void <init>(java.lang.String,int)>	10
<simplejavacalculator.Calculator$BiOperatorModes: void <init>(java.lang.String,int)>/java.lang.Enum.<init>/0	new_var_603	1
<simplejavacalculator.UI: void <init>()>/javax.swing.JButton.<init>/15	<javax.swing.JButton: void <init>(java.lang.String)>	1
<simplejavacalculator.UI: void <init>()>/javax.swing.JButton.<init>/15	<javax.swing.JButton: void <init>(java.lang.String)>	10
<simplejavacalculator.UI: void <init>()>/javax.swing.JButton.<init>/8	<javax.swing.JButton: void <init>(java.lang.String)>	10
<simplejavacalculator.UI: void <init>()>/javax.swing.JButton.<init>/8	new_var_606	1
<simplejavacalculator.UI: void <init>()>/javax.swing.BoxLayout.<init>/0	<javax.swing.JPanel: void <init>(java.awt.LayoutManager)>	1
<simplejavacalculator.UI: void <init>()>/javax.swing.BoxLayout.<init>/0	<javax.swing.BoxLayout: void <init>(java.awt.Container,int)>	10
new_var_600	<java.lang.Enum: void <init>(java.lang.String,int)>	1
new_var_599	<javax.swing.JPanel: void <init>(java.awt.LayoutManager)>	1
<simplejavacalculator.UI: void <init>()>/javax.swing.JPanel.<init>/4	<java.awt.Font: void <init>(java.lang.String,int,int)>	1
<simplejavacalculator.UI: void <init>()>/javax.swing.JPanel.<init>/4	<javax.swing.JPanel: void <init>(java.awt.LayoutManager)>	10
new_var_598	<javax.swing.JPanel: void <init>(java.awt.LayoutManager)>	1
<simplejavacalculator.UI: void <init>()>/simplejavacalculator.BufferedImageCustom.<init>/0	<simplejavacalculator.BufferedImageCustom: void <init>()>	10
<simplejavacalculator.UI: void <init>()>/simplejavacalculator.BufferedImageCustom.<init>/0	new_var_604	1
<simplejavacalculator.UI: void <init>()>/javax.swing.JPanel.<init>/7	<java.awt.Font: void <init>(java.lang.String,int,int)>	1
<simplejavacalculator.UI: void <init>()>/javax.swing.JPanel.<init>/7	<javax.swing.JPanel: void <init>(java.awt.LayoutManager)>	10
<simplejavacalculator.UI: void <init>()>/javax.swing.JPanel.<init>/6	<javax.swing.JPanel: void <init>(java.awt.LayoutManager)>	10
<simplejavacalculator.UI: void <init>()>/javax.swing.JPanel.<init>/6	<javax.swing.JTextArea: void <init>(int,int)>	1
<simplejavacalculator.UI: void <init>()>/javax.swing.JTextArea.<init>/0	<javax.swing.JButton: void <init>(java.lang.String)>	1
<simplejavacalculator.UI: void <init>()>/javax.swing.JTextArea.<init>/0	<javax.swing.JTextArea: void <init>(int,int)>	10
new_var_597	new_var_605	1
<simplejavacalculator.UI: void <init>()>/javax.swing.JButton.<init>/1	<javax.swing.JButton: void <init>(java.lang.String)>	1
<simplejavacalculator.UI: void <init>()>/javax.swing.JButton.<init>/1	<javax.swing.JButton: void <init>(java.lang.String)>	10
<simplejavacalculator.UI: void <init>()>/javax.swing.JButton.<init>/6	<javax.swing.JButton: void <init>(java.lang.String)>	10
<simplejavacalculator.UI: void <init>()>/javax.swing.JButton.<init>/6	<java.awt.Font: void <init>(java.lang.String,int,int)>	1
<simplejavacalculator.UI: void <init>()>/javax.swing.JPanel.<init>/5	<javax.swing.JPanel: void <init>(java.awt.LayoutManager)>	1
<simplejavacalculator.UI: void <init>()>/javax.swing.JPanel.<init>/5	<javax.swing.JPanel: void <init>(java.awt.LayoutManager)>	10
<simplejavacalculator.UI: void <init>()>/javax.swing.JButton.<init>/2	<javax.swing.JButton: void <init>(java.lang.String)>	1
<simplejavacalculator.UI: void <init>()>/javax.swing.JButton.<init>/2	<javax.swing.JButton: void <init>(java.lang.String)>	10
<simplejavacalculator.Calculator$MonoOperatorModes: void <init>(java.lang.String,int)>/java.lang.Enum.<init>/0	<java.lang.Enum: void <init>(java.lang.String,int)>	10
<simplejavacalculator.Calculator$MonoOperatorModes: void <init>(java.lang.String,int)>/java.lang.Enum.<init>/0	new_var_603	1
<simplejavacalculator.UI: void <init>()>/java.awt.FlowLayout.<init>/7	<java.awt.FlowLayout: void <init>()>	10
<simplejavacalculator.UI: void <init>()>/java.awt.FlowLayout.<init>/2	<java.awt.FlowLayout: void <init>()>	10
<simplejavacalculator.SimpleJavaCalculator: void <init>()>/java.lang.Object.<init>/0	<java.lang.Object: void <init>()>	10
<simplejavacalculator.UI: void <init>()>/java.awt.FlowLayout.<init>/6	<java.awt.FlowLayout: void <init>()>	10
<simplejavacalculator.UI: void <init>()>/java.awt.FlowLayout.<init>/5	<java.awt.FlowLayout: void <init>()>	10
<simplejavacalculator.UI: void parsetoBinary()>/java.lang.StringBuilder.<init>/0	<java.lang.StringBuilder: void <init>()>	10
<simplejavacalculator.Calculator: java.lang.Double calculateMono(simplejavacalculator.Calculator$MonoOperatorModes,java.lang.Double)>/java.lang.Double.valueOf/6	<java.lang.Double: java.lang.Double valueOf(double)>	0
<simplejavacalculator.Calculator: java.lang.Double calculateBi(simplejavacalculator.Calculator$BiOperatorModes,java.lang.Double)>/java.lang.Double.valueOf/0	<java.lang.Double: java.lang.Double valueOf(double)>	0
<simplejavacalculator.Calculator: java.lang.Double calculateMono(simplejavacalculator.Calculator$MonoOperatorModes,java.lang.Double)>/java.lang.Double.valueOf/3	<java.lang.Double: java.lang.Double valueOf(double)>	0
<simplejavacalculator.Calculator: java.lang.Double calculateMono(simplejavacalculator.Calculator$MonoOperatorModes,java.lang.Double)>/java.lang.Math.tan/0	<java.lang.Math: double tan(double)>	0
<simplejavacalculator.Calculator: java.lang.Double calculateBiImpl()>/java.lang.Double.valueOf/0	<java.lang.Double: java.lang.Double valueOf(double)>	0
<simplejavacalculator.UI: void writer(java.lang.Double)>/java.lang.Double.toString/0	<java.lang.Double: java.lang.String toString(double)>	0
<simplejavacalculator.Calculator: java.lang.Double calculateMono(simplejavacalculator.Calculator$MonoOperatorModes,java.lang.Double)>/java.lang.Double.valueOf/1	<java.lang.Double: java.lang.Double valueOf(double)>	0
<simplejavacalculator.UI: void init()>/javax.swing.Box.createHorizontalStrut/2	<javax.swing.Box: java.awt.Component createHorizontalStrut(int)>	0
<simplejavacalculator.Calculator: java.lang.Double calculateBiImpl()>/java.lang.Double.valueOf/1	<java.lang.Double: java.lang.Double valueOf(double)>	0
<simplejavacalculator.Calculator: java.lang.Double calculateBiImpl()>/java.lang.Math.pow/0	<java.lang.Math: double pow(double,double)>	0
<simplejavacalculator.UI: void init()>/javax.swing.Box.createHorizontalStrut/3	<javax.swing.Box: java.awt.Component createHorizontalStrut(int)>	0
<simplejavacalculator.Calculator: java.lang.Double calculateBi(simplejavacalculator.Calculator$BiOperatorModes,java.lang.Double)>/java.lang.Double.valueOf/1	<java.lang.Double: java.lang.Double valueOf(double)>	0
<simplejavacalculator.Calculator: java.lang.Double calculateMono(simplejavacalculator.Calculator$MonoOperatorModes,java.lang.Double)>/java.lang.Double.valueOf/5	<java.lang.Double: java.lang.Double valueOf(double)>	0
<simplejavacalculator.Calculator: java.lang.Double reset()>/java.lang.Double.valueOf/0	<java.lang.Double: java.lang.Double valueOf(double)>	0
<simplejavacalculator.Calculator: java.lang.Double calculateMono(simplejavacalculator.Calculator$MonoOperatorModes,java.lang.Double)>/java.lang.Double.valueOf/4	<java.lang.Double: java.lang.Double valueOf(double)>	0
<simplejavacalculator.Calculator: java.lang.Double calculateMono(simplejavacalculator.Calculator$MonoOperatorModes,java.lang.Double)>/java.lang.Math.log10/0	<java.lang.Math: double log10(double)>	0
<simplejavacalculator.Calculator: java.lang.Double calculateMono(simplejavacalculator.Calculator$MonoOperatorModes,java.lang.Double)>/java.lang.Math.sin/0	<java.lang.Math: double sin(double)>	0
<simplejavacalculator.Calculator: java.lang.Double calculateBiImpl()>/java.lang.Double.valueOf/2	<java.lang.Double: java.lang.Double valueOf(double)>	0
<simplejavacalculator.Calculator: java.lang.Double calculateMono(simplejavacalculator.Calculator$MonoOperatorModes,java.lang.Double)>/java.lang.Double.valueOf/2	<java.lang.Double: java.lang.Double valueOf(double)>	0
<simplejavacalculator.Calculator: java.lang.Double calculateBiImpl()>/java.lang.Double.valueOf/4	<java.lang.Double: java.lang.Double valueOf(double)>	0
<simplejavacalculator.Calculator: java.lang.Double calculateMono(simplejavacalculator.Calculator$MonoOperatorModes,java.lang.Double)>/java.lang.Double.valueOf/7	<java.lang.Double: java.lang.Double valueOf(double)>	0
<simplejavacalculator.Calculator: java.lang.Double calculateMono(simplejavacalculator.Calculator$MonoOperatorModes,java.lang.Double)>/java.lang.Double.valueOf/9	<java.lang.Double: java.lang.Double valueOf(double)>	0
<simplejavacalculator.Calculator: java.lang.Double calculateBiImpl()>/java.lang.Double.valueOf/3	<java.lang.Double: java.lang.Double valueOf(double)>	0
<simplejavacalculator.Calculator: java.lang.Double calculateMono(simplejavacalculator.Calculator$MonoOperatorModes,java.lang.Double)>/java.lang.Double.valueOf/8	<java.lang.Double: java.lang.Double valueOf(double)>	0
<simplejavacalculator.UI: void init()>/javax.swing.Box.createHorizontalStrut/0	<javax.swing.Box: java.awt.Component createHorizontalStrut(int)>	0
<simplejavacalculator.UI: void <init>()>/java.lang.String.valueOf/0	<java.lang.String: java.lang.String valueOf(int)>	0
<simplejavacalculator.Calculator: java.lang.Double calculateMono(simplejavacalculator.Calculator$MonoOperatorModes,java.lang.Double)>/java.lang.Math.cos/0	<java.lang.Math: double cos(double)>	0
<simplejavacalculator.UI: void init()>/javax.swing.Box.createHorizontalStrut/4	<javax.swing.Box: java.awt.Component createHorizontalStrut(int)>	0
<simplejavacalculator.Calculator: java.lang.Double calculateMono(simplejavacalculator.Calculator$MonoOperatorModes,java.lang.Double)>/java.lang.Math.sqrt/0	<java.lang.Math: double sqrt(double)>	0
<simplejavacalculator.UI: void writer(java.lang.Double)>/java.lang.Double.isNaN/0	<java.lang.Double: boolean isNaN(double)>	0
<simplejavacalculator.Calculator: java.lang.Double calculateMono(simplejavacalculator.Calculator$MonoOperatorModes,java.lang.Double)>/java.lang.Double.valueOf/0	<java.lang.Double: java.lang.Double valueOf(double)>	10
<simplejavacalculator.Calculator: java.lang.Double calculateMono(simplejavacalculator.Calculator$MonoOperatorModes,java.lang.Double)>/java.lang.Double.valueOf/0	new_var_596	1
<simplejavacalculator.Calculator: java.lang.Double calculateMono(simplejavacalculator.Calculator$MonoOperatorModes,java.lang.Double)>/java.lang.Double.valueOf/10	<java.lang.Double: java.lang.Double valueOf(double)>	1
<simplejavacalculator.Calculator: java.lang.Double calculateMono(simplejavacalculator.Calculator$MonoOperatorModes,java.lang.Double)>/java.lang.Double.valueOf/10	<java.lang.Double: java.lang.Double valueOf(double)>	10
<simplejavacalculator.BufferedImageCustom: java.awt.Image imageReturn()>/javax.imageio.ImageIO.read/0	<java.lang.Double: java.lang.Double valueOf(double)>	1
<simplejavacalculator.BufferedImageCustom: java.awt.Image imageReturn()>/javax.imageio.ImageIO.read/0	<javax.imageio.ImageIO: java.awt.image.BufferedImage read(java.io.InputStream)>	10
<simplejavacalculator.UI: void init()>/javax.swing.Box.createHorizontalStrut/1	<java.lang.Double: java.lang.Double valueOf(double)>	1
<simplejavacalculator.UI: void init()>/javax.swing.Box.createHorizontalStrut/1	<javax.swing.Box: java.awt.Component createHorizontalStrut(int)>	10
<simplejavacalculator.Calculator: java.lang.Double reset()>/java.lang.Double.valueOf/2	<java.lang.Double: java.lang.Double valueOf(double)>	10
<simplejavacalculator.Calculator: java.lang.Double reset()>/java.lang.Double.valueOf/2	<java.lang.Long: java.lang.String toBinaryString(long)>	1
<simplejavacalculator.UI: java.lang.Double reader()>/java.lang.Double.valueOf/0	<java.lang.Double: java.lang.Double valueOf(double)>	1
<simplejavacalculator.UI: java.lang.Double reader()>/java.lang.Double.valueOf/0	<java.lang.Double: java.lang.Double valueOf(java.lang.String)>	10
<simplejavacalculator.Calculator: java.lang.Double calculateMono(simplejavacalculator.Calculator$MonoOperatorModes,java.lang.Double)>/java.lang.Math.abs/0	<java.lang.Math: double abs(double)>	1
<simplejavacalculator.Calculator: java.lang.Double calculateMono(simplejavacalculator.Calculator$MonoOperatorModes,java.lang.Double)>/java.lang.Math.abs/0	<java.lang.Math: double abs(double)>	10
<simplejavacalculator.Calculator$MonoOperatorModes: simplejavacalculator.Calculator$MonoOperatorModes valueOf(java.lang.String)>/java.lang.Enum.valueOf/0	<java.lang.Enum: java.lang.Enum valueOf(java.lang.Class,java.lang.String)>	1
<simplejavacalculator.Calculator$MonoOperatorModes: simplejavacalculator.Calculator$MonoOperatorModes valueOf(java.lang.String)>/java.lang.Enum.valueOf/0	<java.lang.Enum: java.lang.Enum valueOf(java.lang.Class,java.lang.String)>	10
<simplejavacalculator.Calculator$BiOperatorModes: simplejavacalculator.Calculator$BiOperatorModes valueOf(java.lang.String)>/java.lang.Enum.valueOf/0	<java.lang.Enum: java.lang.Enum valueOf(java.lang.Class,java.lang.String)>	1
<simplejavacalculator.Calculator$BiOperatorModes: simplejavacalculator.Calculator$BiOperatorModes valueOf(java.lang.String)>/java.lang.Enum.valueOf/0	<java.lang.Enum: java.lang.Enum valueOf(java.lang.Class,java.lang.String)>	10
<simplejavacalculator.Calculator: java.lang.Double reset()>/java.lang.Double.valueOf/1	<java.lang.Double: java.lang.Double valueOf(double)>	10
<simplejavacalculator.Calculator: java.lang.Double reset()>/java.lang.Double.valueOf/1	<java.lang.Double: java.lang.Double valueOf(java.lang.String)>	1
