<simplejavacalculator.Calculator: java.lang.Double reset()>/$stack4	<simplejavacalculator.Calculator: java.lang.Double reset()>	0
<simplejavacalculator.Calculator: java.lang.Double calculateMono(simplejavacalculator.Calculator$MonoOperatorModes,java.lang.Double)>/$stack42	<simplejavacalculator.Calculator: java.lang.Double calculateMono(simplejavacalculator.Calculator$MonoOperatorModes,java.lang.Double)>	0
<simplejavacalculator.Calculator: java.lang.Double calculateBi(simplejavacalculator.Calculator$BiOperatorModes,java.lang.Double)>/$stack8	<simplejavacalculator.Calculator: java.lang.Double calculateBi(simplejavacalculator.Calculator$BiOperatorModes,java.lang.Double)>	0
<simplejavacalculator.Calculator: java.lang.Double calculateBi(simplejavacalculator.Calculator$BiOperatorModes,java.lang.Double)>/$stack6	<simplejavacalculator.Calculator: java.lang.Double calculateBi(simplejavacalculator.Calculator$BiOperatorModes,java.lang.Double)>	0
<simplejavacalculator.Calculator: java.lang.Double calculateBiImpl()>/$stack19	<simplejavacalculator.Calculator: java.lang.Double calculateBiImpl()>	0
<simplejavacalculator.Calculator: java.lang.Double calculateBiImpl()>/$stack48	<simplejavacalculator.Calculator: java.lang.Double calculateBiImpl()>	0
<simplejavacalculator.Calculator: java.lang.Double calculateMono(simplejavacalculator.Calculator$MonoOperatorModes,java.lang.Double)>/$stack15	<simplejavacalculator.Calculator: java.lang.Double calculateMono(simplejavacalculator.Calculator$MonoOperatorModes,java.lang.Double)>	1
<simplejavacalculator.Calculator: java.lang.Double calculateMono(simplejavacalculator.Calculator$MonoOperatorModes,java.lang.Double)>/$stack15	<simplejavacalculator.Calculator: java.lang.Double calculateMono(simplejavacalculator.Calculator$MonoOperatorModes,java.lang.Double)>	10
<simplejavacalculator.Calculator: java.lang.Double calculateMono(simplejavacalculator.Calculator$MonoOperatorModes,java.lang.Double)>/$stack45	<simplejavacalculator.Calculator: java.lang.Double calculateMono(simplejavacalculator.Calculator$MonoOperatorModes,java.lang.Double)>	0
<simplejavacalculator.Calculator: java.lang.Double calculateMono(simplejavacalculator.Calculator$MonoOperatorModes,java.lang.Double)>/$stack33	<simplejavacalculator.Calculator: java.lang.Double calculateMono(simplejavacalculator.Calculator$MonoOperatorModes,java.lang.Double)>	0
<simplejavacalculator.Calculator: java.lang.Double calculateBiImpl()>/$stack41	<simplejavacalculator.Calculator: java.lang.Double calculateBiImpl()>	0
<simplejavacalculator.Calculator: java.lang.Double calculateMono(simplejavacalculator.Calculator$MonoOperatorModes,java.lang.Double)>/$stack52	<simplejavacalculator.Calculator: java.lang.Double calculateMono(simplejavacalculator.Calculator$MonoOperatorModes,java.lang.Double)>	0
<simplejavacalculator.Calculator: java.lang.Double calculateEqual(java.lang.Double)>/$stack3	<simplejavacalculator.Calculator: java.lang.Double calculateEqual(java.lang.Double)>	0
<simplejavacalculator.Calculator: java.lang.Double calculateBiImpl()>/$stack31	<simplejavacalculator.Calculator: java.lang.Double calculateBiImpl()>	0
<simplejavacalculator.Calculator: java.lang.Double calculateMono(simplejavacalculator.Calculator$MonoOperatorModes,java.lang.Double)>/$stack38	<simplejavacalculator.Calculator: java.lang.Double calculateMono(simplejavacalculator.Calculator$MonoOperatorModes,java.lang.Double)>	0
<simplejavacalculator.UI: java.lang.Double reader()>/num#_323	<simplejavacalculator.UI: java.lang.Double reader()>	0
<simplejavacalculator.Calculator: java.lang.Double calculateBiImpl()>/$stack37	<simplejavacalculator.Calculator: java.lang.Double calculateBiImpl()>	0
<simplejavacalculator.Calculator: java.lang.Double calculateMono(simplejavacalculator.Calculator$MonoOperatorModes,java.lang.Double)>/$stack49	<simplejavacalculator.Calculator: java.lang.Double calculateMono(simplejavacalculator.Calculator$MonoOperatorModes,java.lang.Double)>	0
<simplejavacalculator.Calculator: java.lang.Double calculateBiImpl()>/$stack25	<simplejavacalculator.Calculator: java.lang.Double calculateBiImpl()>	0
<simplejavacalculator.Calculator: java.lang.Double calculateMono(simplejavacalculator.Calculator$MonoOperatorModes,java.lang.Double)>/$stack24	<simplejavacalculator.Calculator: java.lang.Double calculateMono(simplejavacalculator.Calculator$MonoOperatorModes,java.lang.Double)>	0
<simplejavacalculator.Calculator: java.lang.Double calculateMono(simplejavacalculator.Calculator$MonoOperatorModes,java.lang.Double)>/$stack18	<simplejavacalculator.Calculator: java.lang.Double calculateMono(simplejavacalculator.Calculator$MonoOperatorModes,java.lang.Double)>	1
<simplejavacalculator.Calculator: java.lang.Double calculateMono(simplejavacalculator.Calculator$MonoOperatorModes,java.lang.Double)>/$stack18	<simplejavacalculator.Calculator: java.lang.Double calculateMono(simplejavacalculator.Calculator$MonoOperatorModes,java.lang.Double)>	10
<simplejavacalculator.Calculator$BiOperatorModes: simplejavacalculator.Calculator$BiOperatorModes[] values()>/$stack2	<simplejavacalculator.Calculator$BiOperatorModes: simplejavacalculator.Calculator$BiOperatorModes[] values()>	0
<simplejavacalculator.Calculator: java.lang.Double calculateMono(simplejavacalculator.Calculator$MonoOperatorModes,java.lang.Double)>/$stack21	<simplejavacalculator.Calculator: java.lang.Double calculateMono(simplejavacalculator.Calculator$MonoOperatorModes,java.lang.Double)>	0
<simplejavacalculator.Calculator: java.lang.Double calculateBiImpl()>/$stack47	<simplejavacalculator.Calculator: java.lang.Double calculateBiImpl()>	0
<simplejavacalculator.Calculator: java.lang.Double calculateMono(simplejavacalculator.Calculator$MonoOperatorModes,java.lang.Double)>/$stack56	<simplejavacalculator.Calculator: java.lang.Double calculateMono(simplejavacalculator.Calculator$MonoOperatorModes,java.lang.Double)>	0
<simplejavacalculator.Calculator$MonoOperatorModes: simplejavacalculator.Calculator$MonoOperatorModes[] values()>/$stack2	<simplejavacalculator.Calculator$MonoOperatorModes: simplejavacalculator.Calculator$MonoOperatorModes[] values()>	0
<simplejavacalculator.Calculator$BiOperatorModes: simplejavacalculator.Calculator$BiOperatorModes valueOf(java.lang.String)>/$stack2	<simplejavacalculator.Calculator$MonoOperatorModes: simplejavacalculator.Calculator$MonoOperatorModes valueOf(java.lang.String)>	1
<simplejavacalculator.Calculator$BiOperatorModes: simplejavacalculator.Calculator$BiOperatorModes valueOf(java.lang.String)>/$stack2	<simplejavacalculator.Calculator$BiOperatorModes: simplejavacalculator.Calculator$BiOperatorModes valueOf(java.lang.String)>	10
<simplejavacalculator.Calculator$MonoOperatorModes: simplejavacalculator.Calculator$MonoOperatorModes valueOf(java.lang.String)>/$stack2	<simplejavacalculator.Calculator$MonoOperatorModes: simplejavacalculator.Calculator$MonoOperatorModes valueOf(java.lang.String)>	10
<simplejavacalculator.Calculator$MonoOperatorModes: simplejavacalculator.Calculator$MonoOperatorModes valueOf(java.lang.String)>/$stack2	<simplejavacalculator.Calculator$BiOperatorModes: simplejavacalculator.Calculator$BiOperatorModes valueOf(java.lang.String)>	1
<simplejavacalculator.BufferedImageCustom: java.awt.Image imageReturn()>/image#_21	<simplejavacalculator.BufferedImageCustom: java.awt.Image imageReturn()>	10
